PharmGKB	NCBI	Symbol	Chr	Start	End	Length	Name
PA24356	1	A1BG	chr19	58855172	58874865	19693	alpha-1-B glycoprotein
PA162375098	29974	A1CF	chr10	52556169	52655435	99266	APOBEC1 complementation factor
PA24357	2	A2M	chr12	9217304	9278558	61254	alpha-2-macroglobulin
PA142670460	144568	A2ML1	chr12	8965150	9032381	67231	alpha-2-macroglobulin-like 1
PA24359	53947	A4GALT	chr22	43085123	43127307	42184	alpha 1,4-galactosyltransferase
PA134960042	51146	A4GNT	chr3	137839560	137861229	21669	alpha-1,4-N-acetylglucosaminyltransferase
PA24361	8086	AAAS	chr12	53698240	53725412	27172	achalasia, adrenocortical insufficiency, alacrimia
PA134940696	65985	AACS	chr12	125539925	125630879	90954	acetoacetyl-CoA synthetase
PA24363	13	AADAC	chr3	151521769	151549276	27507	arylacetamide deacetylase
PA142670463	344752	AADACL2	chr3	151441704	151478556	36852	arylacetamide deacetylase-like 2
PA145147526	126767	AADACL3	chr1	12766118	12791726	25608	arylacetamide deacetylase-like 3
PA145147537	343066	AADACL4	chr1	12694566	12730097	35531	arylacetamide deacetylase-like 4
PA24364	51166	AADAT	chr4	170978373	171022823	44450	aminoadipate aminotransferase
PA38190	195827	AAED1	chr9	99400109	99427603	27494	AhpC/TSA antioxidant enzyme domain containing 1
PA165478457	79719	AAGAB	chr15	67490013	67557536	67523	alpha- and gamma-adaptin binding protein
PA134990616	22848	AAK1	chr2	69682127	69911566	229439	AP2 associated kinase 1
PA144596486	28971	AAMDC	chr11	77522147	77586398	64251	adipogenesis associated, Mth938 domain containing
PA24365	14	AAMP	chr2	219125852	219144893	19041	angio-associated, migratory cell protein
PA24366	15	AANAT	chr17	74439433	74469199	29766	aralkylamine N-acetyltransferase
PA25753	25980	AAR2	chr20	34814339	34847863	33524	AAR2 splicing factor homolog (S. cerevisiae)
PA164717502	441376	AARD	chr8	117940464	117959239	18775	alanine and arginine rich domain containing protein
PA24367	16	AARS	chr16	70283198	70333452	50254	alanyl-tRNA synthetase
PA162375129	57505	AARS2	chr6	44263463	44291094	27631	alanyl-tRNA synthetase 2, mitochondrial
PA142670464	80755	AARSD1	chr17	41099543	41126515	26972	alanyl-tRNA synthetase domain containing 1
PA162375178	132949	AASDH	chr4	57201450	57264265	62815	aminoadipate-semialdehyde dehydrogenase
PA24368	60496	AASDHPPT	chr11	105938292	105972419	34127	aminoadipate-semialdehyde dehydrogenase-phosphopantetheinyl transferase
PA24369	10157	AASS	chr7	121710598	121794344	83746	aminoadipate-semialdehyde synthase
PA128395780	26574	AATF	chr17	35296175	35417171	120996	apoptosis antagonizing transcription factor
PA24370	9625	AATK	chr17	79081285	79149877	68592	apoptosis-associated tyrosine kinase
PA24372	18	ABAT	chr16	8758444	8881432	122988	4-aminobutyrate aminotransferase
PA24373	19	ABCA1	chr9	107540283	107700527	160244	ATP-binding cassette, sub-family A (ABC1), member 1
PA24374	10349	ABCA10	chr17	67141148	67250956	109808	ATP-binding cassette, sub-family A (ABC1), member 10
PA29604	26154	ABCA12	chr2	215793266	216013151	219885	ATP-binding cassette, sub-family A (ABC1), member 12
PA134925234	154664	ABCA13	chr7	48201057	48690091	489034	ATP-binding cassette, sub-family A (ABC1), member 13
PA24377	20	ABCA2	chr9	139898686	139933374	34688	ATP-binding cassette, sub-family A (ABC1), member 2
PA24378	21	ABCA3	chr16	2322879	2400747	77868	ATP-binding cassette, sub-family A (ABC1), member 3
PA24379	24	ABCA4	chr1	94455393	94596705	141312	ATP-binding cassette, sub-family A (ABC1), member 4
PA24380	23461	ABCA5	chr17	67237576	67333323	95747	ATP-binding cassette, sub-family A (ABC1), member 5
PA24381	23460	ABCA6	chr17	67071847	67148015	76168	ATP-binding cassette, sub-family A (ABC1), member 6
PA24382	10347	ABCA7	chr19	1030102	1068571	38469	ATP-binding cassette, sub-family A (ABC1), member 7
PA24383	10351	ABCA8	chr17	66860428	66961550	101122	ATP-binding cassette, sub-family A (ABC1), member 8
PA24384	10350	ABCA9	chr17	66967773	67068442	100669	ATP-binding cassette, sub-family A (ABC1), member 9
PA267	5243	ABCB1	chr7	87130179	87352639	222460	ATP-binding cassette, sub-family B (MDR/TAP), member 1
PA24385	23456	ABCB10	chr1	229649329	229704442	55113	ATP-binding cassette, sub-family B (MDR/TAP), member 10
PA374	8647	ABCB11	chr2	169776336	169897833	121497	ATP-binding cassette, sub-family B (MDR/TAP), member 11
PA268	5244	ABCB4	chr7	87028361	87115019	86658	ATP-binding cassette, sub-family B (MDR/TAP), member 4
PA24387	340273	ABCB5	chr7	20645245	20799637	154392	ATP-binding cassette, sub-family B (MDR/TAP), member 5
PA24388	10058	ABCB6	chr2	220071488	220093712	22224	ATP-binding cassette, sub-family B (MDR/TAP), member 6 (Langereis blood group)
PA24389	22	ABCB7	chrX	74270007	74386175	116168	ATP-binding cassette, sub-family B (MDR/TAP), member 7
PA24390	11194	ABCB8	chr7	150715510	150747869	32359	ATP-binding cassette, sub-family B (MDR/TAP), member 8
PA24391	23457	ABCB9	chr12	123402498	123461056	58558	ATP-binding cassette, sub-family B (MDR/TAP), member 9
PA244	4363	ABCC1	chr16	16033434	16239931	206497	ATP-binding cassette, sub-family C (CFTR/MRP), member 1
PA24392	89845	ABCC10	chr6	43385282	43421163	35881	ATP-binding cassette, sub-family C (CFTR/MRP), member 10
PA24393	85320	ABCC11	chr16	48197782	48291479	93697	ATP-binding cassette, sub-family C (CFTR/MRP), member 11
PA24394	94160	ABCC12	chr16	48113884	48190681	76797	ATP-binding cassette, sub-family C (CFTR/MRP), member 12
PA116	1244	ABCC2	chr10	101532457	101614662	82205	ATP-binding cassette, sub-family C (CFTR/MRP), member 2
PA376	8714	ABCC3	chr17	48702205	48772063	69858	ATP-binding cassette, sub-family C (CFTR/MRP), member 3
PA397	10257	ABCC4	chr13	95669083	95963705	294622	ATP-binding cassette, sub-family C (CFTR/MRP), member 4
PA395	10057	ABCC5	chr3	183634722	183745803	111081	ATP-binding cassette, sub-family C (CFTR/MRP), member 5
PA58	368	ABCC6	chr16	16240422	16328083	87661	ATP-binding cassette, sub-family C (CFTR/MRP), member 6
PA24395	6833	ABCC8	chr11	17411432	17508449	97017	ATP-binding cassette, sub-family C (CFTR/MRP), member 8
PA396	10060	ABCC9	chr12	21947323	22104797	157474	ATP-binding cassette, sub-family C (CFTR/MRP), member 9
PA24396	215	ABCD1	chrX	152980323	153013216	32893	ATP-binding cassette, sub-family D (ALD), member 1
PA24401	225	ABCD2	chr12	39942022	40023843	81821	ATP-binding cassette, sub-family D (ALD), member 2
PA24402	5825	ABCD3	chr1	94873933	94987219	113286	ATP-binding cassette, sub-family D (ALD), member 3
PA24403	5826	ABCD4	chr14	74748980	74779767	30787	ATP-binding cassette, sub-family D (ALD), member 4
PA24404	6059	ABCE1	chr4	146009156	146053676	44520	ATP-binding cassette, sub-family E (OABP), member 1
PA24405	23	ABCF1	chr6	30529170	30562309	33139	ATP-binding cassette, sub-family F (GCN20), member 1
PA24406	10061	ABCF2	chr7	150901923	150934460	32537	ATP-binding cassette, sub-family F (GCN20), member 2
PA24407	55324	ABCF3	chr3	183893863	183914795	20932	ATP-binding cassette, sub-family F (GCN20), member 3
PA24408	9619	ABCG1	chr21	43609799	43727497	117698	ATP-binding cassette, sub-family G (WHITE), member 1
PA390	9429	ABCG2	chr4	89008416	89162569	154153	ATP-binding cassette, sub-family G (WHITE), member 2 (Junior blood group)
PA24410	64137	ABCG4	chr11	119009750	119036375	26625	ATP-binding cassette, sub-family G (WHITE), member 4
PA24411	64240	ABCG5	chr2	44036611	44076039	39428	ATP-binding cassette, sub-family G (WHITE), member 5
PA24412	64241	ABCG8	chr2	44056103	44108947	52844	ATP-binding cassette, sub-family G (WHITE), member 8
PA38459	84696	ABHD1	chr2	27336632	27356680	20048	abhydrolase domain containing 1
PA134978569	55347	ABHD10	chr3	111687723	111715215	27492	abhydrolase domain containing 10
PA38134	83451	ABHD11	chr7	73147424	73163190	15766	abhydrolase domain containing 11
PA25738	26090	ABHD12	chr20	25272379	25381618	109239	abhydrolase domain containing 12
PA162375213	145447	ABHD12B	chr14	51328878	51374688	45810	abhydrolase domain containing 12B
PA134862303	84945	ABHD13	chr13	108860763	108889603	28840	abhydrolase domain containing 13
PA142672659	25864	ABHD14A	chr3	51997700	52018216	20516	abhydrolase domain containing 14A
PA142672660	84836	ABHD14B	chr3	51999526	52018646	19120	abhydrolase domain containing 14B
PA164714659	116236	ABHD15	chr17	27884679	27904042	19363	abhydrolase domain containing 15
PA25266	7920	ABHD16A	chr6	31651726	31681137	29411	abhydrolase domain containing 16A
PA25677	140701	ABHD16B	chr20	62482566	62497341	14775	abhydrolase domain containing 16B
PA134947443	81926	ABHD17A	chr19	1873975	1895518	21543	abhydrolase domain containing 17A
PA162385609	648359	ABHD17AP3	chr1	214775795	214792589	16794	abhydrolase domain containing 17A pseudogene 3
PA162385617	729495	ABHD17AP4	chr22	21018885	21035627	16742	abhydrolase domain containing 17A pseudogene P4
PA162385624	51104	ABHD17B	chr9	74474368	74536148	61780	abhydrolase domain containing 17B
PA162385639	58489	ABHD17C	chr15	80977635	81050962	73327	abhydrolase domain containing 17C
PA38658	11057	ABHD2	chr15	89621381	89748591	127210	abhydrolase domain containing 2
PA38659	171586	ABHD3	chr18	19227858	19294766	66908	abhydrolase domain containing 3
PA128394705	63874	ABHD4	chr14	23057147	23084265	27118	abhydrolase domain containing 4
PA134891622	51099	ABHD5	chr3	43722375	43767217	44842	abhydrolase domain containing 5
PA134916787	57406	ABHD6	chr3	58213233	58283463	70230	abhydrolase domain containing 6
PA134994313	79575	ABHD8	chr19	17399940	17424282	24342	abhydrolase domain containing 8
PA36144	10006	ABI1	chr10	27032525	27160016	127491	abl-interactor 1
PA134977642	10152	ABI2	chr2	204182597	204299892	117295	abl-interactor 2
PA134951642	51225	ABI3	chr17	47277589	47303587	25998	ABI family, member 3
PA134977769	25890	ABI3BP	chr3	100465179	100722336	257157	ABI family, member 3 (NESH) binding protein
PA24413	25	ABL1	chr9	133578266	133766062	187796	ABL proto-oncogene 1, non-receptor tyrosine kinase
PA24414	27	ABL2	chr1	179065462	179208819	143357	ABL proto-oncogene 2, non-receptor tyrosine kinase
PA35023	3983	ABLIM1	chr10	116187869	116454762	266893	actin binding LIM protein 1
PA134940437	84448	ABLIM2	chr4	7964037	8170559	206522	actin binding LIM protein family, member 2
PA134962761	22885	ABLIM3	chr5	148511054	148643002	131948	actin binding LIM protein family, member 3
PA24417	29	ABR	chr17	903758	1100616	196858	active BCR-related
PA143485290	137735	ABRA	chr8	107768711	107792472	23761	actin-binding Rho activating protein
PA134884626	58527	ABRACL	chr6	139339819	139367439	27620	ABRA C-terminal like
PA38451	29777	ABT1	chr6	26587171	26603278	16107	activator of basal transcription 1
PA24418	80325	ABTB1	chr3	127381781	127402769	20988	ankyrin repeat and BTB (POZ) domain containing 1
PA134937734	25841	ABTB2	chr11	34169534	34389555	220021	ankyrin repeat and BTB (POZ) domain containing 2
PA24419	30	ACAA1	chr3	38161201	38188733	27532	acetyl-CoA acyltransferase 1
PA24420	10449	ACAA2	chr18	47306874	47350306	43432	acetyl-CoA acyltransferase 2
PA24421	31	ACACA	chr17	35438927	35776902	337975	acetyl-CoA carboxylase alpha
PA24422	32	ACACB	chr12	109544222	109709031	164809	acetyl-CoA carboxylase beta
PA134976754	80724	ACAD10	chr12	112113857	112197911	84054	acyl-CoA dehydrogenase family, member 10
PA142672658	84129	ACAD11	chr3	132273982	132388975	114993	acyl-CoA dehydrogenase family, member 11
PA24423	27034	ACAD8	chr11	134113428	134138749	25321	acyl-CoA dehydrogenase family, member 8
PA134900655	28976	ACAD9	chr3	128588333	128634957	46624	acyl-CoA dehydrogenase family, member 9
PA24424	33	ACADL	chr2	211049632	211100215	50583	acyl-CoA dehydrogenase, long chain
PA24425	34	ACADM	chr1	76180043	76232355	52312	acyl-CoA dehydrogenase, C-4 to C-12 straight chain
PA24426	35	ACADS	chr12	121153544	121180811	27267	acyl-CoA dehydrogenase, C-2 to C-3 short chain
PA24427	36	ACADSB	chr10	124758429	124820806	62377	acyl-CoA dehydrogenase, short/branched chain
PA24428	37	ACADVL	chr17	7110444	7131586	21142	acyl-CoA dehydrogenase, very long chain
PA24616	176	ACAN	chr15	89336674	89421585	84911	aggrecan
PA26406	9744	ACAP1	chr17	7229848	7257797	27949	ArfGAP with coiled-coil, ankyrin repeat and PH domains 1
PA26407	23527	ACAP2	chr3	194992465	195173817	181352	ArfGAP with coiled-coil, ankyrin repeat and PH domains 2
PA26408	116983	ACAP3	chr1	1224764	1253304	28540	ArfGAP with coiled-coil, ankyrin repeat and PH domains 3
PA24431	38	ACAT1	chr11	107982258	108021895	39637	acetyl-CoA acetyltransferase 1
PA19	39	ACAT2	chr6	160172989	160203087	30098	acetyl-CoA acetyltransferase 2
PA28803	64746	ACBD3	chr1	226329380	226384423	55043	acyl-CoA binding domain containing 3
PA134897893	79777	ACBD4	chr17	43199967	43224548	24581	acyl-CoA binding domain containing 4
PA134892991	91452	ACBD5	chr10	27481143	27541068	59925	acyl-CoA binding domain containing 5
PA134925459	84320	ACBD6	chr1	180254352	180482022	227670	acyl-CoA binding domain containing 6
PA134884059	414149	ACBD7	chr10	15054071	15140783	86712	acyl-CoA binding domain containing 7
PA162375284	84680	ACCS	chr11	44077729	44108791	31062	1-aminocyclopropane-1-carboxylate synthase homolog (Arabidopsis)(non-functional)
PA164714805	390110	ACCSL	chr11	44059531	44084527	24996	1-aminocyclopropane-1-carboxylate synthase homolog (Arabidopsis)(non-functional)-like
PA134882431	65057	ACD	chr16	67688415	67704718	16303	adrenocortical dysplasia homolog (mouse)
PA139	1636	ACE	chr17	61544422	61578741	34319	angiotensin I converting enzyme
PA425	59272	ACE2	chrX	15576156	15630192	54036	angiotensin I converting enzyme 2
PA164714838	125981	ACER1	chr19	6303510	6343640	40130	alkaline ceramidase 1
PA164714853	340485	ACER2	chr9	19398925	19455618	56693	alkaline ceramidase 2
PA33256	55331	ACER3	chr11	76561917	76737850	175933	alkaline ceramidase 3
PA20	43	ACHE	chr7	100484615	100503754	19139	acetylcholinesterase (Yt blood group)
PA134912489	22985	ACIN1	chr14	23524773	23574823	50050	apoptotic chromatin condensation inducer 1
PA28451	2532	ACKR1	chr1	159163803	159179290	15487	atypical chemokine receptor 1 (Duffy blood group)
PA26139	1238	ACKR2	chr3	42840964	42911775	70811	atypical chemokine receptor 2
PA162383053	57007	ACKR3	chr2	237459424	237494001	34577	atypical chemokine receptor 3
PA35036	51554	ACKR4	chr3	132306081	132324488	18407	atypical chemokine receptor 4
PA24441	47	ACLY	chr17	40020169	40096795	76626	ATP citrate lyase
PA134973312	130013	ACMSD	chr2	135585994	135662604	76610	aminocarboxymuconate semialdehyde decarboxylase
PA134976380	57001	ACN9	chr7	96735905	96814075	78170	ACN9 homolog (S. cerevisiae)
PA24442	48	ACO1	chr9	32374601	32453834	79233	aconitase 1, soluble
PA24443	50	ACO2	chr22	41855099	41927993	72894	aconitase 2, mitochondrial
PA162375318	641371	ACOT1	chr14	73993862	74013503	19641	acyl-CoA thioesterase 1
PA38303	26027	ACOT11	chr1	54997930	55103417	105487	acyl-CoA thioesterase 11
PA142672657	134526	ACOT12	chr5	80622731	80699988	77257	acyl-CoA thioesterase 12
PA165617655	55856	ACOT13	chr6	24657263	24708297	51034	acyl-CoA thioesterase 13
PA142672653	10965	ACOT2	chr14	74024324	74045362	21038	acyl-CoA thioesterase 2
PA142672654	122970	ACOT4	chr14	74048410	74065470	17060	acyl-CoA thioesterase 4
PA162375329	641372	ACOT6	chr14	74073548	74089592	16044	acyl-CoA thioesterase 6
PA142672655	11332	ACOT7	chr1	6321332	6463826	142494	acyl-CoA thioesterase 7
PA33941	10005	ACOT8	chr20	44467360	44496048	28688	acyl-CoA thioesterase 8
PA142672656	23597	ACOT9	chrX	23718777	23794592	75815	acyl-CoA thioesterase 9
PA21	51	ACOX1	chr17	73934588	73985515	50927	acyl-CoA oxidase 1, palmitoyl
PA24444	8309	ACOX2	chr3	58487863	58532929	45066	acyl-CoA oxidase 2, branched chain
PA24445	8310	ACOX3	chr4	8365009	8452452	87443	acyl-CoA oxidase 3, pristanoyl
PA134932567	55289	ACOXL	chr2	111480150	111878799	398649	acyl-CoA oxidase-like
PA24446	52	ACP1	chr2	254869	281283	26414	acid phosphatase 1, soluble
PA24447	53	ACP2	chr11	47257853	47280457	22604	acid phosphatase 2, lysosomal
PA24448	54	ACP5	chr19	11682475	11699801	17326	acid phosphatase 5, tartrate resistant
PA134930830	51205	ACP6	chr1	147116168	147152634	36466	acid phosphatase 6, lysophosphatidic
PA24449	55	ACPP	chr3	132026211	132090146	63935	acid phosphatase, prostate
PA24450	93650	ACPT	chr19	51283672	51301481	17809	acid phosphatase, testicular
PA24451	49	ACR	chr22	51166652	51186727	20075	acrosin
PA24452	84519	ACRBP	chr12	6744241	6766594	22353	acrosin binding protein
PA24453	93953	ACRC	chrX	70787840	70836440	48600	acidic repeat containing
PA24454	56	ACRV1	chr11	125539229	125560809	21580	acrosomal vesicle protein 1
PA142672648	23205	ACSBG1	chr15	78460187	78537049	76862	acyl-CoA synthetase bubblegum family member 1
PA142672649	81616	ACSBG2	chr19	6125654	6196113	70459	acyl-CoA synthetase bubblegum family member 2
PA162375338	80221	ACSF2	chr17	48493519	48555200	61681	acyl-CoA synthetase family member 2
PA162375375	197322	ACSF3	chr16	89150217	89225171	74954	acyl-CoA synthetase family member 3
PA27966	2180	ACSL1	chr4	185673749	185757215	83466	acyl-CoA synthetase long-chain family member 1
PA27967	2181	ACSL3	chr2	223715732	223811119	95387	acyl-CoA synthetase long-chain family member 3
PA27968	2182	ACSL4	chrX	108881564	108986621	105057	acyl-CoA synthetase long-chain family member 4
PA27969	51703	ACSL5	chr10	114123916	114191138	67222	acyl-CoA synthetase long-chain family member 5
PA27970	23305	ACSL6	chr5	131282666	131357761	75095	acyl-CoA synthetase long-chain family member 6
PA25468	116285	ACSM1	chr16	20631555	20719066	87511	acyl-CoA synthetase medium-chain family member 1
PA162375402	123876	ACSM2A	chr16	20452846	20501991	49145	acyl-CoA synthetase medium-chain family member 2A
PA162375437	348158	ACSM2B	chr16	20545080	20597695	52615	acyl-CoA synthetase medium-chain family member 2B
PA34930	6296	ACSM3	chr16	20765312	20811479	46167	acyl-CoA synthetase medium-chain family member 3
PA162375472	341392	ACSM4	chr12	7446928	7483969	37041	acyl-CoA synthetase medium-chain family member 4
PA162375501	54988	ACSM5	chr16	20410850	20455290	44440	acyl-CoA synthetase medium-chain family member 5
PA134905303	142827	ACSM6	chr10	96943957	96991686	47729	acyl-CoA synthetase medium-chain family member 6
PA24430	84532	ACSS1	chr20	24983866	25048818	64952	acyl-CoA synthetase short-chain family member 1
PA24429	55902	ACSS2	chr20	33452766	33518769	66003	acyl-CoA synthetase short-chain family member 2
PA162375534	79611	ACSS3	chr12	81461797	81653538	191741	acyl-CoA synthetase short-chain family member 3
PA24455	58	ACTA1	chr1	229563992	229579858	15866	actin, alpha 1, skeletal muscle
PA24456	59	ACTA2	chr10	90691831	90761147	69316	actin, alpha 2, smooth muscle, aorta
PA24457	60	ACTB	chr7	5563779	5580232	16453	actin, beta
PA142672651	345651	ACTBL2	chr5	56772843	56788636	15793	actin, beta-like 2
PA162375571	70	ACTC1	chr15	35077297	35097927	20630	actin, alpha, cardiac muscle 1
PA24468	71	ACTG1	chr17	79473997	79489892	15895	actin, gamma 1
PA24469	72	ACTG2	chr2	74110093	74149780	39687	actin, gamma 2, smooth muscle, enteric
PA25676	170487	ACTL10	chr20	32244304	32259331	15027	actin-like 10
PA134914203	86	ACTL6A	chr3	179270708	179309193	38485	actin-like 6A
PA24482	51412	ACTL6B	chr7	100237720	100264084	26364	actin-like 6B
PA24483	10881	ACTL7A	chr9	111614603	111629035	14432	actin-like 7A
PA24484	10880	ACTL7B	chr9	111613868	111628275	14407	actin-like 7B
PA142672644	81569	ACTL8	chr1	18071808	18156558	84750	actin-like 8
PA165392996	284382	ACTL9	chr19	8804751	8819172	14421	actin-like 9
PA24	87	ACTN1	chr14	69337840	69456083	118243	actinin, alpha 1
PA25	88	ACTN2	chr1	236839754	236930931	91177	actinin, alpha 2
PA24485	89	ACTN3	chr11	66304312	66333799	29487	actinin, alpha 3 (gene/pseudogene)
PA23	81	ACTN4	chr19	39128256	39224336	96080	actinin, alpha 4
PA134899463	55860	ACTR10	chr14	58656833	58705354	48521	actin-related protein 10 homolog (S. cerevisiae)
PA24486	10121	ACTR1A	chr10	104235986	104272580	36594	ARP1 actin-related protein 1 homolog A, centractin alpha (yeast)
PA24487	10120	ACTR1B	chr2	98269402	98290561	21159	ARP1 actin-related protein 1 homolog B, centractin beta (yeast)
PA24488	10097	ACTR2	chr2	65444829	65501387	56558	ARP2 actin-related protein 2 homolog (yeast)
PA24489	10096	ACTR3	chr2	114637511	114722131	84620	ARP3 actin-related protein 3 homolog (yeast)
PA142672645	57180	ACTR3B	chr7	152446834	152555464	108630	ARP3 actin-related protein 3 homolog B (yeast)
PA165617588	653857	ACTR3C	chr7	149941301	150030758	89457	ARP3 actin-related protein 3 homolog C (yeast)
PA24490	79913	ACTR5	chr20	37366933	37404089	37156	ARP5 actin-related protein 5 homolog (yeast)
PA134984466	64431	ACTR6	chr12	100583865	100621202	37337	ARP6 actin-related protein 6 homolog (yeast)
PA24491	93973	ACTR8	chr3	53895959	53926229	30270	ARP8 actin-related protein 8 homolog (yeast)
PA142672646	139741	ACTRT1	chrX	127181941	127196382	14441	actin-related protein T1
PA142672647	140625	ACTRT2	chr1	2928046	2942467	14421	actin-related protein T2
PA24492	90	ACVR1	chr2	158589958	158742374	152416	activin A receptor, type I
PA24493	91	ACVR1B	chr12	52335451	52393863	58412	activin A receptor, type IB
PA134908988	130399	ACVR1C	chr2	158380279	158495399	115120	activin A receptor, type IC
PA24494	92	ACVR2A	chr2	148592086	148691396	99310	activin A receptor, type IIA
PA24495	93	ACVR2B	chr3	38485790	38537633	51843	activin A receptor, type IIB
PA24496	94	ACVRL1	chr12	52290657	52320145	29488	activin A receptor type II-like 1
PA24497	95	ACY1	chr3	52007300	52026218	18918	aminoacylase 1
PA134936640	91703	ACY3	chr11	67407026	67428130	21104	aspartoacylase (aminocyclase) 3
PA24499	97	ACYP1	chr14	75516924	75546181	29257	acylphosphatase 1, erythrocyte (common) type
PA24500	98	ACYP2	chr2	54332410	54535437	203027	acylphosphatase 2, muscle type
PA24503	100	ADA	chr20	43245160	43290376	45216	adenosine deaminase
PA162375590	132612	ADAD1	chr4	123290121	123353957	63836	adenosine deaminase domain containing 1 (testis-specific)
PA162375591	161931	ADAD2	chr16	84214723	84233772	19049	adenosine deaminase domain containing 2
PA142672643	161823	ADAL	chr15	43612872	43649096	36224	adenosine deaminase-like
PA24505	102	ADAM10	chr15	58884403	59052177	167774	ADAM metallopeptidase domain 10
PA24506	4185	ADAM11	chr17	42826405	42862214	35809	ADAM metallopeptidase domain 11
PA24507	8038	ADAM12	chr10	127697960	128087127	389167	ADAM metallopeptidase domain 12
PA24510	8751	ADAM15	chr1	155013748	155038252	24504	ADAM metallopeptidase domain 15
PA24512	6868	ADAM17	chr2	9626392	9705917	79525	ADAM metallopeptidase domain 17
PA24513	8749	ADAM18	chr8	39432087	39590583	158496	ADAM metallopeptidase domain 18
PA24514	8728	ADAM19	chr5	156819071	157012831	193760	ADAM metallopeptidase domain 19
PA24515	2515	ADAM2	chr8	39598254	39705808	107554	ADAM metallopeptidase domain 2
PA24516	8748	ADAM20	chr14	70986078	71032756	46678	ADAM metallopeptidase domain 20
PA24517	8747	ADAM21	chr14	70908874	70929622	20748	ADAM metallopeptidase domain 21
PA134948631	145241	ADAM21P1	chr14	70709470	70724518	15048	ADAM metallopeptidase domain 21 pseudogene 1
PA24518	53616	ADAM22	chr7	87553566	87835204	281638	ADAM metallopeptidase domain 22
PA24519	8745	ADAM23	chr2	207298268	207488854	190586	ADAM metallopeptidase domain 23
PA24523	10863	ADAM28	chr8	24141553	24215726	74173	ADAM metallopeptidase domain 28
PA24524	11086	ADAM29	chr4	175829509	175902331	72822	ADAM metallopeptidase domain 29
PA24525	11085	ADAM30	chr1	120433156	120449147	15991	ADAM metallopeptidase domain 30
PA134932610	203102	ADAM32	chr8	38955050	39145436	190386	ADAM metallopeptidase domain 32
PA24526	80332	ADAM33	chr20	3645620	3672755	27135	ADAM metallopeptidase domain 33
PA24530	255926	ADAM5	chr8	39162182	39277745	115563	ADAM metallopeptidase domain 5, pseudogene
PA24532	8756	ADAM7	chr8	24288509	24373273	84764	ADAM metallopeptidase domain 7
PA24533	101	ADAM8	chr10	135072920	135100489	27569	ADAM metallopeptidase domain 8
PA24534	8754	ADAM9	chr8	38844505	38965780	121275	ADAM metallopeptidase domain 9
PA24535	27299	ADAMDEC1	chr8	24231798	24266526	34728	ADAM-like, decysin 1
PA24536	9510	ADAMTS1	chr21	28205606	28227728	22122	ADAM metallopeptidase with thrombospondin type 1 motif, 1
PA24537	81794	ADAMTS10	chr19	8642124	8685588	43464	ADAM metallopeptidase with thrombospondin type 1 motif, 10
PA24538	81792	ADAMTS12	chr5	33520640	33902319	381679	ADAM metallopeptidase with thrombospondin type 1 motif, 12
PA24539	11093	ADAMTS13	chr9	136269459	136327525	58066	ADAM metallopeptidase with thrombospondin type 1 motif, 13
PA24540	140766	ADAMTS14	chr10	72422559	72525197	102638	ADAM metallopeptidase with thrombospondin type 1 motif, 14
PA24541	170689	ADAMTS15	chr11	130308869	130349539	40670	ADAM metallopeptidase with thrombospondin type 1 motif, 15
PA24542	170690	ADAMTS16	chr5	5130443	5323412	192969	ADAM metallopeptidase with thrombospondin type 1 motif, 16
PA24543	170691	ADAMTS17	chr15	100508643	100892183	383540	ADAM metallopeptidase with thrombospondin type 1 motif, 17
PA24544	170692	ADAMTS18	chr16	77313025	77479011	165986	ADAM metallopeptidase with thrombospondin type 1 motif, 18
PA24545	171019	ADAMTS19	chr5	128786103	129077376	291273	ADAM metallopeptidase with thrombospondin type 1 motif, 19
PA24546	9509	ADAMTS2	chr5	178534852	178782431	247579	ADAM metallopeptidase with thrombospondin type 1 motif, 2
PA134901626	80070	ADAMTS20	chr12	43745012	43955724	210712	ADAM metallopeptidase with thrombospondin type 1 motif, 20
PA24547	9508	ADAMTS3	chr4	73143686	73444516	300830	ADAM metallopeptidase with thrombospondin type 1 motif, 3
PA24548	9507	ADAMTS4	chr1	161156538	161178845	22307	ADAM metallopeptidase with thrombospondin type 1 motif, 4
PA24549	11096	ADAMTS5	chr21	28287231	28349439	62208	ADAM metallopeptidase with thrombospondin type 1 motif, 5
PA24550	11174	ADAMTS6	chr5	64441563	64787704	346141	ADAM metallopeptidase with thrombospondin type 1 motif, 6
PA24551	11173	ADAMTS7	chr15	79048545	79113805	65260	ADAM metallopeptidase with thrombospondin type 1 motif, 7
PA24552	11095	ADAMTS8	chr11	130271660	130308539	36879	ADAM metallopeptidase with thrombospondin type 1 motif, 8
PA24553	56999	ADAMTS9	chr3	64498330	64683676	185346	ADAM metallopeptidase with thrombospondin type 1 motif, 9
PA24554	92949	ADAMTSL1	chr9	18464079	18913948	449869	ADAMTS-like 1
PA134920655	9719	ADAMTSL2	chr9	136387286	136443641	56355	ADAMTS-like 2
PA134934525	57188	ADAMTSL3	chr15	84312838	84711594	398756	ADAMTS-like 3
PA134879921	54507	ADAMTSL4	chr1	150511846	150536413	24567	ADAMTS-like 4
PA134867057	339366	ADAMTSL5	chr19	1502017	1523188	21171	ADAMTS-like 5
PA26404	11033	ADAP1	chr7	934537	1005208	70671	ArfGAP with dual PH domains 1
PA26405	55803	ADAP2	chr17	29238698	29289340	50642	ArfGAP with dual PH domains 2
PA24555	103	ADAR	chr1	154551533	154610456	58923	adenosine deaminase, RNA-specific
PA24556	104	ADARB1	chr21	46484493	46649478	164985	adenosine deaminase, RNA-specific, B1
PA24557	105	ADARB2	chr10	1220253	1789670	569417	adenosine deaminase, RNA-specific, B2 (non-functional)
PA24558	23536	ADAT1	chr16	75619718	75667221	47503	adenosine deaminase, tRNA-specific 1
PA162375592	134637	ADAT2	chr6	143740969	143781841	40872	adenosine deaminase, tRNA-specific 2
PA162375609	113179	ADAT3	chr19	1895371	1916446	21075	adenosine deaminase, tRNA-specific 3
PA134861355	57143	ADCK1	chr14	78256426	78403297	146871	aarF domain containing kinase 1
PA134902329	90956	ADCK2	chr7	140362730	140398745	36015	aarF domain containing kinase 2
PA25999	56997	ADCK3	chr1	227074589	227178246	103657	aarF domain containing kinase 3
PA134988974	79934	ADCK4	chr19	41194434	41232790	38356	aarF domain containing kinase 4
PA134963849	203054	ADCK5	chr8	145587704	145621457	33753	aarF domain containing kinase 5
PA24560	107	ADCY1	chr7	45604125	45765715	161590	adenylate cyclase 1 (brain)
PA162375618	55811	ADCY10	chr1	167775357	167893608	118251	adenylate cyclase 10 (soluble)
PA24561	108	ADCY2	chr5	7386343	7833194	446851	adenylate cyclase 2 (brain)
PA164741137	109	ADCY3	chr2	25039038	25152602	113564	adenylate cyclase 3
PA24562	196883	ADCY4	chr14	24784555	24814277	29722	adenylate cyclase 4
PA24563	111	ADCY5	chr3	122998143	123177924	179781	adenylate cyclase 5
PA27	112	ADCY6	chr12	49156975	49192820	35845	adenylate cyclase 6
PA28	113	ADCY7	chr16	50268830	50355046	86216	adenylate cyclase 7
PA29	114	ADCY8	chr8	131789546	132063012	273466	adenylate cyclase 8 (brain)
PA30	115	ADCY9	chr16	4009650	4176186	166536	adenylate cyclase 9
PA24564	116	ADCYAP1	chr18	894366	915173	20807	adenylate cyclase activating polypeptide 1 (pituitary)
PA24565	117	ADCYAP1R1	chr7	31082076	31154093	72017	adenylate cyclase activating polypeptide 1 (pituitary) receptor type I
PA31	118	ADD1	chr4	2835454	2934803	99349	adducin 1 (alpha)
PA24566	119	ADD2	chr2	70885334	71005375	120041	adducin 2 (beta)
PA24567	120	ADD3	chr10	111755627	111898323	142696	adducin 3 (gamma)
PA24570	124	ADH1A	chr4	100194523	100222185	27662	alcohol dehydrogenase 1A (class I), alpha polypeptide
PA24571	125	ADH1B	chr4	100224527	100252572	28045	alcohol dehydrogenase 1B (class I), beta polypeptide
PA24572	126	ADH1C	chr4	100254649	100283917	29268	alcohol dehydrogenase 1C (class I), gamma polypeptide
PA24573	127	ADH4	chr4	100041832	100075449	33617	alcohol dehydrogenase 4 (class II), pi polypeptide
PA24574	128	ADH5	chr4	99989129	100019931	30802	alcohol dehydrogenase 5 (class III), chi polypeptide
PA24576	130	ADH6	chr4	100120795	100150403	29608	alcohol dehydrogenase 6 (class V)
PA24577	131	ADH7	chr4	100330418	100366667	36249	alcohol dehydrogenase 7 (class IV), mu or sigma polypeptide
PA134871493	137872	ADHFE1	chr8	67334693	67387260	52567	alcohol dehydrogenase, iron containing, 1
PA143485291	55256	ADI1	chr2	3498690	3533350	34660	acireductone dioxygenase 1
PA162375689	149685	ADIG	chr20	37199838	37220104	20266	adipogenin
PA134933118	9370	ADIPOQ	chr3	186550463	186579252	28789	adiponectin, C1Q and collagen domain containing
PA134861801	51094	ADIPOR1	chr1	202906960	202937700	30740	adiponectin receptor 1
PA128394711	79602	ADIPOR2	chr12	1790147	1900845	110698	adiponectin receptor 2
PA134930409	10974	ADIRF	chr10	88718188	88733666	15478	adipogenesis regulatory factor
PA24579	132	ADK	chr10	75900943	76472061	571118	adenosine kinase
PA24580	133	ADM	chr11	10316642	10331923	15281	adrenomedullin
PA134898869	79924	ADM2	chr22	50909985	50927866	17881	adrenomedullin 2
PA165393101	199800	ADM5	chr19	50181942	50197247	15305	adrenomedullin 5 (putative)
PA24582	23394	ADNP	chr20	49502585	49557527	54942	activity-dependent neuroprotector homeobox
PA162375700	22850	ADNP2	chr18	77856915	77901229	44314	ADNP homeobox 2
PA162375713	84890	ADO	chr10	64554516	64571239	16723	2-aminoethanethiol (cysteamine) dioxygenase
PA24583	134	ADORA1	chr1	203086833	203139533	52700	adenosine A1 receptor
PA24584	135	ADORA2A	chr22	24809565	24841328	31763	adenosine A2a receptor
PA24585	136	ADORA2B	chr17	15838231	15882210	43979	adenosine A2b receptor
PA24589	140	ADORA3	chr1	112022970	112116602	93632	adenosine A3 receptor
PA134971928	83440	ADPGK	chr15	73040708	73086126	45418	ADP-dependent glucokinase
PA24590	141	ADPRH	chr3	119288280	119311792	23512	ADP-ribosylarginine hydrolase
PA134870688	113622	ADPRHL1	chr13	114073260	114117839	44579	ADP-ribosylhydrolase like 1
PA134903576	54936	ADPRHL2	chr1	36544453	36562533	18080	ADP-ribosylhydrolase like 2
PA142672231	56985	ADPRM	chr17	10590927	10619264	28337	ADP-ribose/CDP-alcohol diphosphatase, manganese-dependent
PA34	148	ADRA1A	chr8	26602667	26737003	134336	adrenoceptor alpha 1A
PA33	147	ADRA1B	chr5	159333740	159403017	69277	adrenoceptor alpha 1B
PA24597	146	ADRA1D	chr20	4198278	4239659	41381	adrenoceptor alpha 1D
PA35	150	ADRA2A	chr10	112826790	112843665	16875	adrenoceptor alpha 2A
PA36	151	ADRA2B	chr2	96775623	96792281	16658	adrenoceptor alpha 2B
PA37	152	ADRA2C	chr4	3758296	3773253	14957	adrenoceptor alpha 2C
PA38	153	ADRB1	chr10	115793806	115809667	15861	adrenoceptor beta 1
PA39	154	ADRB2	chr5	148196156	148257628	61472	adrenoceptor beta 2, surface
PA24598	155	ADRB3	chr8	37817513	37834184	16671	adrenoceptor beta 3
PA40	156	ADRBK1	chr11	67023905	67057029	33124	adrenergic, beta, receptor kinase 1
PA41	157	ADRBK2	chr22	25950861	26128259	177398	adrenergic, beta, receptor kinase 2
PA24599	11047	ADRM1	chr20	60867112	60887206	20094	adhesion regulating molecule 1
PA24600	158	ADSL	chr22	40732504	40765577	33073	adenylosuccinate lyase
PA24601	159	ADSS	chr1	244568794	244625436	56642	adenylosuccinate synthase
PA134974111	122622	ADSSL1	chr14	105180534	105216662	36128	adenylosuccinate synthase like 1
PA134981312	84830	ADTRP	chr6	11708505	11789861	81356	androgen-dependent TFPI-regulating protein
PA24604	165	AEBP1	chr7	44133960	44157164	23204	AE binding protein 1
PA134875401	121536	AEBP2	chr12	19582608	19678173	95565	AE binding protein 2
PA162375720	64782	AEN	chr15	89154527	89178512	23985	apoptosis enhancing nuclease
PA24606	166	AES	chr19	3049908	3072964	23056	amino-terminal enhancer of split
PA162375733	60312	AFAP1	chr4	7757440	7951653	194213	actin filament associated protein 1
PA162375772	134265	AFAP1L1	chr5	148641401	148724368	82967	actin filament associated protein 1-like 1
PA162375773	84632	AFAP1L2	chr10	116038248	116174515	136267	actin filament associated protein 1-like 2
PA30851	4299	AFF1	chr4	87845758	88065206	219448	AF4/FMR2 family, member 1
PA28192	2334	AFF2	chrX	147572139	148085193	513054	AF4/FMR2 family, member 2
PA30264	3899	AFF3	chr2	100159326	100769037	609711	AF4/FMR2 family, member 3
PA142672641	27125	AFF4	chr5	132208071	132309354	101283	AF4/FMR2 family, member 4
PA24612	10939	AFG3L2	chr18	12325943	12387275	61332	AFG3-like AAA ATPase 2
PA24613	173	AFM	chr4	74337462	74372718	35256	afamin
PA134958475	125061	AFMID	chr17	76173398	76206782	33384	arylformamidase
PA24614	174	AFP	chr4	74291933	74324492	32559	alpha-fetoprotein
PA145149871	54812	AFTPH	chr2	64741439	64823139	81700	aftiphilin
PA24615	175	AGA	chr4	178348928	178373657	24729	aspartylglucosaminidase
PA26412	116987	AGAP1	chr2	236392733	237043444	650711	ArfGAP with GTPase domain, ankyrin repeat and PH domain 1
PA164714990	728127	AGAP10	chr10	47187590	47223514	35924	ArfGAP with GTPase domain, ankyrin repeat and PH domain 10
PA164715011	119385	AGAP11	chr10	88718239	88772960	54721	ankyrin repeat and GTPase domain Arf GTPase activating protein 11
PA26411	116986	AGAP2	chr12	58114544	58145984	31440	ArfGAP with GTPase domain, ankyrin repeat and PH domain 2
PA26413	116988	AGAP3	chr7	150772918	150844523	71605	ArfGAP with GTPase domain, ankyrin repeat and PH domain 3
PA164715122	119016	AGAP4	chr10	46318040	46368501	50461	ArfGAP with GTPase domain, ankyrin repeat and PH domain 4
PA164715123	729092	AGAP5	chr10	75431033	75474357	43324	ArfGAP with GTPase domain, ankyrin repeat and PH domain 5
PA164715148	414189	AGAP6	chr10	51722867	51773259	50392	ArfGAP with GTPase domain, ankyrin repeat and PH domain 6
PA164715167	653268	AGAP7	chr10	51461151	51496327	35176	ArfGAP with GTPase domain, ankyrin repeat and PH domain 7
PA164715168	728404	AGAP8	chr10	51221667	51272116	50449	ArfGAP with GTPase domain, ankyrin repeat and PH domain 8
PA164715169	642517	AGAP9	chr10	48205724	48240508	34784	ArfGAP with GTPase domain, ankyrin repeat and PH domain 9
PA134923894	123624	AGBL1	chr15	86613137	87575283	962146	ATP/GTP binding protein-like 1
PA142672634	79841	AGBL2	chr11	47678143	47746928	68785	ATP/GTP binding protein-like 2
PA142672635	340351	AGBL3	chr7	134661259	134823530	162271	ATP/GTP binding protein-like 3
PA142672636	84871	AGBL4	chr1	48995527	50499626	1504099	ATP/GTP binding protein-like 4
PA162375816	60509	AGBL5	chr2	27264291	27296490	32199	ATP/GTP binding protein-like 5
PA24617	177	AGER	chr6	32145745	32162099	16354	advanced glycosylation end product-specific receptor
PA29449	3267	AGFG1	chr2	228326853	228428938	102085	ArfGAP with FG repeats 1
PA29451	3268	AGFG2	chr7	100126834	100168843	42009	ArfGAP with FG repeats 2
PA134951291	55109	AGGF1	chr5	76316210	76364059	47849	angiogenic factor with G patch and FHA domains 1
PA162375851	55750	AGK	chr7	141241078	141357209	116131	acylglycerol kinase
PA24618	178	AGL	chr1	100305633	100392579	86946	amylo-alpha-1, 6-glucosidase, 4-alpha-glucanotransferase
PA24619	79814	AGMAT	chr1	15895194	15921605	26411	agmatine ureohydrolase (agmatinase)
PA162406334	392636	AGMO	chr7	15236943	15611640	374697	alkylglycerol monooxygenase
PA27693	26523	AGO1	chr1	36325412	36398211	72799	argonaute RISC catalytic component 1
PA27694	27161	AGO2	chr8	141538264	141655646	117382	argonaute RISC catalytic component 2
PA38329	192669	AGO3	chr1	36386364	36525360	138996	argonaute RISC catalytic component 3
PA38330	192670	AGO4	chr1	36263231	36326491	63260	argonaute RISC catalytic component 4
PA24621	10554	AGPAT1	chr6	32132983	32155888	22905	1-acylglycerol-3-phosphate O-acyltransferase 1
PA24622	10555	AGPAT2	chr9	139564595	139591911	27316	1-acylglycerol-3-phosphate O-acyltransferase 2
PA24623	56894	AGPAT3	chr21	45275116	45410475	135359	1-acylglycerol-3-phosphate O-acyltransferase 3
PA134961047	56895	AGPAT4	chr6	161548057	161705107	157050	1-acylglycerol-3-phosphate O-acyltransferase 4
PA165618159	79992	AGPAT4-IT1	chr6	161578146	161593014	14868	AGPAT4 intronic transcript 1 (non-protein coding)
PA134952751	55326	AGPAT5	chr8	6555878	6622024	66146	1-acylglycerol-3-phosphate O-acyltransferase 5
PA142672637	137964	AGPAT6	chr8	41425702	41485520	59818	1-acylglycerol-3-phosphate O-acyltransferase 6
PA162375888	84803	AGPAT9	chr4	84446886	84530028	83142	1-acylglycerol-3-phosphate O-acyltransferase 9
PA24624	8540	AGPS	chr2	178247471	178411564	164093	alkylglycerone phosphate synthase
PA24625	10551	AGR2	chr7	16828437	16854738	26301	anterior gradient 2
PA162375917	155465	AGR3	chr7	16896030	16931613	35583	anterior gradient 3
PA24626	375790	AGRN	chr1	945503	994499	48996	agrin
PA24627	181	AGRP	chr16	67513474	67527716	14242	agouti related neuropeptide
PA42	183	AGT	chr1	230835269	230860336	25067	angiotensinogen (serpin peptidase inhibitor, clade A, member 8)
PA24630	23287	AGTPBP1	chr9	88158454	88366944	208490	ATP/GTP binding protein 1
PA43	185	AGTR1	chr3	148405658	148463790	58132	angiotensin II receptor, type 1
PA44	186	AGTR2	chrX	115291958	115309225	17267	angiotensin II receptor, type 2
PA38363	57085	AGTRAP	chr1	11786142	11813828	27686	angiotensin II receptor-associated protein
PA24633	189	AGXT	chr2	241798162	241821536	23374	alanine-glyoxylate aminotransferase
PA24634	64902	AGXT2	chr5	34995206	35058293	63087	alanine--glyoxylate aminotransferase 2
PA142672631	25909	AHCTF1	chr1	246999400	247104726	105326	AT hook containing transcription factor 1
PA142672632	285116	AHCTF1P1	chr2	162352578	162374413	21835	AT hook containing transcription factor 1 pseudogene 1
PA24636	191	AHCY	chr20	32865071	32909608	44537	adenosylhomocysteinase
PA24637	10768	AHCYL1	chr1	110517387	110569364	51977	adenosylhomocysteinase-like 1
PA162376046	23382	AHCYL2	chr7	128854855	129073052	218197	adenosylhomocysteinase-like 2
PA142672633	27245	AHDC1	chr1	27857756	27940463	82707	AT hook, DNA binding motif, containing 1
PA134874587	54806	AHI1	chr6	135601670	135828903	227233	Abelson helper integration site 1
PA24640	79026	AHNAK	chr11	62198014	62324332	126318	AHNAK nucleoprotein
PA162376085	113146	AHNAK2	chr14	105400590	105454694	54104	AHNAK nucleoprotein 2
PA24641	196	AHR	chr7	17328276	17388775	60499	aryl hydrocarbon receptor
PA24639	57491	AHRR	chr5	294291	441406	147115	aryl-hydrocarbon receptor repressor
PA25515	10598	AHSA1	chr14	77914373	77938815	24442	AHA1, activator of heat shock 90kDa protein ATPase homolog 1 (yeast)
PA134913389	130872	AHSA2	chr2	61394553	61418240	23687	AHA1, activator of heat shock 90kDa protein ATPase homolog 2 (yeast)
PA24642	197	AHSG	chr3	186320850	186342107	21257	alpha-2-HS-glycoprotein
PA27842	51327	AHSP	chr16	31529203	31543125	13922	alpha hemoglobin stabilizing protein
PA24644	57379	AICDA	chr12	8751762	8775463	23701	activation-induced cytidine deaminase
PA162376104	64853	AIDA	chr1	222838355	222896602	58247	axin interactor, dorsalization associated
PA24646	199	AIF1	chr6	31572969	31587798	14829	allograft inflammatory factor 1
PA164715250	83543	AIF1L	chr9	133961863	134001539	39676	allograft inflammatory factor 1-like
PA162376129	9131	AIFM1	chrX	129260337	129309861	49524	apoptosis-inducing factor, mitochondrion-associated, 1
PA162376150	84883	AIFM2	chr10	71869023	71902832	33809	apoptosis-inducing factor, mitochondrion-associated, 2
PA162376173	150209	AIFM3	chr22	21309418	21338649	29231	apoptosis-inducing factor, mitochondrion-associated, 3
PA134991331	51390	AIG1	chr6	143371979	143664441	292462	androgen-induced 1
PA24649	202	AIM1	chr6	106798683	107021335	222652	absent in melanoma 1
PA24650	55057	AIM1L	chr1	26645350	26690621	45271	absent in melanoma 1-like
PA24651	9447	AIM2	chr1	159025790	159056685	30895	absent in melanoma 2
PA35578	9255	AIMP1	chr4	107226767	107273382	46615	aminoacyl tRNA synthetase complex-interacting multifunctional protein 1
PA165617609	7965	AIMP2	chr7	6038882	6066465	27583	aminoacyl tRNA synthetase complex-interacting multifunctional protein 2
PA24652	9049	AIP	chr11	67240505	67261579	21074	aryl hydrocarbon receptor interacting protein
PA24653	23746	AIPL1	chr17	6324057	6348576	24519	aryl hydrocarbon receptor interacting protein-like 1
PA24654	326	AIRE	chr21	45695721	45721102	25381	autoimmune regulator
PA142672629	55966	AJAP1	chr1	4705105	4846851	141746	adherens junctions associated protein 1
PA134978308	84962	AJUBA	chr14	23437386	23461851	24465	ajuba LIM protein
PA24655	203	AK1	chr9	130625759	130650022	24263	adenylate kinase 1
PA24656	204	AK2	chr1	33470541	33512512	41971	adenylate kinase 2
PA164741184	50808	AK3	chr9	4706556	4752043	45487	adenylate kinase 3
PA165750325	205	AK4	chr1	65603232	65700828	97596	adenylate kinase 4
PA24659	26289	AK5	chr1	77737662	78028654	290992	adenylate kinase 5
PA134963502	122481	AK7	chr14	96848448	96958764	110316	adenylate kinase 7
PA134971772	158067	AK8	chr9	135597958	135764198	166240	adenylate kinase 8
PA164715271	221264	AK9	chr6	109811059	110022415	211356	adenylate kinase 9
PA24661	8165	AKAP1	chr17	55152553	55201710	49157	A kinase (PRKA) anchor protein 1
PA24662	11216	AKAP10	chr17	19804765	19891169	86404	A kinase (PRKA) anchor protein 10
PA24663	11215	AKAP11	chr13	42836261	42900403	64142	A kinase (PRKA) anchor protein 11
PA24664	9590	AKAP12	chr6	151551134	151682694	131560	A kinase (PRKA) anchor protein 12
PA24665	11214	AKAP13	chr15	85913818	86295589	381771	A kinase (PRKA) anchor protein 13
PA134914893	158798	AKAP14	chrX	119019936	119057679	37743	A kinase (PRKA) anchor protein 14
PA162402969	8227	AKAP17A	chrY	1650486	1674413	23927	A kinase (PRKA) anchor protein 17A
PA24666	11217	AKAP2	chr9	112800878	112937792	136914	A kinase (PRKA) anchor protein 2
PA24667	10566	AKAP3	chr12	4720837	4768213	47376	A kinase (PRKA) anchor protein 3
PA24668	8852	AKAP4	chrX	49952411	49975664	23253	A kinase (PRKA) anchor protein 4
PA24669	9495	AKAP5	chr14	64922217	64944221	22004	A kinase (PRKA) anchor protein 5
PA24670	9472	AKAP6	chr14	32788479	33305268	516789	A kinase (PRKA) anchor protein 6
PA24671	9465	AKAP7	chr6	131446826	131607675	160849	A kinase (PRKA) anchor protein 7
PA24672	10270	AKAP8	chr19	15461332	15500638	39306	A kinase (PRKA) anchor protein 8
PA134867364	26993	AKAP8L	chr19	15487859	15539916	52057	A kinase (PRKA) anchor protein 8-like
PA24673	10142	AKAP9	chr7	91560181	91742987	182806	A kinase (PRKA) anchor protein 9
PA25484	56672	AKIP1	chr11	8922701	8944626	21925	A kinase (PRKA) interacting protein 1
PA162376180	79647	AKIRIN1	chr1	39446916	39474737	27821	akirin 1
PA162376195	55122	AKIRIN2	chr6	88381578	88421985	40407	akirin 2
PA134908332	80709	AKNA	chr9	117093429	117170783	77354	AT-hook transcription factor
PA165750356	254268	AKNAD1	chr1	109355520	109410864	55344	AKNA domain containing 1
PA24674	10327	AKR1A1	chr1	46006455	46038723	32268	aldo-keto reductase family 1, member A1 (aldehyde reductase)
PA24675	231	AKR1B1	chr7	134124107	134153888	29781	aldo-keto reductase family 1, member B1 (aldose reductase)
PA24676	57016	AKR1B10	chr7	134202344	134229166	26822	aldo-keto reductase family 1, member B10 (aldose reductase)
PA165617622	441282	AKR1B15	chr7	134223849	134267615	43766	aldo-keto reductase family 1, member B15
PA24677	1645	AKR1C1	chr10	4995454	5023158	27704	aldo-keto reductase family 1, member C1
PA24678	1646	AKR1C2	chr10	5026967	5070225	43258	aldo-keto reductase family 1, member C2
PA24679	8644	AKR1C3	chr10	5080958	5152878	71920	aldo-keto reductase family 1, member C3
PA24680	1109	AKR1C4	chr10	5228798	5263910	35112	aldo-keto reductase family 1, member C4
PA24681	6718	AKR1D1	chr7	137751178	137806050	54872	aldo-keto reductase family 1, member D1
PA165548224	83592	AKR1E2	chr10	4858369	4893254	34885	aldo-keto reductase family 1, member E2
PA24682	8574	AKR7A2	chr1	19626202	19648640	22438	aldo-keto reductase family 7, member A2 (aflatoxin aldehyde reductase)
PA24683	22977	AKR7A3	chr1	19606057	19625280	19223	aldo-keto reductase family 7, member A3 (aflatoxin aldehyde reductase)
PA24684	207	AKT1	chr14	105232686	105272080	39394	v-akt murine thymoma viral oncogene homolog 1
PA134943587	84335	AKT1S1	chr19	50369290	50391613	22323	AKT1 substrate 1 (proline-rich)
PA24685	208	AKT2	chr19	40733224	40801443	68219	v-akt murine thymoma viral oncogene homolog 2
PA24686	10000	AKT3	chr1	243648535	244024381	375846	v-akt murine thymoma viral oncogene homolog 3
PA162376210	64400	AKTIP	chr16	53522192	53548323	26131	AKT interacting protein
PA24687	210	ALAD	chr9	116145592	116173618	28026	aminolevulinate dehydratase
PA24688	211	ALAS1	chr3	52222099	52251343	29244	5'-aminolevulinate synthase 1
PA24689	212	ALAS2	chrX	55032488	55067497	35009	5'-aminolevulinate synthase 2
PA24690	213	ALB	chr4	74259972	74290129	30157	albumin
PA24691	214	ALCAM	chr3	105075557	105298757	223200	activated leukocyte cell adhesion molecule
PA134903503	126133	ALDH16A1	chr19	49946473	49977305	30832	aldehyde dehydrogenase 16 family, member A1
PA34065	5832	ALDH18A1	chr10	97362686	97426759	64073	aldehyde dehydrogenase 18 family, member A1
PA24692	216	ALDH1A1	chr9	75512578	75663633	151055	aldehyde dehydrogenase 1 family, member A1
PA24693	8854	ALDH1A2	chr15	58242622	58368121	125499	aldehyde dehydrogenase 1 family, member A2
PA24694	220	ALDH1A3	chr15	101409897	101459831	49934	aldehyde dehydrogenase 1 family, member A3
PA24695	219	ALDH1B1	chr9	38382661	38401662	19001	aldehyde dehydrogenase 1 family, member B1
PA28393	10840	ALDH1L1	chr3	125819404	125910029	90625	aldehyde dehydrogenase 1 family, member L1
PA134928545	160428	ALDH1L2	chr12	105410562	105488341	77779	aldehyde dehydrogenase 1 family, member L2
PA24696	217	ALDH2	chr12	112194691	112250789	56098	aldehyde dehydrogenase 2 family (mitochondrial)
PA24697	218	ALDH3A1	chr17	19638297	19661746	23449	aldehyde dehydrogenase 3 family, member A1
PA24698	224	ALDH3A2	chr17	19542064	19583908	41844	aldehyde dehydrogenase 3 family, member A2
PA24700	222	ALDH3B2	chr11	67426633	67458685	32052	aldehyde dehydrogenase 3 family, member B2
PA24701	8659	ALDH4A1	chr1	19194924	19239293	44369	aldehyde dehydrogenase 4 family, member A1
PA24702	7915	ALDH5A1	chr6	24485197	24540435	55238	aldehyde dehydrogenase 5 family, member A1
PA24703	4329	ALDH6A1	chr14	74521365	74561196	39831	aldehyde dehydrogenase 6 family, member A1
PA24704	501	ALDH7A1	chr5	125874533	125941104	66571	aldehyde dehydrogenase 7 family, member A1
PA24705	64577	ALDH8A1	chr6	135235528	135281260	45732	aldehyde dehydrogenase 8 family, member A1
PA24706	223	ALDH9A1	chr1	165628449	165677900	49451	aldehyde dehydrogenase 9 family, member A1
PA24707	226	ALDOA	chr16	30054411	30084741	30330	aldolase A, fructose-bisphosphate
PA24710	229	ALDOB	chr9	104179842	104208062	28220	aldolase B, fructose-bisphosphate
PA24711	230	ALDOC	chr17	26897133	26914282	17149	aldolase C, fructose-bisphosphate
PA134979319	56052	ALG1	chr16	5111810	5140380	28570	ALG1, chitobiosyldiphosphodolichol beta-mannosyltransferase
PA134732019	84920	ALG10	chr12	34165216	34184237	19021	ALG10, alpha-1,2-glucosyltransferase
PA134936082	144245	ALG10B	chr12	38700557	38726528	25971	ALG10B, alpha-1,2-glucosyltransferase
PA144596518	440138	ALG11	chr13	52576523	52606784	30261	ALG11, alpha-1,2-mannosyltransferase
PA134987771	79087	ALG12	chr22	50293852	50322106	28254	ALG12, alpha-1,6-mannosyltransferase
PA162376235	79868	ALG13	chrX	110914346	111006877	92531	ALG13, UDP-N-acetylglucosaminyltransferase subunit
PA142672628	199857	ALG14	chr1	95445279	95548512	103233	ALG14, UDP-N-acetylglucosaminyltransferase subunit
PA165696816	200810	ALG1L	chr3	125644459	125719383	74924	ALG1, chitobiosyldiphosphodolichol beta-mannosyltransferase-like
PA165696819	644974	ALG1L2	chr3	129790674	129820233	29559	ALG1, chitobiosyldiphosphodolichol beta-mannosyltransferase-like 2
PA134956849	85365	ALG2	chr9	101975707	101994246	18539	ALG2, alpha-1,3/1,6-mannosyltransferase
PA134897460	10195	ALG3	chr3	183957117	183977313	20196	ALG3, alpha-1,3- mannosyltransferase
PA134977026	29880	ALG5	chr13	37520907	37583504	62597	ALG5, dolichyl-phosphate beta-glucosyltransferase
PA134925619	29929	ALG6	chr1	63823261	63907233	83972	ALG6, alpha-1,3-glucosyltransferase
PA134942124	79053	ALG8	chr11	77808988	77860699	51711	ALG8, alpha-1,3-glucosyltransferase
PA134887582	79796	ALG9	chr11	111649919	111752305	102386	ALG9, alpha-1,2-mannosyltransferase
PA24719	238	ALK	chr2	29412640	30154477	741837	anaplastic lymphoma receptor tyrosine kinase
PA134906996	8846	ALKBH1	chr14	78135749	78184365	48616	alkB, alkylation repair homolog 1 (E. coli)
PA143485292	121642	ALKBH2	chr12	109522993	109541436	18443	alkB, alkylation repair homolog 2 (E. coli)
PA143485293	221120	ALKBH3	chr11	43892357	43944825	52468	alkB, alkylation repair homolog 3 (E. coli)
PA143485294	54784	ALKBH4	chr7	102093667	102115321	21654	alkB, alkylation repair homolog 4 (E. coli)
PA142671230	54890	ALKBH5	chr17	18076867	18116268	39401	AlkB family member 5, RNA demethylase
PA143485295	84964	ALKBH6	chr19	36497022	36515145	18123	alkB, alkylation repair homolog 6 (E. coli)
PA134905040	84266	ALKBH7	chr19	6362444	6378261	15817	alkB, alkylation repair homolog 7 (E. coli)
PA143485296	91801	ALKBH8	chr11	107370453	107446468	76015	alkB, alkylation repair homolog 8 (E. coli)
PA24720	55821	ALLC	chr2	3695786	3753261	57475	allantoicase
PA24721	7840	ALMS1	chr2	73602886	73840047	237161	Alstrom syndrome 1
PA45	239	ALOX12	chr17	6889384	6917055	27671	arachidonate 12-lipoxygenase
PA24722	242	ALOX12B	chr17	7972954	8001021	28067	arachidonate 12-lipoxygenase, 12R type
PA48	246	ALOX15	chr17	4531214	4555583	24369	arachidonate 15-lipoxygenase
PA24725	247	ALOX15B	chr17	7932343	7955452	23109	arachidonate 15-lipoxygenase, type B
PA46	240	ALOX5	chr10	45859624	45944569	84945	arachidonate 5-lipoxygenase
PA47	241	ALOX5AP	chr13	31277615	31341565	63950	arachidonate 5-lipoxygenase-activating protein
PA24727	59344	ALOXE3	chr17	7996218	8032365	36147	arachidonate lipoxygenase 3
PA24728	248	ALPI	chr2	233310833	233328455	17622	alkaline phosphatase, intestinal
PA134891785	80216	ALPK1	chr4	113208480	113366774	158294	alpha-kinase 1
PA134916108	115701	ALPK2	chr18	56145479	56306189	160710	alpha-kinase 2
PA134921552	57538	ALPK3	chr15	85349911	85419713	69802	alpha-kinase 3
PA24729	249	ALPL	chr1	21825475	21907905	82430	alkaline phosphatase, liver/bone/kidney
PA24730	250	ALPP	chr2	233233348	233250599	17251	alkaline phosphatase, placental
PA24731	251	ALPPL2	chr2	233261552	233278424	16872	alkaline phosphatase, placental-like 2
PA24732	57679	ALS2	chr2	202561986	202655895	93909	amyotrophic lateral sclerosis 2 (juvenile)
PA134949717	259173	ALS2CL	chr3	46707485	46745194	37709	ALS2 C-terminal like
PA24734	151254	ALS2CR11	chr2	202349144	202493905	144761	amyotrophic lateral sclerosis 2 (juvenile) chromosome region, candidate 11
PA24735	130540	ALS2CR12	chr2	202150147	202232101	81954	amyotrophic lateral sclerosis 2 (juvenile) chromosome region, candidate 12
PA162376294	8092	ALX1	chr12	85663713	85698562	34849	ALX homeobox 1
PA24754	257	ALX3	chr1	110599997	110623322	23325	ALX homeobox 3
PA24755	60529	ALX4	chr11	44279278	44341735	62457	ALX homeobox 4
PA134925107	10189	ALYREF	chr17	79842711	79859464	16753	Aly/REF export factor
PA24757	23600	AMACR	chr5	33984091	34018220	34129	alpha-methylacyl-CoA racemase
PA24758	258	AMBN	chr4	71447975	71476005	28030	ameloblastin (enamel matrix protein)
PA24759	259	AMBP	chr9	116819407	116850752	31345	alpha-1-microglobulin/bikunin precursor
PA162376307	55626	AMBRA1	chr11	46414962	46625619	210657	autophagy/beclin-1 regulator 1
PA24763	262	AMD1	chr6	111125823	111219916	94093	adenosylmethionine decarboxylase 1
PA143485297	144193	AMDHD1	chr12	96327071	96365370	38299	amidohydrolase domain containing 1
PA143485298	51005	AMDHD2	chr16	2560363	2583955	23592	amidohydrolase domain containing 2
PA24766	265	AMELX	chrX	11301533	11321881	20348	amelogenin, X-linked
PA24767	266	AMELY	chrY	6730959	6752068	21109	amelogenin, Y-linked
PA145148904	139285	AMER1	chrX	63401997	63435624	33627	APC membrane recruitment protein 1
PA145148898	219287	AMER2	chr13	25732817	25756426	23609	APC membrane recruitment protein 2
PA162385791	205147	AMER3	chr2	131503077	131528707	25630	APC membrane recruitment protein 3
PA24768	267	AMFR	chr16	56392364	56469450	77086	autocrine motility factor receptor, E3 ubiquitin protein ligase
PA24769	268	AMH	chr19	2239113	2255072	15959	anti-Mullerian hormone
PA24770	269	AMHR2	chr12	53807594	53828439	20845	anti-Mullerian hormone receptor, type II
PA38792	120425	AMICA1	chr11	118061442	118105809	44367	adhesion molecule, interacts with CXADR antigen 1
PA142672625	57463	AMIGO1	chr1	110046446	110062336	15890	adhesion molecule with Ig-like domain 1
PA142672626	347902	AMIGO2	chr12	47466490	47483734	17244	adhesion molecule with Ig-like domain 2
PA142672627	386724	AMIGO3	chr3	49751267	49767238	15971	adhesion molecule with Ig-like domain 3
PA24772	9949	AMMECR1	chrX	109434414	109693461	259047	Alport syndrome, mental retardation, midface hypoplasia and elliptocytosis chromosomal region gene 1
PA162376350	83607	AMMECR1L	chr2	128616204	128653635	37431	AMMECR1-like
PA134962814	81693	AMN	chr14	103378993	103400179	21186	amnion associated transmembrane protein
PA162376371	196394	AMN1	chr12	31821071	31892108	71037	antagonist of mitotic exit network 1 homolog (S. cerevisiae)
PA24773	154796	AMOT	chrX	112015105	112094136	79031	angiomotin
PA24774	154810	AMOTL1	chr11	94429602	94612918	183316	angiomotin like 1
PA24775	51421	AMOTL2	chr3	134071187	134104321	33134	angiomotin like 2
PA24776	270	AMPD1	chr1	115212719	115248239	35520	adenosine monophosphate deaminase 1
PA24777	271	AMPD2	chr1	110152435	110177677	25242	adenosine monophosphate deaminase 2
PA24778	272	AMPD3	chr11	10461846	10532126	70280	adenosine monophosphate deaminase 3
PA24779	273	AMPH	chr7	38420297	38681167	260870	amphiphysin
PA24780	275	AMT	chr3	49451211	49470111	18900	aminomethyltransferase
PA162376390	401138	AMTN	chr4	71374298	71401460	27162	amelotin
PA24781	276	AMY1A	chr1	104183695	104210174	26479	amylase, alpha 1A (salivary)
PA24782	277	AMY1B	chr1	104227039	104253519	26480	amylase, alpha 1B (salivary)
PA24783	278	AMY1C	chr1	104277833	104304312	26479	amylase, alpha 1C (salivary)
PA24784	279	AMY2A	chr1	104149999	104171400	21401	amylase, alpha 2A (pancreatic)
PA24785	280	AMY2B	chr1	104085894	104125156	39262	amylase, alpha 2B (pancreatic)
PA162376413	155185	AMZ1	chr7	2709163	2758069	48906	archaelysin family metallopeptidase 1
PA162376414	51321	AMZ2	chr17	66192127	66256305	64178	archaelysin family metallopeptidase 2
PA134907013	64682	ANAPC1	chr2	112522214	112651765	129551	anaphase promoting complex subunit 1
PA134938672	10393	ANAPC10	chr4	145912727	146029693	116966	anaphase promoting complex subunit 10
PA24787	51529	ANAPC11	chr17	79839599	79861363	21764	anaphase promoting complex subunit 11
PA134949652	25847	ANAPC13	chr3	134193546	134214865	21319	anaphase promoting complex subunit 13
PA143485346	25906	ANAPC15	chr11	71817633	71833822	16189	anaphase promoting complex subunit 15
PA165548225	119504	ANAPC16	chr10	73965758	73998618	32860	anaphase promoting complex subunit 16
PA134884359	29882	ANAPC2	chr9	140066236	140093057	26821	anaphase promoting complex subunit 2
PA134894250	29945	ANAPC4	chr4	25368848	25423120	54272	anaphase promoting complex subunit 4
PA24788	51433	ANAPC5	chr12	121743048	121802012	58964	anaphase promoting complex subunit 5
PA134901290	51434	ANAPC7	chr12	110807705	110851535	43830	anaphase promoting complex subunit 7
PA24790	283	ANG	chr14	21142336	21165345	23009	angiogenin, ribonuclease, RNase A family, 5
PA134982299	23357	ANGEL1	chr14	77245076	77302606	57530	angel homolog 1 (Drosophila)
PA142672620	90806	ANGEL2	chr1	213162524	213199168	36644	angel homolog 2 (Drosophila)
PA24791	284	ANGPT1	chr8	108258710	108520254	261544	angiopoietin 1
PA24792	285	ANGPT2	chr8	6354172	6430784	76612	angiopoietin 2
PA24793	51378	ANGPT4	chr20	849763	906977	57214	angiopoietin 4
PA24794	9068	ANGPTL1	chr1	178815670	178850215	34545	angiopoietin-like 1
PA24795	23452	ANGPTL2	chr9	129846628	129895044	48416	angiopoietin-like 2
PA24796	27329	ANGPTL3	chr1	63053158	63074976	21818	angiopoietin-like 3
PA24797	51129	ANGPTL4	chr19	8419011	8442257	23246	angiopoietin-like 4
PA134944139	253935	ANGPTL5	chr11	101758405	101797253	38848	angiopoietin-like 5
PA134950669	83854	ANGPTL6	chr19	10200013	10225710	25697	angiopoietin-like 6
PA134959516	10218	ANGPTL7	chr1	11239346	11259038	19692	angiopoietin-like 7
PA24798	286	ANK1	chr8	41507744	41764280	256536	ankyrin 1, erythrocytic
PA24799	287	ANK2	chr4	113729239	114307896	578657	ankyrin 2, neuronal
PA24800	288	ANK3	chr10	61783056	62503284	720228	ankyrin 3, node of Ranvier (ankyrin G)
PA145149868	150709	ANKAR	chr2	190529018	190628919	99901	ankyrin and armadillo repeat containing
PA143485299	348094	ANKDD1A	chr15	65194095	65254042	59947	ankyrin repeat and death domain containing 1A
PA143485300	728780	ANKDD1B	chr5	74897301	74970671	73370	ankyrin repeat and death domain containing 1B
PA24806	63926	ANKEF1	chr20	10005697	10040407	34710	ankyrin repeat and EF-hand domain containing 1
PA142672624	162282	ANKFN1	chr17	54220836	54563007	342171	ankyrin-repeat and fibronectin type III domain containing 1
PA134984226	51479	ANKFY1	chr17	4063665	4177274	113609	ankyrin repeat and FYVE domain containing 1
PA24801	56172	ANKH	chr5	14701909	14881887	179978	ANKH inorganic pyrophosphate transport regulator
PA134947858	54882	ANKHD1	chr5	139771399	139922441	151042	ankyrin repeat and KH domain containing 1
PA162376432	404734	ANKHD1-EIF4EBP3	chr5	139771399	139932163	160764	ANKHD1-EIF4EBP3 readthrough
PA134941469	54467	ANKIB1	chr7	91865530	92033698	168168	ankyrin repeat and IBR domain containing 1
PA134872551	255239	ANKK1	chr11	113248513	113274140	25627	ankyrin repeat and kinase domain containing 1
PA162376509	126549	ANKLE1	chr19	17382454	17401455	19001	ankyrin repeat and LEM domain containing 1
PA162376532	23141	ANKLE2	chr12	133299254	133348451	49197	ankyrin repeat and LEM domain containing 2
PA134925670	51281	ANKMY1	chr2	241415839	241510472	94633	ankyrin repeat and MYND domain containing 1
PA134893861	57037	ANKMY2	chr7	16636401	16695442	59041	ankyrin repeat and MYND domain containing 2
PA24803	57763	ANKRA2	chr5	72845025	72871521	26496	ankyrin repeat, family A (RFXANK-like), 2
PA134882768	27063	ANKRD1	chr10	92668857	92691032	22175	ankyrin repeat domain 1 (cardiac muscle)
PA134911073	55608	ANKRD10	chr13	111527887	111577454	49567	ankyrin repeat domain 10
PA134861925	29123	ANKRD11	chr16	89331029	89566969	235940	ankyrin repeat domain 11
PA134899860	23253	ANKRD12	chr18	9126751	9288983	162232	ankyrin repeat domain 12
PA134884324	88455	ANKRD13A	chr12	110426974	110480237	53263	ankyrin repeat domain 13A
PA142672616	124930	ANKRD13B	chr17	27910527	27944779	34252	ankyrin repeat domain 13B
PA142672617	81573	ANKRD13C	chr1	70721685	70830471	108786	ankyrin repeat domain 13C
PA142672618	338692	ANKRD13D	chr11	67046762	67072955	26193	ankyrin repeat domain 13 family, member D
PA134916467	54522	ANKRD16	chr10	5900593	5941860	41267	ankyrin repeat domain 16
PA134943225	26057	ANKRD17	chr4	73937502	74134858	197356	ankyrin repeat domain 17
PA134889624	253650	ANKRD18A	chr9	38540190	38630626	90436	ankyrin repeat domain 18A
PA134961354	441459	ANKRD18B	chr9	33514347	33605658	91311	ankyrin repeat domain 18B
PA24804	26287	ANKRD2	chr10	99322256	99346641	24385	ankyrin repeat domain 2 (stretch responsive muscle)
PA134953648	84210	ANKRD20A1	chr9	67916761	67972840	56079	ankyrin repeat domain 20 family, member A1
PA142672619	441430	ANKRD20A2	chr9	42358303	42414410	56107	ankyrin repeat domain 20 family, member A2
PA143485301	441425	ANKRD20A3	chr9	43086972	43143732	56760	ankyrin repeat domain 20 family, member A3
PA145149866	728747	ANKRD20A4	chr9	69371981	69428109	56128	ankyrin repeat domain 20 family, member A4
PA134954600	118932	ANKRD22	chr10	90576656	90621732	45076	ankyrin repeat domain 22
PA134960626	200539	ANKRD23	chr2	97485599	97519758	34159	ankyrin repeat domain 23
PA134937612	170961	ANKRD24	chr19	4172665	4227811	55146	ankyrin repeat domain 24
PA134926710	22852	ANKRD26	chr10	27281054	27399427	118373	ankyrin repeat domain 26
PA134893411	84079	ANKRD27	chr19	33084907	33176102	91195	ankyrin repeat domain 27 (VPS9 domain)
PA134880251	23243	ANKRD28	chr3	15705743	15911053	205310	ankyrin repeat domain 28
PA134948058	147463	ANKRD29	chr18	21176977	21252849	75872	ankyrin repeat domain 29
PA134974407	91074	ANKRD30A	chr10	37404785	37524495	119710	ankyrin repeat domain 30A
PA134980028	374860	ANKRD30B	chr18	14738239	14855737	117498	ankyrin repeat domain 30B
PA134962599	149992	ANKRD30BP2	chr21	14400487	14493572	93085	ankyrin repeat domain 30B pseudogene 2
PA134879237	256006	ANKRD31	chr5	74361122	74542703	181581	ankyrin repeat domain 31
PA134911523	84250	ANKRD32	chr5	93943086	94036326	93240	ankyrin repeat domain 32
PA25508	341405	ANKRD33	chr12	52271745	52288505	16760	ankyrin repeat domain 33
PA164715326	651746	ANKRD33B	chr5	10554435	10660928	106493	ankyrin repeat domain 33B
PA162376563	284615	ANKRD34A	chr1	145460508	145478647	18139	ankyrin repeat domain 34A
PA162376576	340120	ANKRD34B	chr5	79849574	79876304	26730	ankyrin repeat domain 34B
PA162376577	390616	ANKRD34C	chr15	79565146	79593581	28435	ankyrin repeat domain 34C
PA134896362	148741	ANKRD35	chr1	145539209	145571526	32317	ankyrin repeat domain 35
PA134930297	375248	ANKRD36	chr2	97768923	97933258	164335	ankyrin repeat domain 36
PA162376583	57730	ANKRD36B	chr2	98106009	98216708	110699	ankyrin repeat domain 36B
PA142672604	353322	ANKRD37	chr4	186307840	186324529	16689	ankyrin repeat domain 37
PA142672606	51239	ANKRD39	chr2	97510722	97533756	23034	ankyrin repeat domain 39
PA142672607	91369	ANKRD40	chr17	48767551	48795270	27719	ankyrin repeat domain 40
PA142672609	338699	ANKRD42	chr11	82894754	82970719	75965	ankyrin repeat domain 42
PA142672611	91526	ANKRD44	chr2	197828741	198185521	356780	ankyrin repeat domain 44
PA142672612	339416	ANKRD45	chr1	173574475	173649001	74526	ankyrin repeat domain 45
PA142672613	157567	ANKRD46	chr8	101518980	101582014	63034	ankyrin repeat domain 46
PA142672615	54851	ANKRD49	chr11	94217153	94235744	18591	ankyrin repeat domain 49
PA128394695	57182	ANKRD50	chr4	125582203	125643887	61684	ankyrin repeat domain 50
PA143485302	283373	ANKRD52	chr12	56628591	56662143	33552	ankyrin repeat domain 52
PA144596517	79998	ANKRD53	chr2	71195172	71215629	20457	ankyrin repeat domain 53
PA145149843	129138	ANKRD54	chr22	38223862	38250353	26491	ankyrin repeat domain 54
PA145149863	79722	ANKRD55	chr5	55392507	55539186	146679	ankyrin repeat domain 55
PA24807	22881	ANKRD6	chr6	90132897	90346553	213656	ankyrin repeat domain 6
PA162376674	140731	ANKRD60	chr20	56790551	56808230	17679	ankyrin repeat domain 60
PA164715346	100310846	ANKRD61	chr7	6061007	6079183	18176	ankyrin repeat domain 61
PA164715347	342850	ANKRD62	chr18	12083848	12132763	48915	ankyrin repeat domain 62
PA38591	56311	ANKRD7	chr7	117854493	117885785	31292	ankyrin repeat domain 7
PA134971966	122416	ANKRD9	chr14	102970179	102986128	15949	ankyrin repeat domain 9
PA134958476	23294	ANKS1A	chr6	34847038	35088802	241764	ankyrin repeat and sterile alpha motif domain containing 1A
PA128394692	56899	ANKS1B	chr12	99125569	100388512	1262943	ankyrin repeat and sterile alpha motif domain containing 1B
PA143485303	124401	ANKS3	chr16	4743500	4794378	50878	ankyrin repeat and sterile alpha motif domain containing 3
PA143485304	257629	ANKS4B	chr16	21235016	21266750	31734	ankyrin repeat and sterile alpha motif domain containing 4B
PA134931829	203286	ANKS6	chr9	101491291	101568794	77503	ankyrin repeat and sterile alpha motif domain containing 6
PA134863258	389161	ANKUB1	chr3	149475887	149520610	44723	ankyrin repeat and ubiquitin domain containing 1
PA143485305	55139	ANKZF1	chr2	220084479	220104391	19912	ankyrin repeat and zinc finger domain containing 1
PA24809	54443	ANLN	chr7	36419415	36496400	76985	anillin, actin binding protein
PA164715378	55107	ANO1	chr11	69914408	70038651	124243	anoctamin 1, calcium activated chloride channel
PA164715433	55129	ANO10	chr3	43404818	43673560	268742	anoctamin 10
PA25504	57101	ANO2	chr12	5668817	6065398	396581	anoctamin 2, calcium activated chloride channel
PA25489	63982	ANO3	chr11	26200458	26687836	487378	anoctamin 3
PA164715582	121601	ANO4	chr12	101123841	101525419	401578	anoctamin 4
PA164715641	203859	ANO5	chr11	22204199	22307913	103714	anoctamin 5
PA164715690	196527	ANO6	chr12	45599770	45837187	237417	anoctamin 6
PA32980	50636	ANO7	chr2	242117924	242167791	49867	anoctamin 7
PA164715790	57719	ANO8	chr19	17431032	17455638	24606	anoctamin 8
PA164715791	338440	ANO9	chr11	414930	452011	37081	anoctamin 9
PA24811	8125	ANP32A	chr15	69067874	69123261	55387	acidic (leucine-rich) nuclear phosphoprotein 32 family, member A
PA24812	10541	ANP32B	chr9	100735479	100783860	48381	acidic (leucine-rich) nuclear phosphoprotein 32 family, member B
PA24813	23520	ANP32C	chr4	165115159	165128863	13704	acidic (leucine-rich) nuclear phosphoprotein 32 family, member C
PA24814	23519	ANP32D	chr12	48856448	48869843	13395	acidic (leucine-rich) nuclear phosphoprotein 32 family, member D
PA134880751	81611	ANP32E	chr1	150187717	150218504	30787	acidic (leucine-rich) nuclear phosphoprotein 32 family, member E
PA24815	290	ANPEP	chr15	90325126	90368119	42993	alanyl (membrane) aminopeptidase
PA134956382	84168	ANTXR1	chr2	69230276	69479459	249183	anthrax toxin receptor 1
PA128394752	118429	ANTXR2	chr4	80819771	81004626	184855	anthrax toxin receptor 2
PA24823	301	ANXA1	chr9	75756721	75788309	31588	annexin A1
PA24824	11199	ANXA10	chr4	169003688	169111893	108205	annexin A10
PA24825	311	ANXA11	chr10	81911880	81975433	63553	annexin A11
PA24826	312	ANXA13	chr8	124690034	124759647	69613	annexin A13
PA24827	302	ANXA2	chr15	60636350	60700185	63835	annexin A2
PA162380171	389289	ANXA2R	chr5	43036182	43050447	14265	annexin A2 receptor
PA24831	306	ANXA3	chr4	79462742	79534605	71863	annexin A3
PA24832	307	ANXA4	chr2	69937946	70056596	118650	annexin A4
PA24833	308	ANXA5	chr4	122586152	122628147	41995	annexin A5
PA24834	309	ANXA6	chr5	150477267	150547443	70176	annexin A6
PA24835	310	ANXA7	chr10	75132189	75183841	51652	annexin A7
PA24836	653145	ANXA8	chr10	48245204	48274369	29165	annexin A8
PA134881914	728113	ANXA8L1	chr10	47154983	47184180	29197	annexin A8-like 1
PA134927491	244	ANXA8L2	chr10	47736816	47766041	29225	annexin A8-like 2
PA24837	8416	ANXA9	chr1	150944499	150971114	26615	annexin A9
PA24838	313	AOAH	chr7	36549549	36774154	224605	acyloxyacyl hydrolase (neutrophil)
PA24416	26	AOC1	chr7	150514336	150561379	47043	amine oxidase, copper containing 1
PA24839	314	AOC2	chr17	40986609	41005724	19115	amine oxidase, copper containing 2 (retina-specific)
PA24840	8639	AOC3	chr17	40993201	41013147	19946	amine oxidase, copper containing 3
PA24842	316	AOX1	chr2	201440731	201539218	98487	aldehyde oxidase 1
PA165663153	55435	AP1AR	chr4	113142893	113194211	51318	adaptor-related protein complex 1 associated regulatory protein
PA24844	162	AP1B1	chr22	29720669	29794754	74085	adaptor-related protein complex 1, beta 1 subunit
PA24845	164	AP1G1	chr16	71759903	71853006	93103	adaptor-related protein complex 1, gamma 1 subunit
PA24846	8906	AP1G2	chr14	24025777	24048754	22977	adaptor-related protein complex 1, gamma 2 subunit
PA24848	8907	AP1M1	chr19	16298665	16349156	50491	adaptor-related protein complex 1, mu 1 subunit
PA24849	10053	AP1M2	chr19	10680347	10707991	27644	adaptor-related protein complex 1, mu 2 subunit
PA24850	1174	AP1S1	chr7	100787685	100807557	19872	adaptor-related protein complex 1, sigma 1 subunit
PA24851	8905	AP1S2	chrX	15840929	15883137	42208	adaptor-related protein complex 1, sigma 2 subunit
PA134866785	130340	AP1S3	chr2	224613403	224712319	98916	adaptor-related protein complex 1, sigma 3 subunit
PA24852	160	AP2A1	chr19	50260180	50313369	53189	adaptor-related protein complex 2, alpha 1 subunit
PA24853	161	AP2A2	chr11	915809	1015245	99436	adaptor-related protein complex 2, alpha 2 subunit
PA24854	163	AP2B1	chr17	33903918	34056436	152518	adaptor-related protein complex 2, beta 1 subunit
PA24855	1173	AP2M1	chr3	183882634	183904879	22245	adaptor-related protein complex 2, mu 1 subunit
PA24856	1175	AP2S1	chr19	47338423	47364203	25780	adaptor-related protein complex 2, sigma 1 subunit
PA24857	8546	AP3B1	chr5	77295150	77600579	305429	adaptor-related protein complex 3, beta 1 subunit
PA24858	8120	AP3B2	chr15	83325033	83388660	63627	adaptor-related protein complex 3, beta 2 subunit
PA24859	8943	AP3D1	chr19	2097987	2161556	63569	adaptor-related protein complex 3, delta 1 subunit
PA24860	26985	AP3M1	chr10	75877015	75920826	43811	adaptor-related protein complex 3, mu 1 subunit
PA24861	10947	AP3M2	chr8	42000464	42031701	31237	adaptor-related protein complex 3, mu 2 subunit
PA24862	1176	AP3S1	chr5	115167303	115252778	85475	adaptor-related protein complex 3, sigma 1 subunit
PA24863	10239	AP3S2	chr15	90370831	90447617	76786	adaptor-related protein complex 3, sigma 2 subunit
PA24864	10717	AP4B1	chr1	114434370	114457741	23371	adaptor-related protein complex 4, beta 1 subunit
PA24865	23431	AP4E1	chr15	51190780	51301097	110317	adaptor-related protein complex 4, epsilon 1 subunit
PA24866	9179	AP4M1	chr7	99689130	99707803	18673	adaptor-related protein complex 4, mu 1 subunit
PA24867	11154	AP4S1	chr14	31484312	31568656	84344	adaptor-related protein complex 4, sigma 1 subunit
PA164723216	55745	AP5M1	chr14	57725606	57759797	34191	adaptor-related protein complex 5, mu 1 subunit
PA25744	55317	AP5S1	chr20	3791171	3808954	17783	adaptor-related protein complex 5, sigma 1 subunit
PA162392841	9907	AP5Z1	chr7	4805262	4837026	31764	adaptor-related protein complex 5, zeta 1 subunit
PA24868	317	APAF1	chr12	99029078	99132211	103133	apoptotic peptidase activating factor 1
PA24869	320	APBA1	chr9	72039448	72297275	257827	amyloid beta (A4) precursor protein-binding, family A, member 1
PA24870	321	APBA2	chr15	29201570	29413518	211948	amyloid beta (A4) precursor protein-binding, family A, member 2
PA24872	9546	APBA3	chr19	3747771	3771673	23902	amyloid beta (A4) precursor protein-binding, family A, member 3
PA24873	322	APBB1	chr11	6413355	6450644	37289	amyloid beta (A4) precursor protein-binding, family B, member 1 (Fe65)
PA134933955	54518	APBB1IP	chr10	26717253	26859732	142479	amyloid beta (A4) precursor protein-binding, family B, member 1 interacting protein
PA24874	323	APBB2	chr4	40809044	41228731	419687	amyloid beta (A4) precursor protein-binding, family B, member 2
PA134958636	10307	APBB3	chr5	139934853	139954189	19336	amyloid beta (A4) precursor protein-binding, family B, member 3
PA24875	324	APC	chr5	112033202	112184936	151734	adenomatous polyposis coli
PA134906843	10297	APC2	chr19	1436269	1476243	39974	adenomatosis polyposis coli 2
PA24876	147495	APCDD1	chr18	10444625	10491698	47073	adenomatosis polyposis coli down-regulated 1
PA145149831	164284	APCDD1L	chr20	57030503	57100405	69902	adenomatosis polyposis coli down-regulated 1-like
PA24877	325	APCS	chr1	159547616	159561661	14045	amyloid P component, serum
PA24878	327	APEH	chr3	49701427	49723936	22509	acylaminoacyl-peptide hydrolase
PA201059	328	APEX1	chr14	20913290	20928931	15641	APEX nuclease (multifunctional DNA repair enzyme) 1
PA38474	27301	APEX2	chrX	55016756	55037306	20550	APEX nuclease (apurinic/apyrimidinic endonuclease) 2
PA142672599	51107	APH1A	chr1	150234799	150251609	16810	APH1A gamma secretase subunit
PA142672600	83464	APH1B	chr15	63559749	63604325	44576	APH1B gamma secretase subunit
PA24881	8539	API5	chr11	43323505	43369080	45575	apoptosis inhibitor 5
PA142672601	51074	APIP	chr11	34900842	34947939	47097	APAF1 interacting protein
PA134861614	378708	APITD1	chr1	10479944	10513239	33295	apoptosis-inducing, TAF9-like domain 1
PA164715842	200558	APLF	chr2	68684691	68842361	157670	aprataxin and PNKP like factor
PA134984493	8862	APLN	chrX	128776236	128798933	22697	apelin
PA162376687	187	APLNR	chr11	56998051	57014927	16876	apelin receptor
PA24884	333	APLP1	chr19	36348806	36373699	24893	amyloid beta (A4) precursor-like protein 1
PA24885	334	APLP2	chr11	129929716	130017706	87990	amyloid beta (A4) precursor-like protein 2
PA25745	57136	APMAP	chr20	24940566	24983610	43044	adipocyte plasma membrane associated protein
PA49	335	APOA1	chr11	116703467	116718338	14871	apolipoprotein A-I
PA38538	128240	APOA1BP	chr1	156551554	156567091	15537	apolipoprotein A-I binding protein
PA24886	336	APOA2	chr1	161189083	161203418	14335	apolipoprotein A-II
PA24887	337	APOA4	chr11	116688418	116704011	15593	apolipoprotein A-IV
PA24888	116519	APOA5	chr11	116657086	116673136	16050	apolipoprotein A-V
PA50	338	APOB	chr2	21221301	21276945	55644	apolipoprotein B
PA24889	339	APOBEC1	chr12	7798996	7833195	34199	apolipoprotein B mRNA editing enzyme, catalytic polypeptide 1
PA24890	10930	APOBEC2	chr6	41010940	41035630	24690	apolipoprotein B mRNA editing enzyme, catalytic polypeptide-like 2
PA24891	200315	APOBEC3A	chr22	39338755	39362189	23434	apolipoprotein B mRNA editing enzyme, catalytic polypeptide-like 3A
PA24892	9582	APOBEC3B	chr22	39368352	39391784	23432	apolipoprotein B mRNA editing enzyme, catalytic polypeptide-like 3B
PA24893	27350	APOBEC3C	chr22	39400265	39417843	17578	apolipoprotein B mRNA editing enzyme, catalytic polypeptide-like 3C
PA24894	140564	APOBEC3D	chr22	39407118	39438686	31568	apolipoprotein B mRNA editing enzyme, catalytic polypeptide-like 3D
PA24896	200316	APOBEC3F	chr22	39426609	39454977	28368	apolipoprotein B mRNA editing enzyme, catalytic polypeptide-like 3F
PA24897	60489	APOBEC3G	chr22	39463010	39486748	23738	apolipoprotein B mRNA editing enzyme, catalytic polypeptide-like 3G
PA162376694	164668	APOBEC3H	chr22	39483229	39503072	19843	apolipoprotein B mRNA editing enzyme, catalytic polypeptide-like 3H
PA142672597	403314	APOBEC4	chr1	183612410	183632448	20038	apolipoprotein B mRNA editing enzyme, catalytic polypeptide-like 4 (putative)
PA51	341	APOC1	chr19	45407577	45425606	18029	apolipoprotein C-I
PA52	344	APOC2	chr19	45439239	45455822	16583	apolipoprotein C-II
PA53	345	APOC3	chr11	116690624	116706787	16163	apolipoprotein C-III
PA54	346	APOC4	chr19	45435495	45451753	16258	apolipoprotein C-IV
PA24900	347	APOD	chr3	195292573	195321076	28503	apolipoprotein D
PA55	348	APOE	chr19	45399039	45415650	16611	apolipoprotein E
PA24902	319	APOF	chr12	56751355	56766583	15228	apolipoprotein F
PA24903	350	APOH	chr17	64205147	64235556	30409	apolipoprotein H (beta-2-glycoprotein I)
PA24904	8542	APOL1	chr22	36639117	36666577	27460	apolipoprotein L, 1
PA24905	23780	APOL2	chr22	36619255	36646000	26745	apolipoprotein L, 2
PA24906	80833	APOL3	chr22	36533371	36572225	38854	apolipoprotein L, 3
PA24907	80832	APOL4	chr22	36582176	36610879	28703	apolipoprotein L, 4
PA24908	80831	APOL5	chr22	36103919	36128530	24611	apolipoprotein L, 5
PA24909	80830	APOL6	chr22	36034424	36067456	33032	apolipoprotein L, 6
PA143485306	81575	APOLD1	chr12	12868851	12947400	78549	apolipoprotein L domain containing 1
PA38370	55937	APOM	chr6	31610187	31628987	18800	apolipoprotein M
PA162376709	79135	APOO	chrX	23848465	23936057	87592	apolipoprotein O
PA162376732	139322	APOOL	chrX	84248897	84351323	102426	apolipoprotein O-like
PA134961925	84334	APOPT1	chr14	104019299	104060236	40937	apoptogenic 1, mitochondrial
PA24910	351	APP	chr21	27249861	27553446	303585	amyloid beta (A4) precursor protein
PA24912	10513	APPBP2	chr17	58517520	58613580	96060	amyloid beta precursor protein (cytoplasmic tail) binding protein 2
PA162376755	26060	APPL1	chr3	57251765	57310499	58734	adaptor protein, phosphotyrosine interaction, PH domain and leucine zipper containing 1
PA164741199	55198	APPL2	chr12	105564075	105640008	75933	adaptor protein, phosphotyrosine interaction, PH domain and leucine zipper containing 2
PA24914	353	APRT	chr16	88872877	88888342	15465	adenine phosphoribosyltransferase
PA24915	54840	APTX	chr9	32969604	33011639	42035	aprataxin
PA24918	358	AQP1	chr7	30941415	30968131	26716	aquaporin 1 (Colton blood group)
PA24919	89872	AQP10	chr1	154283592	154300801	17209	aquaporin 10
PA134949682	282679	AQP11	chr11	77290680	77324401	33721	aquaporin 11
PA134977417	375318	AQP12A	chr2	241621262	241640900	19638	aquaporin 12A
PA29902	653437	AQP12B	chr2	241612835	241632317	19482	aquaporin 12B
PA24920	359	AQP2	chr12	50334524	50355664	21140	aquaporin 2 (collecting duct)
PA24921	360	AQP3	chr9	33438152	33457631	19479	aquaporin 3 (Gill blood group)
PA24922	361	AQP4	chr18	24429007	24455735	26728	aquaporin 4
PA24923	362	AQP5	chr12	50345279	50362465	17186	aquaporin 5
PA24924	363	AQP6	chr12	50350874	50373922	23048	aquaporin 6, kidney specific
PA24925	364	AQP7	chr9	33381948	33412643	30695	aquaporin 7
PA24926	343	AQP8	chr16	25218285	25243253	24968	aquaporin 8
PA24927	366	AQP9	chr15	58420374	58481110	60736	aquaporin 9
PA134869224	9716	AQR	chr15	35145552	35271995	126443	aquarius intron-binding spliceosomal factor
PA57	367	AR	chrX	66753874	66953461	199587	androgen receptor
PA24928	369	ARAF	chrX	47410499	47434320	23821	A-Raf proto-oncogene, serine/threonine kinase
PA164715867	116985	ARAP1	chr11	72393114	72473465	80351	ArfGAP with RhoGAP domain, ankyrin repeat and PH domain 1
PA164715938	116984	ARAP2	chr4	36064620	36255979	191359	ArfGAP with RhoGAP domain, ankyrin repeat and PH domain 2
PA164715983	64411	ARAP3	chr5	141029968	141071800	41832	ArfGAP with RhoGAP domain, ankyrin repeat and PH domain 3
PA24930	23237	ARC	chr8	143689405	143705833	16428	activity-regulated cytoskeleton-associated protein
PA24931	372	ARCN1	chr11	118433078	118476748	43670	archain 1
PA24933	374	AREG	chr4	75300853	75323726	22873	amphiregulin
PA162376851	727738	AREGB	chr4	75470839	75493485	22646	amphiregulin B
PA134985474	9870	AREL1	chr14	75124955	75189807	64852	apoptosis resistant E3 ubiquitin protein ligase 1
PA24934	375	ARF1	chr1	228260361	228289913	29552	ADP-ribosylation factor 1
PA24936	377	ARF3	chr12	49326987	49361309	34322	ADP-ribosylation factor 3
PA24937	378	ARF4	chr3	57554090	57593215	39125	ADP-ribosylation factor 4
PA24941	381	ARF5	chr7	127218406	127234759	16353	ADP-ribosylation factor 5
PA24942	382	ARF6	chr14	50349736	50366772	17036	ADP-ribosylation factor 6
PA164741246	55738	ARFGAP1	chr20	61894137	61924145	30008	ADP-ribosylation factor GTPase activating protein 1
PA162376868	84364	ARFGAP2	chr11	47182849	47209054	26205	ADP-ribosylation factor GTPase activating protein 2
PA35024	26286	ARFGAP3	chr22	43189530	43263408	73878	ADP-ribosylation factor GTPase activating protein 3
PA134908197	10565	ARFGEF1	chr8	68082746	68265912	183166	ADP-ribosylation factor guanine nucleotide-exchange factor 1 (brefeldin A-inhibited)
PA24945	10564	ARFGEF2	chr20	47528250	47656230	127980	ADP-ribosylation factor guanine nucleotide-exchange factor 2 (brefeldin A-inhibited)
PA134920621	27236	ARFIP1	chr4	153691091	153836064	144973	ADP-ribosylation factor interacting protein 1
PA134879398	23647	ARFIP2	chr11	6492913	6512709	19796	ADP-ribosylation factor interacting protein 2
PA24946	10139	ARFRP1	chr20	62326995	62349365	22370	ADP-ribosylation factor related protein 1
PA24947	383	ARG1	chr6	131884344	131908472	24128	arginase 1
PA24948	384	ARG2	chr14	68076579	68121437	44858	arginase 2
PA142672588	503582	ARGFX	chr3	121271269	121312469	41200	arginine-fifty homeobox
PA162376869	55082	ARGLU1	chr13	107192662	107230514	37852	arginine and glutamate rich 1
PA24956	392	ARHGAP1	chr11	46695625	46732215	36590	Rho GTPase activating protein 1
PA134904544	79658	ARHGAP10	chr4	148643214	148996927	353713	Rho GTPase activating protein 10
PA134982615	9824	ARHGAP11A	chr15	32896720	32934868	38148	Rho GTPase activating protein 11A
PA134987257	89839	ARHGAP11B	chr15	30908879	30934013	25134	Rho GTPase activating protein 11B
PA24957	94134	ARHGAP12	chr10	32091326	32227804	136478	Rho GTPase activating protein 12
PA134938065	55843	ARHGAP15	chr2	143876899	144528921	652022	Rho GTPase activating protein 15
PA134908575	55114	ARHGAP17	chr16	24927710	25036695	108985	Rho GTPase activating protein 17
PA134884487	93663	ARHGAP18	chr6	129894290	130041370	147080	Rho GTPase activating protein 18
PA134917415	84986	ARHGAP19	chr10	98978930	99062430	83500	Rho GTPase activating protein 19
PA134963885	57569	ARHGAP20	chr11	110444759	110593912	149153	Rho GTPase activating protein 20
PA134973559	57584	ARHGAP21	chr10	24869538	25022597	153059	Rho GTPase activating protein 21
PA134979724	58504	ARHGAP22	chr10	49651068	49874310	223242	Rho GTPase activating protein 22
PA134891853	57636	ARHGAP23	chr17	36574720	36671628	96908	Rho GTPase activating protein 23
PA134934054	83478	ARHGAP24	chr4	86058860	86926823	867963	Rho GTPase activating protein 24
PA134941737	9938	ARHGAP25	chr2	68951913	69056965	105052	Rho GTPase activating protein 25
PA134946198	23092	ARHGAP26	chr5	142139881	142611572	471691	Rho GTPase activating protein 26
PA134873327	201176	ARHGAP27	chr17	43468268	43520282	52014	Rho GTPase activating protein 27
PA134915320	79822	ARHGAP28	chr18	6719717	6918715	198998	Rho GTPase activating protein 28
PA128394548	9411	ARHGAP29	chr1	94631463	94723251	91788	Rho GTPase activating protein 29
PA142672585	257106	ARHGAP30	chr1	161013731	161049760	36029	Rho GTPase activating protein 30
PA165696843	57514	ARHGAP31	chr3	119003220	119141323	138103	Rho GTPase activating protein 31
PA165543138	9743	ARHGAP32	chr11	128831955	129072093	240138	Rho GTPase activating protein 32
PA165393003	115703	ARHGAP33	chr19	36256417	36282724	26307	Rho GTPase activating protein 33
PA28988	2909	ARHGAP35	chr19	47411824	47511334	99510	Rho GTPase activating protein 35
PA165756384	158763	ARHGAP36	chrX	130182216	130226859	44643	Rho GTPase activating protein 36
PA165585391	80728	ARHGAP39	chr8	145751563	145848891	97328	Rho GTPase activating protein 39
PA24958	393	ARHGAP4	chrX	153169830	153201777	31947	Rho GTPase activating protein 4
PA25802	343578	ARHGAP40	chr20	37220577	37282295	61718	Rho GTPase activating protein 40
PA165543186	143872	ARHGAP42	chr11	100548407	100864656	316249	Rho GTPase activating protein 42
PA24959	394	ARHGAP5	chr14	32535664	32631934	96270	Rho GTPase activating protein 5
PA24960	395	ARHGAP6	chrX	11152663	11693821	541158	Rho GTPase activating protein 6
PA24961	23779	ARHGAP8	chr22	45138438	45261664	123226	Rho GTPase activating protein 8
PA24962	64333	ARHGAP9	chr12	57863038	57892756	29718	Rho GTPase activating protein 9
PA24963	396	ARHGDIA	chr17	79822595	79839282	16687	Rho GDP dissociation inhibitor (GDI) alpha
PA24964	397	ARHGDIB	chr12	15091949	15124562	32613	Rho GDP dissociation inhibitor (GDI) beta
PA24965	398	ARHGDIG	chr16	320606	336003	15397	Rho GDP dissociation inhibitor (GDI) gamma
PA24966	9138	ARHGEF1	chr19	42377240	42414604	37364	Rho guanine nucleotide exchange factor (GEF) 1
PA24967	9639	ARHGEF10	chr8	1762149	1909807	147658	Rho guanine nucleotide exchange factor (GEF) 10
PA142672586	55160	ARHGEF10L	chr1	17836693	18027370	190677	Rho guanine nucleotide exchange factor (GEF) 10-like
PA24968	9826	ARHGEF11	chr1	156901632	157025512	123880	Rho guanine nucleotide exchange factor (GEF) 11
PA24969	23365	ARHGEF12	chr11	120197264	120363645	166381	Rho guanine nucleotide exchange factor (GEF) 12
PA24970	22899	ARHGEF15	chr17	8203556	8228834	25278	Rho guanine nucleotide exchange factor (GEF) 15
PA24971	27237	ARHGEF16	chr1	3361147	3400677	39530	Rho guanine nucleotide exchange factor (GEF) 16
PA134884537	9828	ARHGEF17	chr11	73009663	73083425	73762	Rho guanine nucleotide exchange factor (GEF) 17
PA128394630	23370	ARHGEF18	chr19	7410481	7540371	129890	Rho/Rac guanine nucleotide exchange factor (GEF) 18
PA134887028	128272	ARHGEF19	chr1	16521599	16549104	27505	Rho guanine nucleotide exchange factor (GEF) 19
PA24972	9181	ARHGEF2	chr1	155913431	155963396	49965	Rho/Rac guanine nucleotide exchange factor (GEF) 2
PA24973	50650	ARHGEF3	chr3	56758446	57123336	364890	Rho guanine nucleotide exchange factor (GEF) 3
PA165696270	100271715	ARHGEF33	chr2	39136504	39205590	69086	Rho guanine nucleotide exchange factor (GEF) 33
PA165617645	445328	ARHGEF35	chr7	143880176	143902791	22615	Rho guanine nucleotide exchange factor (GEF) 35
PA165660135	389337	ARHGEF37	chr5	148951064	149017531	66467	Rho guanine nucleotide exchange factor (GEF) 37
PA165663186	54848	ARHGEF38	chr4	106463704	106605070	141366	Rho guanine nucleotide exchange factor (GEF) 38
PA134939297	84904	ARHGEF39	chr9	35655872	35685863	29991	Rho guanine nucleotide exchange factor (GEF) 39
PA24974	50649	ARHGEF4	chr2	131584489	131807826	223337	Rho guanine nucleotide exchange factor (GEF) 4
PA24975	7984	ARHGEF5	chr7	144042489	144080725	38236	Rho guanine nucleotide exchange factor (GEF) 5
PA24976	9459	ARHGEF6	chrX	135744708	135873503	128795	Rac/Cdc42 guanine nucleotide exchange factor (GEF) 6
PA24977	8874	ARHGEF7	chr13	111757624	111961081	203457	Rho guanine nucleotide exchange factor (GEF) 7
PA24978	23229	ARHGEF9	chrX	62851847	63015426	163579	Cdc42 guanine nucleotide exchange factor (GEF) 9
PA35960	8289	ARID1A	chr1	27012522	27111601	99079	AT rich interactive domain 1A (SWI-like)
PA134909463	57492	ARID1B	chr6	157088980	157534913	445933	AT rich interactive domain 1B (SWI1-like)
PA134916396	196528	ARID2	chr12	46113494	46304820	191326	AT rich interactive domain 2 (ARID, RFX-like)
PA27485	1820	ARID3A	chr19	915733	975816	60083	AT rich interactive domain 3A (BRIGHT-like)
PA134896829	10620	ARID3B	chr15	74823518	74893472	69954	AT rich interactive domain 3B (BRIGHT-like)
PA134928507	138715	ARID3C	chr9	34618455	34638011	19556	AT rich interactive domain 3C (BRIGHT-like)
PA34249	5926	ARID4A	chr14	58755103	58843713	88610	AT rich interactive domain 4A (RBP1-like)
PA134940494	51742	ARID4B	chr1	235327210	235501532	174322	AT rich interactive domain 4B (RBP1-like)
PA134937822	10865	ARID5A	chr2	97192464	97221375	28911	AT rich interactive domain 5A (MRF1-like)
PA134943193	84159	ARID5B	chr10	63651013	63859707	208694	AT rich interactive domain 5B (MRF1-like)
PA24982	25820	ARIH1	chr15	72756667	72881904	125237	ariadne RBR E3 ubiquitin protein ligase 1
PA24983	10425	ARIH2	chr3	48946265	49025974	79709	ariadne RBR E3 ubiquitin protein ligase 2
PA162379716	646450	ARIH2OS	chr3	48952221	48966818	14597	ariadne homolog 2 opposite strand
PA24985	400	ARL1	chr12	101783894	101812192	28298	ADP-ribosylation factor-like 1
PA134871031	285598	ARL10	chr5	175782477	175803934	21457	ADP-ribosylation factor-like 10
PA134974627	115761	ARL11	chr13	50192435	50211008	18573	ADP-ribosylation factor-like 11
PA134890660	392509	ARL13A	chrX	100214697	100248820	34123	ADP-ribosylation factor-like 13A
PA134975272	200894	ARL13B	chr3	93688983	93777522	88539	ADP-ribosylation factor-like 13B
PA134971739	80117	ARL14	chr3	160384948	160399236	14288	ADP-ribosylation factor-like 14
PA142672291	120534	ARL14EP	chr11	30334649	30362165	27516	ADP-ribosylation factor-like 14 effector protein
PA134960964	54622	ARL15	chr5	53177578	53616403	438825	ADP-ribosylation factor-like 15
PA142672583	339231	ARL16	chr17	79645224	79660954	15730	ADP-ribosylation factor-like 16
PA165431441	51326	ARL17A	chr17	44574184	44667155	92971	ADP-ribosylation factor-like 17A
PA165431478	100506084	ARL17B	chr17	44348550	44449416	100866	ADP-ribosylation factor-like 17B
PA24986	402	ARL2	chr11	64771585	64792657	21072	ADP-ribosylation factor-like 2
PA134904608	23568	ARL2BP	chr16	57269037	57290547	21510	ADP-ribosylation factor-like 2 binding protein
PA24987	403	ARL3	chr10	104430484	104484190	53706	ADP-ribosylation factor-like 3
PA24988	10124	ARL4A	chr7	12716452	12733559	17107	ADP-ribosylation factor-like 4A
PA24991	10123	ARL4C	chr2	235398685	235415721	17036	ADP-ribosylation factor-like 4C
PA24938	379	ARL4D	chr17	41466353	41481504	15151	ADP-ribosylation factor-like 4D
PA24989	26225	ARL5A	chr2	152654480	152695009	40529	ADP-ribosylation factor-like 5A
PA134979161	221079	ARL5B	chr10	18938264	18973568	35304	ADP-ribosylation factor-like 5B
PA134964408	390790	ARL5C	chr17	37310147	37332414	22267	ADP-ribosylation factor-like 5C
PA134931939	84100	ARL6	chr3	97473365	97523086	49721	ADP-ribosylation factor-like 6
PA162376894	23204	ARL6IP1	chr16	18799991	18822894	22903	ADP-ribosylation factor-like 6 interacting protein 1
PA134879338	51329	ARL6IP4	chr12	123454607	123470460	15853	ADP-ribosylation factor-like 6 interacting protein 4
PA134898937	10550	ARL6IP5	chr3	69124090	69158239	34149	ADP-ribosylation factor-like 6 interacting protein 5
PA134866669	151188	ARL6IP6	chr2	153564407	153620767	56360	ADP-ribosylation factor-like 6 interacting protein 6
PA134905021	127829	ARL8A	chr1	202099532	202123871	24339	ADP-ribosylation factor-like 8A
PA134959531	55207	ARL8B	chr3	5153930	5225601	71671	ADP-ribosylation factor-like 8B
PA134987258	132946	ARL9	chr4	57361375	57393149	31774	ADP-ribosylation factor-like 9
PA134882659	55156	ARMC1	chr8	66511691	66556452	44761	armadillo repeat containing 1
PA162376895	83787	ARMC10	chr7	102705174	102743210	38036	armadillo repeat containing 10
PA134943829	84071	ARMC2	chr6	109159617	109298352	138735	armadillo repeat containing 2
PA134917281	219681	ARMC3	chr10	23206954	23330452	123498	armadillo repeat containing 3
PA134877125	55130	ARMC4	chr10	28098095	28297977	199882	armadillo repeat containing 4
PA134926941	79798	ARMC5	chr16	31459010	31481488	22478	armadillo repeat containing 5
PA134884604	93436	ARMC6	chr19	19134387	19171987	37600	armadillo repeat containing 6
PA134901380	79637	ARMC7	chr17	73096047	73129360	33313	armadillo repeat containing 7
PA134984953	25852	ARMC8	chr3	137896115	138020231	124116	armadillo repeat containing 8
PA142672581	80210	ARMC9	chr2	232053294	232241606	188312	armadillo repeat containing 9
PA128394658	51309	ARMCX1	chrX	100795466	100812683	17217	armadillo repeat containing, X-linked 1
PA134985862	9823	ARMCX2	chrX	100907267	100924894	17627	armadillo repeat containing, X-linked 2
PA134977725	51566	ARMCX3	chrX	100868117	100885833	17716	armadillo repeat containing, X-linked 3
PA134910322	64860	ARMCX5	chrX	101844096	101862087	17991	armadillo repeat containing, X-linked 5
PA134869551	54470	ARMCX6	chrX	100867108	100882991	15883	armadillo repeat containing, X-linked 6
PA162376896	387715	ARMS2	chr10	124204179	124219868	15689	age-related maculopathy susceptibility 2
PA24994	405	ARNT	chr1	150779181	150859244	80063	aryl hydrocarbon receptor nuclear translocator
PA24995	9915	ARNT2	chr15	80686692	80893278	206586	aryl-hydrocarbon receptor nuclear translocator 2
PA24996	406	ARNTL	chr11	13289325	13411813	122488	aryl hydrocarbon receptor nuclear translocator-like
PA134896555	56938	ARNTL2	chr12	27475787	27581746	105959	aryl hydrocarbon receptor nuclear translocator-like 2
PA24997	10552	ARPC1A	chr7	98913496	98966885	53389	actin related protein 2/3 complex, subunit 1A, 41kDa
PA24998	10095	ARPC1B	chr7	98962298	99007226	44928	actin related protein 2/3 complex, subunit 1B, 41kDa
PA24999	10109	ARPC2	chr2	219071817	219122071	50254	actin related protein 2/3 complex, subunit 2, 34kDa
PA25000	10094	ARPC3	chr12	110869695	110898222	28527	actin related protein 2/3 complex, subunit 3, 21kDa
PA25002	10093	ARPC4	chr3	9824082	9851789	27707	actin related protein 2/3 complex, subunit 4, 20kDa
PA25003	10092	ARPC5	chr1	183592328	183615076	22748	actin related protein 2/3 complex, subunit 5, 16kDa
PA134991012	81873	ARPC5L	chr9	127616267	127643012	26745	actin related protein 2/3 complex, subunit 5-like
PA142672274	348110	ARPIN	chr15	90440832	90466222	25390	actin-related protein 2/3 complex inhibitor
PA165478498	10776	ARPP19	chr15	52836384	52871436	35052	cAMP-regulated phosphoprotein, 19kDa
PA25004	407	ARR3	chrX	69478185	69504691	26506	arrestin 3, retinal (X-arrestin)
PA59	408	ARRB1	chr11	74968166	75072875	104709	arrestin, beta 1
PA60	409	ARRB2	chr17	4603789	4627795	24006	arrestin, beta 2
PA134938267	92714	ARRDC1	chr9	140490092	140512812	22720	arrestin domain containing 1
PA134945141	27106	ARRDC2	chr19	18101944	18127911	25967	arrestin domain containing 2
PA134925765	57561	ARRDC3	chr5	90661541	90689149	27608	arrestin domain containing 3
PA134895338	91947	ARRDC4	chr15	98493933	98520068	26135	arrestin domain containing 4
PA134917663	645432	ARRDC5	chr19	4887449	4912879	25430	arrestin domain containing 5
PA25005	410	ARSA	chr22	51058182	51076601	18419	arylsulfatase A
PA25006	411	ARSB	chr5	78070032	78292357	222325	arylsulfatase B
PA25008	414	ARSD	chrX	2819011	2857416	38405	arylsulfatase D
PA25010	415	ARSE	chrX	2849673	2896345	46672	arylsulfatase E (chondrodysplasia punctata 1)
PA25012	416	ARSF	chrX	2948275	3033770	85495	arylsulfatase F
PA143485307	22901	ARSG	chr17	66245323	66428516	183193	arylsulfatase G
PA143485308	347527	ARSH	chrX	2914654	2954426	39772	arylsulfatase family, member H
PA143485309	340075	ARSI	chr5	149672909	149692525	19616	arylsulfatase family, member I
PA143485310	79642	ARSJ	chr4	114818432	114911281	92849	arylsulfatase family, member J
PA143485311	153642	ARSK	chr5	94880825	94943806	62981	arylsulfatase family, member K
PA25014	417	ART1	chr11	3653487	3688844	35357	ADP-ribosyltransferase 1
PA25016	419	ART3	chr4	76922333	77036955	114622	ADP-ribosyltransferase 3
PA142672580	420	ART4	chr12	14979245	15006413	27168	ADP-ribosyltransferase 4 (Dombrock blood group)
PA134887713	116969	ART5	chr11	3656733	3673546	16813	ADP-ribosyltransferase 5
PA25017	9048	ARTN	chr1	44388992	44405912	16920	artemin
PA134935092	64801	ARV1	chr1	231104823	231139479	34656	ARV1 homolog (S. cerevisiae)
PA25018	421	ARVCF	chr22	19951126	20014325	63199	armadillo repeat gene deleted in velocardiofacial syndrome
PA25024	170302	ARX	chrX	25018811	25044065	25254	aristaless related homeobox
PA134896392	57412	AS3MT	chr10	104619183	104664656	45473	arsenite methyltransferase
PA35025	427	ASAH1	chr8	17910925	17952507	41582	N-acylsphingosine amidohydrolase (acid ceramidase) 1
PA38720	56624	ASAH2	chr10	51944000	52018370	74370	N-acylsphingosine amidohydrolase (non-lysosomal ceramidase) 2
PA134977109	653308	ASAH2B	chr10	52489688	52519948	30260	N-acylsphingosine amidohydrolase (non-lysosomal ceramidase) 2B
PA134984054	653365	ASAH2C	chr10	47998709	48060538	61829	N-acylsphingosine amidohydrolase (non-lysosomal ceramidase) 2C
PA164716055	50807	ASAP1	chr8	131061350	131465906	404556	ArfGAP with SH3 domain, ankyrin repeat and PH domain 1
PA164716118	8853	ASAP2	chr2	9336894	9548812	211918	ArfGAP with SH3 domain, ankyrin repeat and PH domain 2
PA164716179	55616	ASAP3	chr1	23752056	23820750	68694	ArfGAP with SH3 domain, ankyrin repeat and PH domain 3
PA25027	51665	ASB1	chr2	239325382	239363891	38509	ankyrin repeat and SOCS box containing 1
PA25028	136371	ASB10	chr7	150869785	150894919	25134	ankyrin repeat and SOCS box containing 10
PA25029	140456	ASB11	chrX	15290800	15343788	52988	ankyrin repeat and SOCS box containing 11, E3 ubiquitin protein ligase
PA134937084	142689	ASB12	chrX	63441072	63460511	19439	ankyrin repeat and SOCS box containing 12
PA134992129	79754	ASB13	chr10	5677820	5718558	40738	ankyrin repeat and SOCS box containing 13
PA134983884	142686	ASB14	chr3	57299379	57336753	37374	ankyrin repeat and SOCS box containing 14
PA134977130	142685	ASB15	chr7	123231882	123280951	49069	ankyrin repeat and SOCS box containing 15
PA134879678	92591	ASB16	chr17	42238074	42259650	21576	ankyrin repeat and SOCS box containing 16
PA142672248	339201	ASB16-AS1	chr17	42250341	42274085	23744	ASB16 antisense RNA 1
PA134958560	127247	ASB17	chr1	76381558	76408116	26558	ankyrin repeat and SOCS box containing 17
PA134950797	401036	ASB18	chr2	237100515	237182988	82473	ankyrin repeat and SOCS box containing 18
PA25030	51676	ASB2	chr14	94397499	94453085	55586	ankyrin repeat and SOCS box containing 2
PA25031	51130	ASB3	chr2	53894117	54024146	130029	ankyrin repeat and SOCS box containing 3
PA25032	51666	ASB4	chr7	95105213	95172543	67330	ankyrin repeat and SOCS box containing 4
PA25033	140458	ASB5	chr4	177131824	177208722	76898	ankyrin repeat and SOCS box containing 5
PA25034	140459	ASB6	chr9	132393883	132414496	20613	ankyrin repeat and SOCS box containing 6
PA25035	140460	ASB7	chr15	101132755	101194906	62151	ankyrin repeat and SOCS box containing 7
PA25036	140461	ASB8	chr12	48538572	48561377	22805	ankyrin repeat and SOCS box containing 8
PA25037	140462	ASB9	chrX	15259109	15298589	39480	ankyrin repeat and SOCS box containing 9
PA134974899	51008	ASCC1	chr10	73852790	73986892	134102	activating signal cointegrator 1 complex subunit 1
PA134916940	84164	ASCC2	chr22	30181597	30244293	62696	activating signal cointegrator 1 complex subunit 2
PA134890913	10973	ASCC3	chr6	100953325	101339243	385918	activating signal cointegrator 1 complex subunit 3
PA26416	429	ASCL1	chr12	103341452	103357294	15842	achaete-scute family bHLH transcription factor 1
PA25039	430	ASCL2	chr11	2286728	2302182	15454	achaete-scute family bHLH transcription factor 2
PA25040	56676	ASCL3	chr11	8956119	8974580	18461	achaete-scute family bHLH transcription factor 3
PA134869300	121549	ASCL4	chr12	108158162	108173421	15259	achaete-scute family bHLH transcription factor 4
PA128394636	25842	ASF1A	chr6	119205241	119233336	28095	anti-silencing function 1A histone chaperone
PA134931112	55723	ASF1B	chr19	14227321	14257440	30119	anti-silencing function 1B histone chaperone
PA25042	432	ASGR1	chr17	7073750	7092883	19133	asialoglycoprotein receptor 1
PA25043	433	ASGR2	chr17	7001641	7028292	26651	asialoglycoprotein receptor 2
PA134891064	55870	ASH1L	chr1	155302052	155542324	240272	ash1 (absent, small, or homeotic)-like (Drosophila)
PA25044	9070	ASH2L	chr8	37952483	38000598	48115	ash2 (absent, small, or homeotic)-like (Drosophila)
PA24434	41	ASIC1	chr12	50441420	50480405	38985	acid-sensing (proton-gated) ion channel 1
PA24433	40	ASIC2	chr17	31337105	32493825	1156720	acid-sensing (proton-gated) ion channel 2
PA24435	9311	ASIC3	chr7	150735379	150752843	17464	acid-sensing (proton-gated) ion channel 3
PA134956731	55515	ASIC4	chr2	220368892	220406494	37602	acid-sensing (proton-gated) ion channel family member 4
PA134946702	51802	ASIC5	chr4	156747881	156797425	49544	acid-sensing (proton-gated) ion channel family member 5
PA25045	434	ASIP	chr20	32819188	32860150	40962	agouti signaling protein
PA25046	435	ASL	chr7	65530776	65561330	30554	argininosuccinate lyase
PA25049	438	ASMT	chrY	1654348	1714974	60626	acetylserotonin O-methyltransferase
PA25050	8623	ASMTL	chrY	1469032	1532687	63655	acetylserotonin O-methyltransferase-like
PA25051	439	ASNA1	chr19	12838306	12862137	23831	arsA arsenite transporter, ATP-binding, homolog 1 (bacterial)
PA25052	440	ASNS	chr7	97478429	97511854	33425	asparagine synthetase (glutamine-hydrolyzing)
PA143485312	54529	ASNSD1	chr2	190516125	190538557	22432	asparagine synthetase domain containing 1
PA25055	443	ASPA	chr17	3367404	3405700	38296	aspartoacylase
PA164716234	554235	ASPDH	chr19	51011857	51028689	16832	aspartate dehydrogenase domain containing
PA25056	444	ASPH	chr8	62410115	62637199	227084	aspartate beta-hydroxylase
PA143485313	253982	ASPHD1	chr16	29902147	29934181	32034	aspartate beta-hydroxylase domain containing 1
PA143485314	57168	ASPHD2	chr22	26815280	26843978	28698	aspartate beta-hydroxylase domain containing 2
PA38782	259266	ASPM	chr1	197050257	197125824	75567	asp (abnormal spindle) homolog, microcephaly associated (Drosophila)
PA25057	54829	ASPN	chr9	95215487	95254844	39357	asporin
PA162376919	151516	ASPRV1	chr2	70184221	70199397	15176	aspartic peptidase, retroviral-like 1
PA25058	79058	ASPSCR1	chr17	79925426	79978282	52856	alveolar soft part sarcoma chromosome region, candidate 1
PA25059	80150	ASRGL1	chr11	62094774	62163887	69113	asparaginase like 1
PA162376926	445	ASS1	chr9	133310094	133379661	69567	argininosuccinate synthase 1
PA142672577	28990	ASTE1	chr3	130729721	130755698	25977	asteroid homolog 1 (Drosophila)
PA134922299	431705	ASTL	chr2	96786589	96814175	27586	astacin-like metallo-endopeptidase (M12 family)
PA162376961	460	ASTN1	chr1	176823441	177144024	320583	astrotactin 1
PA25076	23245	ASTN2	chr9	119184504	120187317	1002813	astrotactin 2
PA134892469	55726	ASUN	chr12	27055112	27101254	46142	asunder spermatogenesis regulator
PA25078	171023	ASXL1	chr20	30936147	31030122	93975	additional sex combs like transcriptional regulator 1
PA134884863	55252	ASXL2	chr2	25959253	26111312	152059	additional sex combs like transcriptional regulator 2
PA162377010	80816	ASXL3	chr18	31148541	31334159	185618	additional sex combs like transcriptional regulator 3
PA25950	136991	ASZ1	chr7	117000276	117077577	77301	ankyrin repeat, SAM and basic leucine zipper domain containing 1
PA134914940	84896	ATAD1	chr10	89508608	89611111	102503	ATPase family, AAA domain containing 1
PA134895566	29028	ATAD2	chr8	124329090	124418705	89615	ATPase family, AAA domain containing 2
PA162377039	54454	ATAD2B	chr2	23968534	24159978	191444	ATPase family, AAA domain containing 2B
PA134872099	55210	ATAD3A	chr1	1437523	1473067	35544	ATPase family, AAA domain containing 3A
PA134993325	83858	ATAD3B	chr1	1397139	1447852	50713	ATPase family, AAA domain containing 3B
PA142672578	219293	ATAD3C	chr1	1368152	1408538	40386	ATPase family, AAA domain containing 3C
PA162377100	79915	ATAD5	chr17	29149020	29225295	76275	ATPase family, AAA domain containing 5
PA134948212	79969	ATAT1	chr6	30584613	30617598	32985	alpha tubulin acetyltransferase 1
PA25080	85300	ATCAY	chr19	3870618	3931080	60462	ataxia, cerebellar, Cayman type
PA25082	11101	ATE1	chr10	123496939	123698149	201210	arginyltransferase 1
PA25083	466	ATF1	chr12	51147789	51217943	70154	activating transcription factor 1
PA25084	1386	ATF2	chr2	175933978	176042934	108956	activating transcription factor 2
PA25085	467	ATF3	chr1	212728676	212797119	68443	activating transcription factor 3
PA25086	468	ATF4	chr22	39906569	39921691	15122	activating transcription factor 4
PA25090	22809	ATF5	chr19	50421959	50440193	18234	activating transcription factor 5
PA25091	22926	ATF6	chr1	161726034	161936860	210826	activating transcription factor 6
PA164716250	1388	ATF6B	chr6	32080045	32106017	25972	activating transcription factor 6 beta
PA25092	11016	ATF7	chr12	53898640	54030200	131560	activating transcription factor 7
PA134889460	55729	ATF7IP	chr12	14508566	14658864	150298	activating transcription factor 7 interacting protein
PA134988230	80063	ATF7IP2	chr16	10469912	10580495	110583	activating transcription factor 7 interacting protein 2
PA134872167	83734	ATG10	chr5	81257844	81554958	297114	autophagy related 10
PA143485374	60673	ATG101	chr12	52453758	52474279	20521	autophagy related 101
PA24879	9140	ATG12	chr5	115160893	115187548	26655	autophagy related 12
PA165543187	9776	ATG13	chr11	46628826	46700569	71743	autophagy related 13
PA165478560	22863	ATG14	chr14	55830109	55888576	58467	autophagy related 14
PA134902949	55054	ATG16L1	chr2	234150217	234207320	57103	autophagy related 16-like 1 (S. cerevisiae)
PA142672575	89849	ATG16L2	chr11	72515451	72556793	41342	autophagy related 16-like 2 (S. cerevisiae)
PA162377101	23130	ATG2A	chr11	64659004	64694722	35718	autophagy related 2A
PA162377102	55102	ATG2B	chr14	96744595	96839678	95083	autophagy related 2B
PA134883444	64422	ATG3	chr3	112248354	112290810	42456	autophagy related 3
PA25184	115201	ATG4A	chrX	107324899	107400901	76002	autophagy related 4A, cysteine peptidase
PA134898340	23192	ATG4B	chr2	242566775	242616272	49497	autophagy related 4B, cysteine peptidase
PA25183	84938	ATG4C	chr1	63239777	63333941	94164	autophagy related 4C, cysteine peptidase
PA134907475	84971	ATG4D	chr19	10644570	10667099	22529	autophagy related 4D, cysteine peptidase
PA24880	9474	ATG5	chr6	106629351	106783695	154344	autophagy related 5
PA134983397	10533	ATG7	chr3	11304010	11602139	298129	autophagy related 7
PA134931318	79065	ATG9A	chr2	220081102	220104387	23285	autophagy related 9A
PA134883165	285973	ATG9B	chr7	150706297	150731586	25289	autophagy related 9B
PA142672576	80162	ATHL1	chr11	278480	300511	22031	ATH1, acid trehalase-like 1 (yeast)
PA25094	471	ATIC	chr2	216166679	216217496	50817	5-aminoimidazole-4-carboxamide ribonucleotide formyltransferase/IMP cyclohydrolase
PA36061	51062	ATL1	chr14	50989800	51102786	112986	atlastin GTPase 1
PA164716322	64225	ATL2	chr2	38519027	38614432	95405	atlastin GTPase 2
PA164716353	25923	ATL3	chr11	63388554	63449533	60979	atlastin GTPase 3
PA61	472	ATM	chr11	108083559	108242829	159270	ATM serine/threonine kinase
PA162377191	23300	ATMIN	chr16	81059458	81083955	24497	ATM interactor
PA27487	1822	ATN1	chr12	7023626	7054484	30858	atrophin 1
PA25095	474	ATOH1	chr4	94740078	94754142	14064	atonal homolog 1 (Drosophila)
PA38369	220202	ATOH7	chr10	69987352	70001870	14518	atonal homolog 7 (Drosophila)
PA134904746	84913	ATOH8	chr2	85970909	86021506	50597	atonal homolog 8 (Drosophila)
PA25096	475	ATOX1	chr5	151119383	151148210	28827	antioxidant 1 copper chaperone
PA25097	57194	ATP10A	chr15	25920859	26120304	199445	ATPase, class V, type 10A
PA25098	23120	ATP10B	chr5	159987127	160289219	302092	ATPase, class V, type 10B
PA25100	57205	ATP10D	chr4	47477296	47598503	121207	ATPase, class V, type 10D
PA25101	23250	ATP11A	chr13	113334358	113544482	210124	ATPase, class VI, type 11A
PA162378074	400165	ATP11AUN	chr13	113291358	113341811	50453	ATP11A upstream neighbor
PA25102	23200	ATP11B	chr3	182501291	182642423	141132	ATPase, class VI, type 11B
PA25103	286410	ATP11C	chrX	138805505	139025190	219685	ATPase, class VI, type 11C
PA25104	479	ATP12A	chr13	25244549	25288923	44374	ATPase, H+/K+ transporting, nongastric, alpha polypeptide
PA134988892	57130	ATP13A1	chr19	19753007	19784512	31505	ATPase type 13A1
PA134897221	23400	ATP13A2	chr1	17309453	17348467	39014	ATPase type 13A2
PA134971145	79572	ATP13A3	chr3	194120403	194198968	78565	ATPase type 13A3
PA134979581	84239	ATP13A4	chr3	193116866	193282810	165944	ATPase type 13A4
PA134952038	344905	ATP13A5	chr3	192989831	193106514	116683	ATPase type 13A5
PA62	476	ATP1A1	chr1	116904802	116951069	46267	ATPase, Na+/K+ transporting, alpha 1 polypeptide
PA165750414	84852	ATP1A1OS	chr1	116932487	116971244	38757	ATP1A1 opposite strand
PA30796	477	ATP1A2	chr1	160075520	160116381	40861	ATPase, Na+/K+ transporting, alpha 2 polypeptide
PA64	478	ATP1A3	chr19	42467628	42508428	40800	ATPase, Na+/K+ transporting, alpha 3 polypeptide
PA65	480	ATP1A4	chr1	160111352	160159767	48415	ATPase, Na+/K+ transporting, alpha 4 polypeptide
PA66	481	ATP1B1	chr1	169065947	169104960	39013	ATPase, Na+/K+ transporting, beta 1 polypeptide
PA67	482	ATP1B2	chr17	7544254	7564089	19835	ATPase, Na+/K+ transporting, beta 2 polypeptide
PA68	483	ATP1B3	chr3	141585424	141648382	62958	ATPase, Na+/K+ transporting, beta 3 polypeptide
PA410	23439	ATP1B4	chrX	119485940	119520104	34164	ATPase, Na+/K+ transporting, beta 4 polypeptide
PA25105	487	ATP2A1	chr16	28879192	28918830	39638	ATPase, Ca++ transporting, cardiac muscle, fast twitch 1
PA71	488	ATP2A2	chr12	110709032	110791898	82866	ATPase, Ca++ transporting, cardiac muscle, slow twitch 2
PA25106	489	ATP2A3	chr17	3824163	3877758	53595	ATPase, Ca++ transporting, ubiquitous
PA25107	490	ATP2B1	chr12	89978826	90113130	134304	ATPase, Ca++ transporting, plasma membrane 1
PA25108	491	ATP2B2	chr3	10362707	10743131	380424	ATPase, Ca++ transporting, plasma membrane 2
PA25109	492	ATP2B3	chrX	152773905	152851387	77482	ATPase, Ca++ transporting, plasma membrane 3
PA25110	493	ATP2B4	chr1	203585915	203716209	130294	ATPase, Ca++ transporting, plasma membrane 4
PA25111	27032	ATP2C1	chr3	130559327	130738556	179229	ATPase, Ca++ transporting, type 2C, member 1
PA162377204	9914	ATP2C2	chr16	84392129	84500793	108664	ATPase, Ca++ transporting, type 2C, member 2
PA25113	495	ATP4A	chr19	36038095	36064560	26465	ATPase, H+/K+ exchanging, alpha polypeptide
PA25114	496	ATP4B	chr13	114300119	114322513	22394	ATPase, H+/K+ exchanging, beta polypeptide
PA25115	498	ATP5A1	chr18	43661110	43694199	33089	ATP synthase, H+ transporting, mitochondrial F1 complex, alpha subunit 1, cardiac muscle
PA25122	506	ATP5B	chr12	57028959	57049852	20893	ATP synthase, H+ transporting, mitochondrial F1 complex, beta polypeptide
PA25125	509	ATP5C1	chr10	7820093	7852764	32671	ATP synthase, H+ transporting, mitochondrial F1 complex, gamma polypeptide 1
PA25127	513	ATP5D	chr19	1231749	1247824	16075	ATP synthase, H+ transporting, mitochondrial F1 complex, delta subunit
PA25128	514	ATP5E	chr20	57600733	57617422	16689	ATP synthase, H+ transporting, mitochondrial F1 complex, epsilon subunit
PA25130	515	ATP5F1	chr1	111981467	112007540	26073	ATP synthase, H+ transporting, mitochondrial Fo complex, subunit B1
PA25131	516	ATP5G1	chr17	46960148	46976233	16085	ATP synthase, H+ transporting, mitochondrial Fo complex, subunit C1 (subunit 9)
PA25132	517	ATP5G2	chr12	54055944	54080512	24568	ATP synthase, H+ transporting, mitochondrial Fo complex, subunit C2 (subunit 9)
PA25133	518	ATP5G3	chr2	176037986	176056490	18504	ATP synthase, H+ transporting, mitochondrial Fo complex, subunit C3 (subunit 9)
PA25135	10476	ATP5H	chr17	73031955	73053074	21119	ATP synthase, H+ transporting, mitochondrial Fo complex, subunit d
PA25136	521	ATP5I	chr4	663225	678127	14902	ATP synthase, H+ transporting, mitochondrial Fo complex, subunit E
PA25137	522	ATP5J	chr21	27093791	27117965	24174	ATP synthase, H+ transporting, mitochondrial Fo complex, subunit F6
PA25138	9551	ATP5J2	chr7	99052784	99073824	21040	ATP synthase, H+ transporting, mitochondrial Fo complex, subunit F2
PA25143	10632	ATP5L	chr11	118262104	118283562	21458	ATP synthase, H+ transporting, mitochondrial Fo complex, subunit G
PA134948694	267020	ATP5L2	chr22	43032809	43046607	13798	ATP synthase, H+ transporting, mitochondrial Fo complex, subunit G2
PA25144	539	ATP5O	chr21	35272757	35298158	25401	ATP synthase, H+ transporting, mitochondrial F1 complex, O subunit
PA134991095	27109	ATP5S	chr14	50768256	50805359	37103	ATP synthase, H+ transporting, mitochondrial Fo complex, subunit s (factor B)
PA162377263	55101	ATP5SL	chr19	41934223	41955843	21620	ATP5S-like
PA25145	537	ATP6AP1	chrX	153646978	153667862	20884	ATPase, H+ transporting, lysosomal accessory protein 1
PA164716384	92270	ATP6AP1L	chr5	81591166	81617147	25981	ATPase, H+ transporting, lysosomal accessory protein 1-like
PA38523	10159	ATP6AP2	chrX	40430141	40468889	38748	ATPase, H+ transporting, lysosomal accessory protein 2
PA25146	535	ATP6V0A1	chr17	40600862	40677597	76735	ATPase, H+ transporting, lysosomal V0 subunit a1
PA38549	23545	ATP6V0A2	chr12	124186865	124249302	62437	ATPase, H+ transporting, lysosomal V0 subunit a2
PA25147	50617	ATP6V0A4	chr7	138388039	138494305	106266	ATPase, H+ transporting, lysosomal V0 subunit a4
PA25148	533	ATP6V0B	chr1	44430118	44446972	16854	ATPase, H+ transporting, lysosomal 21kDa, V0 subunit b
PA25149	527	ATP6V0C	chr16	2553727	2573224	19497	ATPase, H+ transporting, lysosomal 16kDa, V0 subunit c
PA25150	9114	ATP6V0D1	chr16	67468917	67525089	56172	ATPase, H+ transporting, lysosomal 38kDa, V0 subunit d1
PA38516	245972	ATP6V0D2	chr8	87101139	87169454	68315	ATPase, H+ transporting, lysosomal 38kDa, V0 subunit d2
PA25151	8992	ATP6V0E1	chr5	172400763	172464900	64137	ATPase, H+ transporting, lysosomal 9kDa, V0 subunit e1
PA162377277	155066	ATP6V0E2	chr7	149560053	149580787	20734	ATPase, H+ transporting V0 subunit e2
PA25152	523	ATP6V1A	chr3	113455866	113533905	78039	ATPase, H+ transporting, lysosomal 70kDa, V1 subunit A
PA25154	525	ATP6V1B1	chr2	71152998	71195561	42563	ATPase, H+ transporting, lysosomal 56/58kDa, V1 subunit B1
PA25155	526	ATP6V1B2	chr8	20044704	20082207	37503	ATPase, H+ transporting, lysosomal 56/58kDa, V1 subunit B2
PA25156	528	ATP6V1C1	chr8	104023248	104088285	65037	ATPase, H+ transporting, lysosomal 42kDa, V1 subunit C1
PA38514	245973	ATP6V1C2	chr2	10851775	10928236	76461	ATPase, H+ transporting, lysosomal 42kDa, V1 subunit C2
PA25157	51382	ATP6V1D	chr14	67801581	67836720	35139	ATPase, H+ transporting, lysosomal 34kDa, V1 subunit D
PA25158	529	ATP6V1E1	chr22	18071902	18121588	49686	ATPase, H+ transporting, lysosomal 31kDa, V1 subunit E1
PA25159	90423	ATP6V1E2	chr2	46735986	46779551	43565	ATPase, H+ transporting, lysosomal 31kDa, V1 subunit E2
PA38421	9296	ATP6V1F	chr7	128492857	128508903	16046	ATPase, H+ transporting, lysosomal 14kDa, V1 subunit F
PA25163	9550	ATP6V1G1	chr9	117339994	117364152	24158	ATPase, H+ transporting, lysosomal 13kDa, V1 subunit G1
PA25164	534	ATP6V1G2	chr6	31509228	31524625	15397	ATPase, H+ transporting, lysosomal 13kDa, V1 subunit G2
PA38515	127124	ATP6V1G3	chr1	198489352	198520075	30723	ATPase, H+ transporting, lysosomal 13kDa, V1 subunit G3
PA38521	51606	ATP6V1H	chr8	54625103	54766099	140996	ATPase, H+ transporting, lysosomal 50/57kDa, V1 subunit H
PA72	538	ATP7A	chrX	77156194	77308892	152698	ATPase, Cu++ transporting, alpha polypeptide
PA73	540	ATP7B	chr13	52503805	52596181	92376	ATPase, Cu++ transporting, beta polypeptide
PA25165	10396	ATP8A1	chr4	42407390	42669122	261732	ATPase, aminophospholipid transporter (APLT), class I, type 8A, member 1
PA25166	51761	ATP8A2	chr13	25936209	26602989	666780	ATPase, aminophospholipid transporter, class I, type 8A, member 2
PA265	5205	ATP8B1	chr18	55310658	55480327	169669	ATPase, aminophospholipid transporter, class I, type 8B, member 1
PA25167	57198	ATP8B2	chr1	154288036	154326780	38744	ATPase, aminophospholipid transporter, class I, type 8B, member 2
PA25168	148229	ATP8B3	chr19	1779074	1822275	43201	ATPase, aminophospholipid transporter, class I, type 8B, member 3
PA25169	79895	ATP8B4	chr15	50147435	50421419	273984	ATPase, class I, type 8B, member 4
PA25171	10079	ATP9A	chr20	50210314	50394908	184594	ATPase, class II, type 9A
PA25172	374868	ATP9B	chr18	76819394	77141283	321889	ATPase, class II, type 9B
PA38687	64756	ATPAF1	chr1	47097711	47144099	46388	ATP synthase mitochondrial F1 complex assembly factor 1
PA38686	91647	ATPAF2	chr17	17918334	17952483	34149	ATP synthase mitochondrial F1 complex assembly factor 2
PA25173	93974	ATPIF1	chr1	28552602	28567616	15014	ATPase inhibitory factor 1
PA74	545	ATR	chr3	142165077	142307668	142591	ATR serine/threonine kinase
PA134964154	51374	ATRAID	chr2	27424899	27443046	18147	all-trans retinoic acid-induced differentiation factor
PA162377290	84126	ATRIP	chr3	48478114	48512044	33930	ATR interacting protein
PA25178	8455	ATRN	chr20	3441665	3634769	193104	attractin
PA134961599	26033	ATRNL1	chr10	116843124	117711496	868372	attractin-like 1
PA25179	546	ATRX	chrX	76757356	77051755	294399	alpha thalassemia/mental retardation syndrome X-linked
PA34958	6310	ATXN1	chr6	16296343	16771721	475378	ataxin 1
PA34959	25814	ATXN10	chr22	46057678	46244187	186509	ataxin 10
PA162377321	342371	ATXN1L	chr16	71869894	71894236	24342	ataxin 1-like
PA34968	6311	ATXN2	chr12	111887018	112047480	160462	ataxin 2
PA128394585	11273	ATXN2L	chr16	28824369	28851558	27189	ataxin 2-like
PA134971833	4287	ATXN3	chr14	92521896	92582965	61069	ataxin 3
PA134884147	92552	ATXN3L	chrX	13333766	13348518	14752	ataxin 3-like
PA34973	6314	ATXN7	chr3	63839785	63992240	152455	ataxin 7
PA134884892	222255	ATXN7L1	chr7	105241932	105527046	285114	ataxin 7-like 1
PA134927530	127002	ATXN7L2	chr1	110016533	110038426	21893	ataxin 7-like 2
PA134991793	56970	ATXN7L3	chr17	42266173	42285747	19574	ataxin 7-like 3
PA165512339	552889	ATXN7L3B	chr12	74921551	74938232	16681	ataxin 7-like 3B
PA25181	549	AUH	chr9	93973097	94134215	161118	AU RNA binding protein/enoyl-CoA hydratase
PA142672453	79000	AUNIP	chr1	26155414	26195939	40525	aurora kinase A and ninein interacting protein
PA25182	550	AUP1	chr2	74750775	74767019	16244	ancient ubiquitous protein 1
PA36201	6790	AURKA	chr20	54941445	54977351	35906	aurora kinase A
PA142672568	54998	AURKAIP1	chr1	1306110	1320818	14708	aurora kinase A interacting protein 1
PA36199	9212	AURKB	chr17	8105049	8123944	18895	aurora kinase B
PA36200	6795	AURKC	chr19	57731750	57749916	18166	aurora kinase C
PA134863175	26053	AUTS2	chr7	69053905	70260885	1206980	autism susceptibility candidate 2
PA134874337	57099	AVEN	chr15	34155428	34341303	185875	apoptosis, caspase activation inhibitor
PA38380	10677	AVIL	chr12	58187415	58220193	32778	advillin
PA164716408	23080	AVL9	chr7	32525101	32631327	106226	AVL9 homolog (S. cerevisiase)
PA25186	551	AVP	chr20	3060202	3075370	15168	arginine vasopressin
PA134905326	60370	AVPI1	chr10	99434181	99457015	22834	arginine vasopressin-induced 1
PA25187	552	AVPR1A	chr12	63533539	63557971	24432	arginine vasopressin receptor 1A
PA25188	553	AVPR1B	chr1	206214283	206234482	20199	arginine vasopressin receptor 1B
PA25189	554	AVPR2	chrX	153157985	153175620	17635	arginine vasopressin receptor 2
PA164716409	158833	AWAT1	chrX	69444505	69463511	19006	acyl-CoA wax alcohol acyltransferase 1
PA164716410	158835	AWAT2	chrX	69257392	69279788	22396	acyl-CoA wax alcohol acyltransferase 2
PA142672443	126859	AXDND1	chr1	179324855	179526870	202015	axonemal dynein light chain domain containing 1
PA25195	8312	AXIN1	chr16	334440	415244	80804	axin 1
PA25196	8313	AXIN2	chr17	63521681	63567740	46059	axin 2
PA25197	558	AXL	chr19	41715104	41770672	55568	AXL receptor tyrosine kinase
PA25203	563	AZGP1	chr7	99561350	99583735	22385	alpha-2-glycoprotein 1, zinc-binding
PA134950985	64343	AZI2	chr3	28360844	28400915	40071	5-azacytidine induced 2
PA31887	51582	AZIN1	chr8	103835536	103886905	51369	antizyme inhibitor 1
PA142672642	113451	AZIN2	chr1	33536714	33588995	52281	antizyme inhibitor 2
PA25206	566	AZU1	chr19	817831	835017	17186	azurocidin 1
PA25207	567	B2M	chr15	44993685	45013357	19672	beta-2-microglobulin
PA25211	8706	B3GALNT1	chr3	160798671	160833160	34489	beta-1,3-N-acetylgalactosaminyltransferase 1 (globoside blood group)
PA142672567	148789	B3GALNT2	chr1	235607505	235677781	70276	beta-1,3-N-acetylgalactosaminyltransferase 2
PA25209	8708	B3GALT1	chr2	168336692	168730366	393674	UDP-Gal:betaGlcNAc beta 1,3-galactosyltransferase, polypeptide 1
PA25210	8707	B3GALT2	chr1	193144860	193165743	20883	UDP-Gal:betaGlcNAc beta 1,3-galactosyltransferase, polypeptide 2
PA25212	8705	B3GALT4	chr6	33234917	33249602	14685	UDP-Gal:betaGlcNAc beta 1,3-galactosyltransferase, polypeptide 4
PA25213	10317	B3GALT5	chr21	40918369	41037816	119447	UDP-Gal:betaGlcNAc beta 1,3-galactosyltransferase, polypeptide 5
PA25214	126792	B3GALT6	chr1	1157629	1173421	15792	UDP-Gal:betaGal beta 1,3-galactosyltransferase polypeptide 6
PA144596515	145173	B3GALTL	chr13	31764112	31909413	145301	beta 1,3-galactosyltransferase-like
PA25215	27087	B3GAT1	chr11	134245398	134291880	46482	beta-1,3-glucuronyltransferase 1
PA25216	135152	B3GAT2	chr6	71563914	71677101	113187	beta-1,3-glucuronyltransferase 2
PA25217	26229	B3GAT3	chr11	62379768	62399647	19879	beta-1,3-glucuronyltransferase 3
PA164741279	11041	B3GNT1	chr11	66109843	66125161	15318	UDP-GlcNAc:betaGal beta-1,3-N-acetylglucosaminyltransferase 1
PA25218	10678	B3GNT2	chr2	62413262	62454866	41604	UDP-GlcNAc:betaGal beta-1,3-N-acetylglucosaminyltransferase 2
PA25219	10331	B3GNT3	chr19	17895919	17927385	31466	UDP-GlcNAc:betaGal beta-1,3-N-acetylglucosaminyltransferase 3
PA25220	79369	B3GNT4	chr12	122678228	122695677	17449	UDP-GlcNAc:betaGal beta-1,3-N-acetylglucosaminyltransferase 4
PA25221	84002	B3GNT5	chr3	182961032	182994179	33147	UDP-GlcNAc:betaGal beta-1,3-N-acetylglucosaminyltransferase 5
PA164741288	192134	B3GNT6	chr11	76735385	76756020	20635	UDP-GlcNAc:betaGal beta-1,3-N-acetylglucosaminyltransferase 6 (core 3 synthase)
PA38692	93010	B3GNT7	chr2	232250335	232268875	18540	UDP-GlcNAc:betaGal beta-1,3-N-acetylglucosaminyltransferase 7
PA134910679	374907	B3GNT8	chr19	41928264	41944635	16371	UDP-GlcNAc:betaGal beta-1,3-N-acetylglucosaminyltransferase 8
PA164716431	84752	B3GNT9	chr16	67179005	67194902	15897	UDP-GlcNAc:betaGal beta-1,3-N-acetylglucosaminyltransferase 9
PA134910219	146712	B3GNTL1	chr17	80897009	81019686	122677	UDP-GlcNAc:betaGal beta-1,3-N-acetylglucosaminyltransferase-like 1
PA28532	2583	B4GALNT1	chr12	58016678	58037022	20344	beta-1,4-N-acetyl-galactosaminyl transferase 1
PA134988070	124872	B4GALNT2	chr17	47199822	47250351	50529	beta-1,4-N-acetyl-galactosaminyl transferase 2
PA142672564	283358	B4GALNT3	chr12	559543	674503	114960	beta-1,4-N-acetyl-galactosaminyl transferase 3
PA142672565	338707	B4GALNT4	chr11	359795	385117	25322	beta-1,4-N-acetyl-galactosaminyl transferase 4
PA25223	2683	B4GALT1	chr9	33107636	33177356	69720	UDP-Gal:betaGlcNAc beta 1,4- galactosyltransferase, polypeptide 1
PA25224	8704	B4GALT2	chr1	44434874	44459843	24969	UDP-Gal:betaGlcNAc beta 1,4- galactosyltransferase, polypeptide 2
PA25225	8703	B4GALT3	chr1	161138100	161157758	19658	UDP-Gal:betaGlcNAc beta 1,4- galactosyltransferase, polypeptide 3
PA25226	8702	B4GALT4	chr3	118927589	118969754	42165	UDP-Gal:betaGlcNAc beta 1,4- galactosyltransferase, polypeptide 4
PA25227	9334	B4GALT5	chr20	48246482	48340421	93939	UDP-Gal:betaGlcNAc beta 1,4- galactosyltransferase, polypeptide 5
PA25228	9331	B4GALT6	chr18	29199209	29316560	117351	UDP-Gal:betaGlcNAc beta 1,4- galactosyltransferase, polypeptide 6
PA25229	11285	B4GALT7	chr5	177017119	177040348	23229	xylosylprotein beta 1,4-galactosyltransferase, polypeptide 7
PA162377328	27077	B9D1	chr17	19237563	19291495	53932	B9 protein domain 1
PA162377347	80776	B9D2	chr19	41857322	41880078	22756	B9 protein domain 2
PA25230	79870	BAALC	chr8	104142921	104245533	102612	brain and acute leukemia, cytoplasmic
PA25231	570	BAAT	chr9	104119699	104157287	37588	bile acid CoA:amino acid N-acyltransferase
PA162378767	29086	BABAM1	chr19	17368200	17393162	24962	BRISC and BRCA1 A complex member 1
PA25232	23621	BACE1	chr11	117153402	117196972	43570	beta-site APP-cleaving enzyme 1
PA25233	25825	BACE2	chr21	42529728	42657461	127733	beta-site APP-cleaving enzyme 2
PA25234	571	BACH1	chr21	30661151	30737257	76106	BTB and CNC homology 1, basic leucine zipper transcription factor 1
PA25235	60468	BACH2	chr6	90633247	91016627	383380	BTB and CNC homology 1, basic leucine zipper transcription factor 2
PA25236	572	BAD	chr11	64034300	64062176	27876	BCL2-associated agonist of cell death
PA25237	573	BAG1	chr9	33249469	33274759	25290	BCL2-associated athanogene
PA25238	9532	BAG2	chr6	57027104	57053013	25909	BCL2-associated athanogene 2
PA25239	9531	BAG3	chr10	121400859	121440331	39472	BCL2-associated athanogene 3
PA25240	9530	BAG4	chr8	38024106	38073819	49713	BCL2-associated athanogene 4
PA25241	9529	BAG5	chr14	104019881	104039151	19270	BCL2-associated athanogene 5
PA25264	7917	BAG6	chr6	31603805	31630953	27148	BCL2-associated athanogene 6
PA25243	85319	BAGE2	chr21	11017842	11108925	91083	B melanoma antigen family, member 2
PA25244	85318	BAGE3	chr21	11017843	11068324	50481	B melanoma antigen family, member 3
PA128394719	57597	BAHCC1	chr17	79363540	79436358	72818	BAH domain and coiled-coil containing 1
PA128394592	22893	BAHD1	chr15	40723411	40763441	40030	bromo adjacent homology domain containing 1
PA25247	575	BAI1	chr8	143535377	143629369	93992	brain-specific angiogenesis inhibitor 1
PA25248	576	BAI2	chr1	32189718	32240494	50776	brain-specific angiogenesis inhibitor 2
PA25249	577	BAI3	chr6	69335210	70102403	767193	brain-specific angiogenesis inhibitor 3
PA25251	10458	BAIAP2	chr17	78998944	79094232	95288	BAI1-associated protein 2
PA142672562	55971	BAIAP2L1	chr7	97917962	98040427	122465	BAI1-associated protein 2-like 1
PA142672563	80115	BAIAP2L2	chr22	38477896	38516971	39075	BAI1-associated protein 2-like 2
PA25252	8938	BAIAP3	chr16	1373606	1402442	28836	BAI1-associated protein 3
PA25253	578	BAK1	chr6	33537323	33558072	20749	BCL2-antagonist/killer 1
PA25308	600	BAK1P1	chr20	31273732	31288856	15124	BCL2-antagonist/killer 1 pseudogene 1
PA134909139	25805	BAMBI	chr10	28956424	28974868	18444	BMP and activin membrane-bound inhibitor
PA134903639	8815	BANF1	chr11	65759550	65774617	15067	barrier to autointegration factor 1
PA162377348	140836	BANF2	chr20	17664320	17719517	55197	barrier to autointegration factor 2
PA128394677	55024	BANK1	chr4	102701764	102998969	297205	B-cell scaffold protein with ankyrin repeats 1
PA134933411	54971	BANP	chr16	87974231	88113924	139693	BTG3 associated nuclear protein
PA25254	8314	BAP1	chr3	52432020	52454121	22101	BRCA1 associated protein-1 (ubiquitin carboxy-terminal hydrolase)
PA25256	580	BARD1	chr2	215587370	215684428	97058	BRCA1 associated RING domain 1
PA25257	56751	BARHL1	chr9	135447993	135468640	20647	BarH-like homeobox 1
PA25258	343472	BARHL2	chr1	91174579	91192794	18215	BarH-like homeobox 2
PA25259	56033	BARX1	chr9	96710909	96727608	16699	BARX homeobox 1
PA25260	8538	BARX2	chr11	129235879	129325174	89295	BARX homeobox 2
PA25261	10409	BASP1	chr5	17206932	17279954	73022	brain abundant, membrane attached signal protein 1
PA25268	10538	BATF	chr14	75978784	76016335	37551	basic leucine zipper transcription factor, ATF-like
PA143485315	116071	BATF2	chr11	64752417	64775060	22643	basic leucine zipper transcription factor, ATF-like 2
PA162377349	55509	BATF3	chr1	212856759	212883327	26568	basic leucine zipper transcription factor, ATF-like 3
PA25269	581	BAX	chr19	49448117	49468055	19938	BCL2-associated X protein
PA25270	11177	BAZ1A	chr14	35218937	35354853	135916	bromodomain adjacent to zinc finger domain, 1A
PA25271	9031	BAZ1B	chr7	72851728	72946628	94900	bromodomain adjacent to zinc finger domain, 1B
PA25272	11176	BAZ2A	chr12	56986380	57040600	54220	bromodomain adjacent to zinc finger domain, 2A
PA25273	29994	BAZ2B	chr2	160172490	160483059	310569	bromodomain adjacent to zinc finger domain, 2B
PA38471	27113	BBC3	chr19	47721079	47746023	24944	BCL2 binding component 3
PA25274	8424	BBOX1	chr11	27052252	27152354	100102	butyrobetaine (gamma), 2-oxoglutarate dioxygenase (gamma-butyrobetaine hydroxylase) 1
PA25275	582	BBS1	chr11	66268077	66304084	36007	Bardet-Biedl syndrome 1
PA143485387	79738	BBS10	chr12	76735266	76752222	16956	Bardet-Biedl syndrome 10
PA162377350	166379	BBS12	chr4	123643857	123669098	25241	Bardet-Biedl syndrome 12
PA25276	583	BBS2	chr16	56501301	56564008	62707	Bardet-Biedl syndrome 2
PA25278	585	BBS4	chr15	72968520	73033817	65297	Bardet-Biedl syndrome 4
PA25279	129880	BBS5	chr2	170325967	170366165	40198	Bardet-Biedl syndrome 5
PA134923753	55212	BBS7	chr4	122742484	122801652	59168	Bardet-Biedl syndrome 7
PA162377359	27241	BBS9	chr7	33159144	33648680	489536	Bardet-Biedl syndrome 9
PA25280	56987	BBX	chr3	107231783	107533176	301393	bobby sox homolog (Drosophila)
PA30484	4059	BCAM	chr19	45302316	45327678	25362	basal cell adhesion molecule (Lutheran blood group)
PA134868393	63827	BCAN	chr1	156601740	156632324	30584	brevican
PA134939094	55973	BCAP29	chr7	107210422	107266762	56340	B-cell receptor-associated protein 29
PA128394569	10134	BCAP31	chrX	152962947	153000201	37254	B-cell receptor-associated protein 31
PA25281	9564	BCAR1	chr16	75259928	75311951	52023	breast cancer anti-estrogen resistance 1
PA25283	8412	BCAR3	chr1	94024343	94322706	298363	breast cancer anti-estrogen resistance 3
PA25284	8537	BCAS1	chr20	52557079	52697304	140225	breast carcinoma amplified sequence 1
PA25285	10286	BCAS2	chr1	115107178	115134265	27087	breast carcinoma amplified sequence 2
PA25286	54828	BCAS3	chr17	58745172	59473199	728027	breast carcinoma amplified sequence 3
PA25287	55653	BCAS4	chr20	49401467	49496714	95247	breast carcinoma amplified sequence 4
PA25288	586	BCAT1	chr12	24959958	25112393	152435	branched chain amino-acid transaminase 1, cytosolic
PA25289	587	BCAT2	chr19	49295319	49324320	29001	branched chain amino-acid transaminase 2, mitochondrial
PA25290	56647	BCCIP	chr10	127502102	127545264	43162	BRCA2 and CDKN1A interacting protein
PA162377410	144233	BCDIN3D	chr12	50226826	50246912	20086	BCDIN3 domain containing
PA25294	590	BCHE	chr3	165487692	165565260	77568	butyrylcholinesterase
PA25297	593	BCKDHA	chr19	41893694	41933910	40216	branched chain keto acid dehydrogenase E1, alpha polypeptide
PA25298	594	BCKDHB	chr6	80806344	81058987	252643	branched chain keto acid dehydrogenase E1, beta polypeptide
PA134899581	10295	BCKDK	chr16	31109615	31127112	17497	branched chain ketoacid dehydrogenase kinase
PA25299	8915	BCL10	chr1	85728459	85752604	24145	B-cell CLL/lymphoma 10
PA25300	53335	BCL11A	chr2	60675302	60790633	115331	B-cell CLL/lymphoma 11A (zinc finger protein)
PA25301	64919	BCL11B	chr14	99632624	99748514	115890	B-cell CLL/lymphoma 11B (zinc finger protein)
PA25302	596	BCL2	chr18	60787579	60997011	209432	B-cell CLL/lymphoma 2
PA25303	597	BCL2A1	chr15	80250232	80273643	23411	BCL2-related protein A1
PA76	598	BCL2L1	chr20	30249261	30321752	72491	BCL2-like 1
PA25304	10017	BCL2L10	chr15	52398490	52414972	16482	BCL2-like 10 (apoptosis facilitator)
PA25305	10018	BCL2L11	chr2	111868491	111929022	60531	BCL2-like 11 (apoptosis facilitator)
PA25306	83596	BCL2L12	chr19	50158399	50180173	21774	BCL2-like 12 (proline rich)
PA134912159	23786	BCL2L13	chr22	18101621	18216621	115000	BCL2-like 13 (apoptosis facilitator)
PA134870762	79370	BCL2L14	chr12	12213873	12255629	41756	BCL2-like 14 (apoptosis facilitator)
PA162377411	440603	BCL2L15	chr1	114416436	114440230	23794	BCL2-like 15
PA25307	599	BCL2L2	chr14	23765971	23793241	27270	BCL2-like 2
PA25310	602	BCL3	chr19	45236070	45266301	30231	B-cell CLL/lymphoma 3
PA25312	604	BCL6	chr3	187436165	187473513	37348	B-cell CLL/lymphoma 6
PA25313	255877	BCL6B	chr17	6916368	6936609	20241	B-cell CLL/lymphoma 6, member B
PA25314	605	BCL7A	chr12	122449861	122502950	53089	B-cell CLL/lymphoma 7A
PA25315	9275	BCL7B	chr7	72947683	72982065	34382	B-cell CLL/lymphoma 7B
PA25316	9274	BCL7C	chr16	30842373	30915852	73479	B-cell CLL/lymphoma 7C
PA25318	607	BCL9	chr1	147003222	147101022	97800	B-cell CLL/lymphoma 9
PA134974002	283149	BCL9L	chr11	118763849	118806327	42478	B-cell CLL/lymphoma 9-like
PA134868035	9774	BCLAF1	chr6	136575001	136621783	46782	BCL2-associated transcription factor 1
PA37812	53630	BCO1	chr16	81262296	81327747	65451	beta-carotene oxygenase 1
PA162377424	83875	BCO2	chr11	112036208	112092652	56444	beta-carotene oxygenase 2
PA134921737	54880	BCOR	chrX	39907499	40046643	139144	BCL6 corepressor
PA134863970	63035	BCORL1	chrX	129104277	129195058	90781	BCL6 corepressor-like 1
PA25321	613	BCR	chr22	23512402	23663224	150822	breakpoint cluster region
PA25327	617	BCS1L	chr2	219514379	219531166	16787	BC1 (ubiquinol-cytochrome c reductase) synthesis-like
PA25331	622	BDH1	chr3	197233654	197310194	76540	3-hydroxybutyrate dehydrogenase, type 1
PA142672559	56898	BDH2	chr4	103995770	104031024	35254	3-hydroxybutyrate dehydrogenase, type 2
PA79	623	BDKRB1	chr14	96711641	96738304	26663	bradykinin receptor B1
PA80	624	BDKRB2	chr14	96661016	96713666	52650	bradykinin receptor B2
PA31891	627	BDNF	chr11	27673440	27753605	80165	brain-derived neurotrophic factor
PA25336	55814	BDP1	chr5	70741442	70866649	125207	B double prime 1, subunit of RNA polymerase III transcription initiation factor IIIB
PA25337	8678	BECN1	chr17	40959150	40986310	27160	beclin 1, autophagy related
PA162377453	57596	BEGAIN	chr14	101000484	101046131	45647	brain-enriched guanylate kinase-associated
PA164716507	139105	BEND2	chrX	18178051	18249024	70973	BEN domain containing 2
PA164716540	57673	BEND3	chr6	107383385	107446371	62986	BEN domain containing 3
PA164716541	389206	BEND4	chr4	42109870	42164895	55025	BEN domain containing 4
PA164716542	79656	BEND5	chr1	49190538	49252547	62009	BEN domain containing 5
PA164716559	221336	BEND6	chr6	56809773	56895450	85677	BEN domain containing 6
PA164716578	222389	BEND7	chr10	13477484	13580587	103103	BEN domain containing 7
PA162377454	7439	BEST1	chr11	61707356	61734935	27579	bestrophin 1
PA162377481	54831	BEST2	chr19	12852600	12872272	19672	bestrophin 2
PA162377503	144453	BEST3	chr12	70034334	70103196	68862	bestrophin 3
PA162377520	266675	BEST4	chr1	45244831	45263648	18817	bestrophin 4
PA25338	10282	BET1	chr7	93589082	93643693	54611	Bet1 golgi vesicular membrane trafficking protein
PA134970036	51272	BET1L	chr11	199924	217422	17498	Bet1 golgi vesicular membrane trafficking protein-like
PA25340	55859	BEX1	chrX	102314581	102329168	14587	brain expressed, X-linked 1
PA134977614	84707	BEX2	chrX	102561274	102575974	14700	brain expressed X-linked 2
PA162377543	56271	BEX4	chrX	102459996	102475128	15132	brain expressed, X-linked 4
PA162377554	340542	BEX5	chrX	101405679	101420986	15307	brain expressed, X-linked 5
PA38460	51283	BFAR	chr16	14716668	14766093	49425	bifunctional apoptosis regulator
PA25343	631	BFSP1	chr20	17471550	17559865	88315	beaded filament structural protein 1, filensin
PA25344	8419	BFSP2	chr3	133108790	133197056	88266	beaded filament structural protein 2, phakinin
PA25345	632	BGLAP	chr1	156201951	156216123	14172	bone gamma-carboxyglutamate (gla) protein
PA25346	633	BGN	chrX	152750347	152778004	27657	biglycan
PA164716601	168620	BHLHA15	chr7	97830759	97847769	17010	basic helix-loop-helix family, member a15
PA164716602	727857	BHLHA9	chr17	1163858	1177565	13707	basic helix-loop-helix family, member a9
PA134895992	80823	BHLHB9	chrX	101965642	102011468	45826	basic helix-loop-helix domain containing, class B, 9
PA36650	27319	BHLHE22	chr8	65482795	65499191	16396	basic helix-loop-helix family, member e22
PA164716615	128408	BHLHE23	chr20	61634331	61648387	14056	basic helix-loop-helix family, member e23
PA25347	8553	BHLHE40	chr3	5011097	5029866	18769	basic helix-loop-helix family, member e40
PA164716636	79365	BHLHE41	chr12	26269959	26288003	18044	basic helix-loop-helix family, member e41
PA25350	635	BHMT	chr5	78397604	78431113	33509	betaine--homocysteine S-methyltransferase
PA25351	23743	BHMT2	chr5	78355547	78388897	33350	betaine--homocysteine S-methyltransferase 2
PA134878124	80114	BICC1	chr10	60262774	60594194	331420	BicC family RNA binding protein 1
PA25352	636	BICD1	chr12	32249713	32539567	289854	bicaudal D homolog 1 (Drosophila)
PA134969018	23299	BICD2	chr9	95470645	95537083	66438	bicaudal D homolog 2 (Drosophila)
PA25353	637	BID	chr22	18213906	18267431	53525	BH3 interacting domain death agonist
PA25354	638	BIK	chr22	43496754	43528718	31964	BCL2-interacting killer (apoptosis-inducing)
PA25355	274	BIN1	chr2	127802599	127874903	72304	bridging integrator 1
PA25356	51411	BIN2	chr12	51671822	51728446	56624	bridging integrator 2
PA25357	55909	BIN3	chr8	22474931	22536661	61730	bridging integrator 3
PA25359	329	BIRC2	chr11	102207913	102252401	44488	baculoviral IAP repeat containing 2
PA25360	330	BIRC3	chr11	102178181	102213134	34953	baculoviral IAP repeat containing 3
PA25362	332	BIRC5	chr17	76200277	76224716	24439	baculoviral IAP repeat containing 5
PA25363	57448	BIRC6	chr2	32571735	32846966	275231	baculoviral IAP repeat containing 6
PA25364	79444	BIRC7	chr20	61857235	61874859	17624	baculoviral IAP repeat containing 7
PA25365	112401	BIRC8	chr19	53789854	53804875	15021	baculoviral IAP repeat containing 8
PA25366	54841	BIVM	chr13	103441399	103496888	55489	basic, immunoglobulin-like variable motif containing
PA25367	10904	BLCAP	chr20	36142819	36166333	23514	bladder cancer associated protein
PA162377555	414899	BLID	chr11	121983062	121996923	13861	BH3-like motif containing, cell death inducer
PA25368	640	BLK	chr8	11341521	11425108	83587	BLK proto-oncogene, Src family tyrosine kinase
PA25369	641	BLM	chr15	91250579	91361686	111107	Bloom syndrome, RecQ helicase-like
PA25370	642	BLMH	chr17	28572213	28629184	56971	bleomycin hydrolase
PA25371	29760	BLNK	chr10	97948455	98041333	92878	B-cell linker
PA28617	2647	BLOC1S1	chr12	56099818	56116491	16673	biogenesis of lysosomal organelles complex-1, subunit 1
PA134936108	282991	BLOC1S2	chr10	102030035	102056469	26434	biogenesis of lysosomal organelles complex-1, subunit 2
PA134884924	388552	BLOC1S3	chr19	45672003	45688058	16055	biogenesis of lysosomal organelles complex-1, subunit 3
PA142672088	55330	BLOC1S4	chr4	6707842	6722387	14545	biogenesis of lysosomal organelles complex-1, subunit 4, cappuccino
PA134921692	63915	BLOC1S5	chr6	8010800	8074647	63847	biogenesis of lysosomal organelles complex-1, subunit 5, muted
PA33398	26258	BLOC1S6	chr15	45869417	45904909	35492	biogenesis of lysosomal organelles complex-1, subunit 6, pallidin
PA25373	644	BLVRA	chr7	43788272	43849941	61669	biliverdin reductase A
PA25374	645	BLVRB	chr19	40950691	40981725	31034	biliverdin reductase B
PA25375	8548	BLZF1	chr1	169327122	169368782	41660	basic leucine zipper nuclear factor 1
PA134893658	90427	BMF	chr15	40377091	40411088	33997	Bcl2 modifying factor
PA25376	648	BMI1	chr10	22600139	22623414	23275	BMI1 proto-oncogene, polycomb ring finger
PA25377	649	BMP1	chr8	22012653	22072839	60186	bone morphogenetic protein 1
PA134953092	27302	BMP10	chr2	69089613	69108649	19036	bone morphogenetic protein 10
PA25378	9210	BMP15	chrX	50643735	50662641	18906	bone morphogenetic protein 15
PA25379	650	BMP2	chr20	6738745	6763910	25165	bone morphogenetic protein 2
PA134992822	55589	BMP2K	chr4	79687532	79840519	152987	BMP2 inducible kinase
PA25380	651	BMP3	chr4	81942119	81981685	39566	bone morphogenetic protein 3
PA25381	652	BMP4	chr14	54413454	54433554	20100	bone morphogenetic protein 4
PA25382	653	BMP5	chr6	55615451	55750388	134937	bone morphogenetic protein 5
PA25383	654	BMP6	chr6	7717011	7884972	167961	bone morphogenetic protein 6
PA25384	655	BMP7	chr20	55740809	55851707	110898	bone morphogenetic protein 7
PA134894231	353500	BMP8A	chr1	39947318	39998541	51223	bone morphogenetic protein 8a
PA25385	656	BMP8B	chr1	40220903	40264533	43630	bone morphogenetic protein 8b
PA142672557	168667	BMPER	chr7	33934523	34198484	263961	BMP binding endothelial regulator
PA25386	657	BMPR1A	chr10	88506396	88687945	181549	bone morphogenetic protein receptor, type IA
PA25387	658	BMPR1B	chr4	95669128	96082601	413473	bone morphogenetic protein receptor, type IB
PA25388	659	BMPR2	chr2	203231033	203435474	204441	bone morphogenetic protein receptor, type II (serine/threonine kinase)
PA162377556	9790	BMS1	chr10	43267954	43333385	65431	BMS1 ribosome biogenesis factor
PA25389	660	BMX	chrX	15472356	15577652	105296	BMX non-receptor tyrosine kinase
PA25391	646	BNC1	chr15	83921655	83963468	41813	basonuclin 1
PA134953132	54796	BNC2	chr9	16406501	16880786	474285	basonuclin 2
PA25392	662	BNIP1	chr5	172561445	172594390	32945	BCL2/adenovirus E1B 19kDa interacting protein 1
PA25393	663	BNIP2	chr15	59948345	59991728	43383	BCL2/adenovirus E1B 19kDa interacting protein 2
PA25394	664	BNIP3	chr10	133778204	133805435	27231	BCL2/adenovirus E1B 19kDa interacting protein 3
PA25395	665	BNIP3L	chr8	26229894	26273644	43750	BCL2/adenovirus E1B 19kDa interacting protein 3-like
PA38196	149428	BNIPL	chr1	150999029	151023076	24047	BCL2/adenovirus E1B 19kD interacting protein like
PA143485316	91653	BOC	chr3	112919850	113009306	89456	BOC cell adhesion associated, oncogene regulated
PA164716651	91272	BOD1	chr5	173031148	173053706	22558	biorientation of chromosomes in cell division 1
PA164716652	259282	BOD1L1	chr4	13567362	13639334	71972	biorientation of chromosomes in cell division 1-like 1
PA25396	666	BOK	chr2	242488146	242516553	28407	BCL2-related ovarian killer
PA142672552	51027	BOLA1	chr1	149861110	149875348	14238	bolA family member 1
PA142672553	552900	BOLA2	chr16	29449601	29476285	26684	bolA family member 2
PA143485317	654483	BOLA2B	chr16	30201256	30215627	14371	bolA family member 2B
PA142672554	388962	BOLA3	chr2	74359528	74385039	25511	bolA family member 3
PA25397	66037	BOLL	chr2	198588603	198661036	72433	boule-like RNA-binding protein
PA25398	23246	BOP1	chr8	145483056	145525120	42064	block of proliferation 1
PA162378045	79866	BORA	chr13	73291981	73333328	41347	bora, aurora kinase A activator
PA25401	669	BPGM	chr7	134321531	134367568	46037	2,3-bisphosphoglycerate mutase
PA25402	670	BPHL	chr6	3108926	3156833	47907	biphenyl hydrolase-like (serine hydrolase)
PA25403	671	BPI	chr20	36922552	36968907	46355	bactericidal/permeability-increasing protein
PA33423	51297	BPIFA1	chr20	31813802	31834115	20313	BPI fold containing family A, member 1
PA25781	140683	BPIFA2	chr20	31739660	31772223	32563	BPI fold containing family A, member 2
PA25782	128861	BPIFA3	chr20	31795130	31818612	23482	BPI fold containing family A, member 3
PA25654	92747	BPIFB1	chr20	31860941	31900684	39743	BPI fold containing family B, member 1
PA25404	80341	BPIFB2	chr20	31585384	31614515	29131	BPI fold containing family B, member 2
PA25727	359710	BPIFB3	chr20	31633230	31664434	31204	BPI fold containing family B, member 3
PA25728	149954	BPIFB4	chr20	31659318	31702557	43239	BPI fold containing family B, member 4
PA25406	128859	BPIFB6	chr20	31609454	31634853	25399	BPI fold containing family B, member 6
PA25405	254240	BPIFC	chr22	32806834	32870429	63595	BPI fold containing family C
PA25407	10380	BPNT1	chr1	220227824	220273249	45425	3'(2'), 5'-bisphosphate nucleotidase 1
PA162377557	2186	BPTF	chr17	65811644	65983494	171850	bromodomain PHD finger transcription factor
PA37794	9083	BPY2	chrY	25120410	25154612	34202	basic charge, Y-linked, 2
PA134906625	442867	BPY2B	chrY	26754151	26788354	34203	basic charge, Y-linked, 2B
PA134873304	442868	BPY2C	chrY	27174048	27208251	34203	basic charge, Y-linked, 2C
PA25408	673	BRAF	chr7	140412749	140634564	221815	B-Raf proto-oncogene, serine/threonine kinase
PA25410	8315	BRAP	chr12	112076950	112133790	56840	BRCA1 associated protein
PA134959439	221927	BRAT1	chr7	2574444	2605392	30948	BRCA1-associated ATM activator 1
PA25411	672	BRCA1	chr17	41193312	41287500	94188	breast cancer 1, early onset
PA25412	675	BRCA2	chr13	32879617	32976809	97192	breast cancer 2, early onset
PA134922847	79184	BRCC3	chrX	154289695	154354349	64654	BRCA1/BRCA2-containing complex, subunit 3
PA25413	23774	BRD1	chr22	50163931	50231196	67265	bromodomain containing 1
PA25414	6046	BRD2	chr6	32926437	32952282	25845	bromodomain containing 2
PA25415	8019	BRD3	chr9	136892427	136943655	51228	bromodomain containing 3
PA25416	23476	BRD4	chr19	15345301	15453354	108053	bromodomain containing 4
PA25417	29117	BRD7	chr16	50349929	50412845	62916	bromodomain containing 7
PA134923194	10902	BRD8	chr5	137472455	137524358	51903	bromodomain containing 8
PA134866578	65980	BRD9	chr5	860850	902939	42089	bromodomain containing 9
PA25418	676	BRDT	chr1	92404928	92482985	78057	bromodomain, testis-specific
PA25419	9577	BRE	chr2	28103482	28564768	461286	brain and reproductive organ-expressed (TNFRSF1A modulator)
PA164741296	2972	BRF1	chr14	105672623	105791914	119291	BRF1, RNA polymerase III transcription initiation factor 90 kDa subunit
PA164741329	55290	BRF2	chr8	37698398	37717431	19033	BRF2, RNA polymerase III transcription initiation factor 50 kDa subunit
PA25422	25798	BRI3	chr7	97900972	97955972	55000	brain protein I3
PA25423	140707	BRI3BP	chr12	125468194	125513349	45155	BRI3 binding protein
PA162378367	283870	BRICD5	chr16	2256254	2273541	17287	BRICHOS domain containing 5
PA27156	1620	BRINP1	chr9	121925907	122141739	215832	bone morphogenetic protein/retinoic acid inducible neural-specific 1
PA142671895	57795	BRINP2	chr1	177130058	177254558	124500	bone morphogenetic protein/retinoic acid inducible neural-specific 2
PA142671896	339479	BRINP3	chr1	190063797	190456759	392962	bone morphogenetic protein/retinoic acid inducible neural-specific 3
PA134906421	83990	BRIP1	chr17	59753547	59950920	197373	BRCA1 interacting protein C-terminal helicase 1
PA165660166	55299	BRIX1	chr5	34905820	34928787	22967	BRX1, biogenesis of ribosomes, homolog (S. cerevisiae)
PA164741342	25855	BRMS1	chr11	66101804	66122596	20792	breast cancer metastasis suppressor 1
PA134968356	84312	BRMS1L	chr14	36285524	36344169	58645	breast cancer metastasis-suppressor 1-like
PA142672509	148362	BROX	chr1	222875906	222911529	35623	BRO1 domain and CAAX motif containing
PA25424	7862	BRPF1	chr3	9763413	9792699	29286	bromodomain and PHD finger containing, 1
PA25425	27154	BRPF3	chr6	36154408	36203567	49159	bromodomain and PHD finger containing, 3
PA25427	680	BRS3	chrX	135554521	135578931	24410	bombesin-like receptor 3
PA134888976	84446	BRSK1	chr19	55783440	55826930	43490	BR serine/threonine kinase 1
PA36212	9024	BRSK2	chr11	1401129	1486919	85790	BR serine/threonine kinase 2
PA134906879	54014	BRWD1	chr21	40553102	40695745	142643	bromodomain and WD repeat domain containing 1
PA134900775	254065	BRWD3	chrX	79921987	80075233	153246	bromodomain and WD repeat domain containing 3
PA25432	26580	BSCL2	chr11	62454734	62487091	32357	Berardinelli-Seip congenital lipodystrophy 2 (seipin)
PA142672548	55108	BSDC1	chr1	32827704	32870062	42358	BSD domain containing 1
PA25433	682	BSG	chr19	561277	586493	25216	basigin (Ok blood group)
PA25434	8927	BSN	chr3	49581922	49711982	130060	bassoon presynaptic cytomatrix protein
PA134911659	7809	BSND	chr1	55454617	55477465	22848	barttin CLCNK-type chloride channel accessory beta subunit
PA164716709	100131137	BSPH1	chr19	48468303	48505427	37124	binder of sperm protein homolog 1
PA134979106	54836	BSPRY	chr9	116101812	116136513	34701	B-box and SPRY domain containing
PA25435	683	BST1	chr4	15694573	15744121	49548	bone marrow stromal cell antigen 1
PA25436	684	BST2	chr19	17499238	17526458	27220	bone marrow stromal cell antigen 2
PA162377618	390259	BSX	chr11	122845357	122862379	17022	brain-specific homeobox
PA25437	9044	BTAF1	chr10	93673526	93793755	120229	BTAF1 RNA polymerase II, B-TFIID transcription factor-associated, 170kDa
PA25438	53339	BTBD1	chr15	83682175	83746106	63931	BTB (POZ) domain containing 1
PA142672543	84280	BTBD10	chr11	13406555	13494838	88283	BTB (POZ) domain containing 10
PA134975180	121551	BTBD11	chr12	107702197	108056419	354222	BTB (POZ) domain containing 11
PA134900594	118663	BTBD16	chr10	124020811	124100676	79865	BTB (POZ) domain containing 16
PA162377627	388419	BTBD17	chr17	72349555	72367958	18403	BTB (POZ) domain containing 17
PA165543229	643376	BTBD18	chr11	57507986	57529253	21267	BTB (POZ) domain containing 18
PA165750488	149478	BTBD19	chr1	45263373	45282801	19428	BTB (POZ) domain containing 19
PA25439	55643	BTBD2	chr19	1982437	2025702	43265	BTB (POZ) domain containing 2
PA25440	22903	BTBD3	chr20	11861377	11910243	48866	BTB (POZ) domain containing 3
PA128394741	90135	BTBD6	chr14	105704879	105720430	15551	BTB (POZ) domain containing 6
PA134938971	55727	BTBD7	chr14	93700896	93809385	108489	BTB (POZ) domain containing 7
PA134916444	284697	BTBD8	chr1	92535862	92616397	80535	BTB (POZ) domain containing 8
PA134891920	114781	BTBD9	chr6	38133227	38618202	484975	BTB (POZ) domain containing 9
PA25442	685	BTC	chr4	75668448	75729882	61434	betacellulin
PA25443	686	BTD	chr3	15632864	15692147	59283	biotinidase
PA25445	689	BTF3	chr5	72784250	72804448	20198	basic transcription factor 3
PA142672545	91408	BTF3L4	chr1	52511857	52559388	47531	basic transcription factor 3-like 4
PA25450	694	BTG1	chr12	92531054	92549673	18619	B-cell translocation gene 1, anti-proliferative
PA25451	7832	BTG2	chr1	203264664	203281730	17066	BTG family, member 2
PA25452	10950	BTG3	chr21	18962968	18995268	32300	BTG family, member 3
PA25453	54766	BTG4	chr11	111335255	111393105	57850	B-cell translocation gene 4
PA25454	695	BTK	chrX	100601435	100651212	49777	Bruton agammaglobulinemia tyrosine kinase
PA134968341	151888	BTLA	chr3	112179813	112228438	48625	B and T lymphocyte associated
PA25455	696	BTN1A1	chr6	26490577	26513653	23076	butyrophilin, subfamily 1, member A1
PA25456	11120	BTN2A1	chr6	26448132	26479849	31717	butyrophilin, subfamily 2, member A1
PA25457	10385	BTN2A2	chr6	26373111	26398102	24991	butyrophilin, subfamily 2, member A2
PA25459	11119	BTN3A1	chr6	26392465	26418444	25979	butyrophilin, subfamily 3, member A1
PA25460	11118	BTN3A2	chr6	26355387	26381548	26161	butyrophilin, subfamily 3, member A2
PA25461	10384	BTN3A3	chr6	26430700	26456643	25943	butyrophilin, subfamily 3, member A3
PA25463	56244	BTNL2	chr6	32359513	32384900	25387	butyrophilin-like 2 (MHC class II associated)
PA25464	10917	BTNL3	chr5	180405845	180436727	30882	butyrophilin-like 3
PA134918466	79908	BTNL8	chr5	180316077	180380906	64829	butyrophilin-like 8
PA134945306	153579	BTNL9	chr5	180457203	180491523	34320	butyrophilin-like 9
PA25465	8945	BTRC	chr10	103103790	103320078	216288	beta-transducin repeat containing E3 ubiquitin protein ligase
PA81	699	BUB1	chr2	111392275	111445684	53409	BUB1 mitotic checkpoint serine/threonine kinase
PA82	701	BUB1B	chr15	40443210	40516337	73127	BUB1 mitotic checkpoint serine/threonine kinase B
PA25467	9184	BUB3	chr10	124903760	124927886	24126	BUB3 mitotic checkpoint protein
PA144596512	84811	BUD13	chr11	116615886	116653714	37828	BUD13 homolog (S. cerevisiae)
PA144596513	8896	BUD31	chr7	98996243	99020239	23996	BUD31 homolog (S. cerevisiae)
PA25469	11149	BVES	chr6	105541697	105595049	53352	blood vessel epicardial substance
PA25472	705	BYSL	chr6	41878965	41903784	24819	bystin-like
PA128394545	9256	BZRAP1	chr17	56375588	56416152	40564	benzodiazepine receptor (peripheral) associated protein 1
PA38535	9689	BZW1	chr2	201666262	201691569	25307	basic leucine zipper and W2 domains 1
PA38690	28969	BZW2	chr7	16675759	16749148	73389	basic leucine zipper and W2 domains 2
PA128394583	11067	C10orf10	chr10	45468709	45484330	15621	chromosome 10 open reading frame 10
PA134923659	414152	C10orf105	chr10	73468458	73507581	39123	chromosome 10 open reading frame 105
PA134897916	219621	C10orf107	chr10	63412709	63529524	116815	chromosome 10 open reading frame 107
PA134899373	83938	C10orf11	chr10	77181217	78320133	1138916	chromosome 10 open reading frame 11
PA134990460	221060	C10orf111	chr10	15134384	15149318	14934	chromosome 10 open reading frame 111
PA134950749	387638	C10orf113	chr10	21411692	21445488	33796	chromosome 10 open reading frame 113
PA134866687	26148	C10orf12	chr10	98731041	98748585	17544	chromosome 10 open reading frame 12
PA134871711	399814	C10orf120	chr10	124454225	124469338	15113	chromosome 10 open reading frame 120
PA134962893	170371	C10orf128	chr10	50360890	50406640	45750	chromosome 10 open reading frame 128
PA134931868	100127889	C10orf131	chr10	97657722	97701415	43693	chromosome 10 open reading frame 131
PA162377675	56652	C10orf2	chr10	102737293	102757159	19866	chromosome 10 open reading frame 2
PA134916491	220979	C10orf25	chr10	45490146	45506470	16324	chromosome 10 open reading frame 25
PA134928831	119032	C10orf32	chr10	104603967	104627718	23751	chromosome 10 open reading frame 32
PA134863788	219738	C10orf35	chr10	71380003	71396355	16352	chromosome 10 open reading frame 35
PA134895627	282966	C10orf53	chr10	50877684	50919956	42272	chromosome 10 open reading frame 53
PA142672307	64115	C10orf54	chr10	73504313	73543337	39024	chromosome 10 open reading frame 54
PA134866694	414236	C10orf55	chr10	75666727	75692535	25808	chromosome 10 open reading frame 55
PA134924151	414157	C10orf62	chr10	99339450	99353691	14241	chromosome 10 open reading frame 62
PA134915530	256815	C10orf67	chr10	23602520	23643772	41252	chromosome 10 open reading frame 67
PA134955273	79741	C10orf68	chr10	32725057	33174805	449748	chromosome 10 open reading frame 68
PA134920715	118461	C10orf71	chr10	50495118	50538537	43419	chromosome 10 open reading frame 71
PA134903060	79591	C10orf76	chr10	103602356	103825932	223576	chromosome 10 open reading frame 76
PA134919914	143379	C10orf82	chr10	118420207	118439765	19558	chromosome 10 open reading frame 82
PA134993933	80007	C10orf88	chr10	124687419	124723919	36500	chromosome 10 open reading frame 88
PA134895930	118611	C10orf90	chr10	128110566	128223444	112878	chromosome 10 open reading frame 90
PA134926670	170393	C10orf91	chr10	134248714	134264825	16111	chromosome 10 open reading frame 91
PA134917788	255352	C10orf93	chr10	134739690	134766065	26375	chromosome 10 open reading frame 93
PA134908188	79946	C10orf95	chr10	104206594	104221300	14706	chromosome 10 open reading frame 95
PA134990747	387695	C10orf99	chr10	85923511	85948050	24539	chromosome 10 open reading frame 99
PA25477	64776	C11orf1	chr11	111739948	111757798	17850	chromosome 11 open reading frame 1
PA25483	56673	C11orf16	chr11	8938623	8964553	25930	chromosome 11 open reading frame 16
PA25486	29125	C11orf21	chr11	2314507	2333143	18636	chromosome 11 open reading frame 21
PA25488	53838	C11orf24	chr11	68025803	68049469	23666	chromosome 11 open reading frame 24
PA134904392	56946	C11orf30	chr11	76145967	76266943	120976	chromosome 11 open reading frame 30
PA25495	280636	C11orf31	chr11	57498722	57513883	15161	chromosome 11 open reading frame 31
PA142672300	143501	C11orf40	chr11	4589653	4609050	19397	chromosome 11 open reading frame 40
PA142672287	160298	C11orf42	chr11	6216798	6235365	18567	chromosome 11 open reading frame 42
PA142672290	219833	C11orf45	chr11	128766460	128786126	19666	chromosome 11 open reading frame 45
PA143485345	79096	C11orf49	chr11	46948240	47188932	240692	chromosome 11 open reading frame 49
PA143485347	91894	C11orf52	chr11	111779601	111800595	20994	chromosome 11 open reading frame 52
PA143485348	341032	C11orf53	chr11	111116707	111159973	43266	chromosome 11 open reading frame 53
PA143485349	28970	C11orf54	chr11	93464769	93499250	34481	chromosome 11 open reading frame 54
PA143485352	55216	C11orf57	chr11	111934968	111958874	23906	chromosome 11 open reading frame 57
PA143485353	10944	C11orf58	chr11	16750148	16782901	32753	chromosome 11 open reading frame 58
PA143485358	79864	C11orf63	chr11	122743236	122833430	90194	chromosome 11 open reading frame 63
PA144596484	160140	C11orf65	chr11	108176012	108348258	172246	chromosome 11 open reading frame 65
PA144596487	83638	C11orf68	chr11	65681281	65696531	15250	chromosome 11 open reading frame 68
PA144596489	85016	C11orf70	chr11	101908147	101958291	50144	chromosome 11 open reading frame 70
PA144596490	54494	C11orf71	chr11	114259170	114281272	22102	chromosome 11 open reading frame 71
PA144596492	51501	C11orf73	chr11	86003253	86059985	56732	chromosome 11 open reading frame 73
PA144596493	119710	C11orf74	chr11	36606043	36683841	77798	chromosome 11 open reading frame 74
PA162377704	79703	C11orf80	chr11	66502207	66616997	114790	chromosome 11 open reading frame 80
PA162377769	144097	C11orf84	chr11	63570846	63598190	27344	chromosome 11 open reading frame 84
PA162377786	283129	C11orf85	chr11	64702702	64749565	46863	chromosome 11 open reading frame 85
PA162377813	254439	C11orf86	chr11	66732754	66747479	14725	chromosome 11 open reading frame 86
PA162377822	399947	C11orf87	chr11	109282570	109302893	20323	chromosome 11 open reading frame 87
PA162377831	399949	C11orf88	chr11	111375510	111410756	35246	chromosome 11 open reading frame 88
PA164716759	100131378	C11orf91	chr11	33716654	33732286	15632	chromosome 11 open reading frame 91
PA164716768	399948	C11orf92	chr11	111161114	111187104	25990	chromosome 11 open reading frame 92
PA165543255	143678	C11orf94	chr11	45925085	45938833	13748	chromosome 11 open reading frame 94
PA165543266	65998	C11orf95	chr11	63524364	63546113	21749	chromosome 11 open reading frame 95
PA165543281	387763	C11orf96	chr11	43954106	43968433	14327	chromosome 11 open reading frame 96
PA25501	60314	C12orf10	chr12	53683132	53703965	20833	chromosome 12 open reading frame 10
PA143485359	91298	C12orf29	chr12	88419268	88446937	27669	chromosome 12 open reading frame 29
PA143485366	283422	C12orf36	chr12	13520605	13550101	29496	chromosome 12 open reading frame 36
PA25505	57102	C12orf4	chr12	4593899	4657674	63775	chromosome 12 open reading frame 4
PA143485370	283461	C12orf40	chr12	40009972	40118716	108744	chromosome 12 open reading frame 40
PA143485372	374470	C12orf42	chr12	103628369	103899788	271419	chromosome 12 open reading frame 42
PA143485373	64897	C12orf43	chr12	121437835	121464300	26465	chromosome 12 open reading frame 43
PA143485375	121053	C12orf45	chr12	105370098	105391505	21407	chromosome 12 open reading frame 45
PA128394721	79794	C12orf49	chr12	117148289	117185868	37579	chromosome 12 open reading frame 49
PA25506	57103	C12orf5	chr12	4420359	4472194	51835	chromosome 12 open reading frame 5
PA143485379	160419	C12orf50	chr12	88370816	88433176	62360	chromosome 12 open reading frame 50
PA143485383	121273	C12orf54	chr12	48866283	48893297	27014	chromosome 12 open reading frame 54
PA143485385	115749	C12orf56	chr12	64657763	64794345	136582	chromosome 12 open reading frame 56
PA143485386	113246	C12orf57	chr12	7042146	7058165	16019	chromosome 12 open reading frame 57
PA143485389	144608	C12orf60	chr12	14945997	14979792	33795	chromosome 12 open reading frame 60
PA143485390	283416	C12orf61	chr12	62992531	63007214	14683	chromosome 12 open reading frame 61
PA144596481	374467	C12orf63	chr12	97104173	97219602	115429	chromosome 12 open reading frame 63
PA162377963	91574	C12orf65	chr12	123707844	123745651	37807	chromosome 12 open reading frame 65
PA162377974	144577	C12orf66	chr12	64577098	64626076	48978	chromosome 12 open reading frame 66
PA162378036	728858	C12orf71	chr12	27230990	27245455	14465	chromosome 12 open reading frame 71
PA164716790	728568	C12orf73	chr12	104340980	104360993	20013	chromosome 12 open reading frame 73
PA164716804	338809	C12orf74	chr12	93086619	93105325	18706	chromosome 12 open reading frame 74
PA164716815	387882	C12orf75	chr12	105714414	105768296	53882	chromosome 12 open reading frame 75
PA165512406	400073	C12orf76	chr12	110462401	110515500	53099	chromosome 12 open reading frame 76
PA165512421	196415	C12orf77	chr12	25143358	25160373	17015	chromosome 12 open reading frame 77
PA25513	11161	C14orf1	chr14	76114233	76137538	23305	chromosome 14 open reading frame 1
PA134868494	55195	C14orf105	chr14	57933595	57970581	36986	chromosome 14 open reading frame 105
PA134974692	55017	C14orf119	chr14	23554683	23572665	17982	chromosome 14 open reading frame 119
PA134918457	84520	C14orf142	chr14	93666237	93683459	17222	chromosome 14 open reading frame 142
PA134952868	80017	C14orf159	chr14	91516677	91694976	178299	chromosome 14 open reading frame 159
PA134953268	51637	C14orf166	chr14	52446228	52474420	28192	chromosome 14 open reading frame 166
PA145149653	283598	C14orf177	chr14	99167950	99187103	19153	chromosome 14 open reading frame 177
PA145149665	283579	C14orf178	chr14	78217173	78239085	21912	chromosome 14 open reading frame 178
PA162378139	400258	C14orf180	chr14	105036056	105059184	23128	chromosome 14 open reading frame 180
PA162378154	400223	C14orf181	chr14	69258465	69273191	14726	chromosome 14 open reading frame 181
PA164716833	283551	C14orf182	chr14	50445430	50484238	38808	chromosome 14 open reading frame 182
PA165478562	196913	C14orf183	chr14	50547369	50569361	21992	chromosome 14 open reading frame 183
PA165478575	650662	C14orf184	chr14	92035789	92051384	15595	chromosome 14 open reading frame 184
PA25514	9556	C14orf2	chr14	104375625	104397903	22278	chromosome 14 open reading frame 2
PA134923136	122525	C14orf28	chr14	45356433	45379460	23027	chromosome 14 open reading frame 28
PA134941886	145407	C14orf37	chr14	58467808	58628847	161039	chromosome 14 open reading frame 37
PA134950036	317761	C14orf39	chr14	60899674	60962764	63090	chromosome 14 open reading frame 39
PA134876308	122616	C14orf79	chr14	105442125	105469056	26931	chromosome 14 open reading frame 79
PA134885988	283643	C14orf80	chr14	105946192	105968585	22393	chromosome 14 open reading frame 80
PA134982493	60686	C14orf93	chr14	23453110	23489375	36265	chromosome 14 open reading frame 93
PA134908662	161502	C15orf26	chr15	81381749	81444516	62767	chromosome 15 open reading frame 26
PA134968419	123591	C15orf27	chr15	76342299	76500304	158005	chromosome 15 open reading frame 27
PA142672268	145858	C15orf32	chr15	93004907	93047347	42440	chromosome 15 open reading frame 32
PA142672275	56905	C15orf39	chr15	75481219	75507510	26291	chromosome 15 open reading frame 39
PA142672276	123207	C15orf40	chr15	83654715	83691050	36335	chromosome 15 open reading frame 40
PA142672277	84529	C15orf41	chr15	36861812	37105449	243637	chromosome 15 open reading frame 41
PA143485393	145645	C15orf43	chr15	45238900	45274421	35521	chromosome 15 open reading frame 43
PA142672265	84419	C15orf48	chr15	45712727	45728647	15920	chromosome 15 open reading frame 48
PA162378161	388115	C15orf52	chr15	40620653	40643168	22515	chromosome 15 open reading frame 52
PA162378188	400359	C15orf53	chr15	38978799	38995239	16440	chromosome 15 open reading frame 53
PA162378197	400360	C15orf54	chr15	39532885	39550048	17163	chromosome 15 open reading frame 54
PA162378225	644809	C15orf56	chr15	40539865	40555110	15245	chromosome 15 open reading frame 56
PA162378234	90416	C15orf57	chr15	40821083	40867252	46169	chromosome 15 open reading frame 57
PA162378260	388135	C15orf59	chr15	74024772	74055495	30723	chromosome 15 open reading frame 59
PA162378286	145853	C15orf61	chr15	67803522	67822641	19119	chromosome 15 open reading frame 61
PA162378296	643338	C15orf62	chr15	41052159	41067647	15488	chromosome 15 open reading frame 62
PA25526	84326	C16orf13	chr16	681429	696371	14942	chromosome 16 open reading frame 13
PA25544	750	C16orf3	chr16	90092316	90106309	13993	chromosome 16 open reading frame 3
PA134973206	89927	C16orf45	chr16	15518325	15685116	166791	chromosome 16 open reading frame 45
PA142672254	123775	C16orf46	chr16	81084102	81120872	36770	chromosome 16 open reading frame 46
PA142672259	730094	C16orf52	chr16	22009456	22098975	89519	chromosome 16 open reading frame 52
PA142672261	283897	C16orf54	chr16	29750784	29767340	16556	chromosome 16 open reading frame 54
PA143485395	64755	C16orf58	chr16	31497796	31529740	31944	chromosome 16 open reading frame 58
PA143485396	80178	C16orf59	chr16	2500115	2517964	17849	chromosome 16 open reading frame 59
PA162378300	57020	C16orf62	chr16	19556737	19715485	158748	chromosome 16 open reading frame 62
PA142671552	80262	C16orf70	chr16	67133801	67185442	51641	chromosome 16 open reading frame 70
PA145149565	146562	C16orf71	chr16	4774289	4802397	28108	chromosome 16 open reading frame 71
PA145149589	29035	C16orf72	chr16	9175537	9216555	41018	chromosome 16 open reading frame 72
PA145149623	404550	C16orf74	chr16	85738123	85794689	56566	chromosome 16 open reading frame 74
PA147358456	123970	C16orf78	chr16	49397808	49436321	38513	chromosome 16 open reading frame 78
PA164716846	162083	C16orf82	chr16	27068219	27083487	15268	chromosome 16 open reading frame 82
PA162378445	388284	C16orf86	chr16	67690662	67705661	14999	chromosome 16 open reading frame 86
PA162378458	388272	C16orf87	chr16	46832959	46875074	42115	chromosome 16 open reading frame 87
PA162378486	146556	C16orf89	chr16	5089925	5126146	36221	chromosome 16 open reading frame 89
PA162378507	646174	C16orf90	chr16	3540484	3555758	15274	chromosome 16 open reading frame 90
PA164716853	283951	C16orf91	chr16	1466745	1480801	14056	chromosome 16 open reading frame 91
PA164716866	146378	C16orf92	chr16	30024655	30039023	14368	chromosome 16 open reading frame 92
PA164716879	90835	C16orf93	chr16	30765733	30783598	17865	chromosome 16 open reading frame 93
PA164716900	388327	C17orf100	chr17	6545059	6559617	14558	chromosome 17 open reading frame 100
PA164716932	400591	C17orf102	chr17	32898142	32916388	18246	chromosome 17 open reading frame 102
PA165431498	284071	C17orf104	chr17	42723762	42758673	34911	chromosome 17 open reading frame 104
PA165431514	284067	C17orf105	chr17	41847803	41865054	17251	chromosome 17 open reading frame 105
PA165431617	100130311	C17orf107	chr17	4792948	4809227	16279	chromosome 17 open reading frame 107
PA142672230	284083	C17orf47	chr17	56615948	56631733	15785	chromosome 17 open reading frame 47
PA142672232	124944	C17orf49	chr17	6908056	6923843	15787	chromosome 17 open reading frame 49
PA142672233	146853	C17orf50	chr17	34077890	34095098	17208	chromosome 17 open reading frame 50
PA142672234	339263	C17orf51	chr17	21340211	21464941	124730	chromosome 17 open reading frame 51
PA142672236	78995	C17orf53	chr17	42209274	42242844	33570	chromosome 17 open reading frame 53
PA142672241	284018	C17orf58	chr17	65984217	65999765	15548	chromosome 17 open reading frame 58
PA142672242	54785	C17orf59	chr17	8088651	8103564	14913	chromosome 17 open reading frame 59
PA142672245	79415	C17orf62	chr17	80397462	80418707	21245	chromosome 17 open reading frame 62
PA142672247	124773	C17orf64	chr17	58488574	58511787	23213	chromosome 17 open reading frame 64
PA142672250	339210	C17orf67	chr17	54866274	54921256	54982	chromosome 17 open reading frame 67
PA142672253	80233	C17orf70	chr17	79503911	79529429	25518	chromosome 17 open reading frame 70
PA142672222	201243	C17orf74	chr17	7318851	7333887	15036	chromosome 17 open reading frame 74
PA142672223	64149	C17orf75	chr17	30652460	30687066	34606	chromosome 17 open reading frame 75
PA165432227	125144	C17orf76-AS1	chr17	16332301	16377344	45043	C17orf76 antisense RNA 1
PA143485401	146723	C17orf77	chr17	72571057	72593348	22291	chromosome 17 open reading frame 77
PA143485402	284099	C17orf78	chr17	35722928	35752812	29884	chromosome 17 open reading frame 78
PA143485404	55028	C17orf80	chr17	71218372	71248098	29726	chromosome 17 open reading frame 80
PA145008807	388407	C17orf82	chr17	59479112	59493641	14529	chromosome 17 open reading frame 82
PA145149545	55421	C17orf85	chr17	3707042	3759545	52503	chromosome 17 open reading frame 85
PA162378532	284184	C17orf89	chr17	79203039	79218098	15059	chromosome 17 open reading frame 89
PA162378581	100170841	C17orf96	chr17	36824956	36841187	16231	chromosome 17 open reading frame 96
PA162378582	400566	C17orf97	chr17	250118	267457	17339	chromosome 17 open reading frame 97
PA162378591	388381	C17orf98	chr17	36988341	37007642	19301	chromosome 17 open reading frame 98
PA162378601	100141515	C17orf99	chr17	76132434	76165364	32930	chromosome 17 open reading frame 99
PA134888949	83608	C18orf21	chr18	33542588	33562250	19662	chromosome 18 open reading frame 21
PA134919240	147339	C18orf25	chr18	43743519	43849955	106436	chromosome 18 open reading frame 25
PA162378602	497661	C18orf32	chr18	47004548	47023644	19096	chromosome 18 open reading frame 32
PA134942612	162681	C18orf54	chr18	51874284	51911404	37120	chromosome 18 open reading frame 54
PA134956204	494514	C18orf56	chr18	646620	668340	21720	chromosome 18 open reading frame 56
PA134862561	29919	C18orf8	chr18	21073434	21116311	42877	chromosome 18 open reading frame 8
PA29827	56005	C19orf10	chr19	4654557	4680415	25858	chromosome 19 open reading frame 10
PA134981038	83636	C19orf12	chr19	30186793	30216696	29903	chromosome 19 open reading frame 12
PA134876425	147685	C19orf18	chr19	58466805	58495902	29097	chromosome 19 open reading frame 18
PA134930220	55009	C19orf24	chr19	1265520	1282243	16723	chromosome 19 open reading frame 24
PA134878893	148223	C19orf25	chr19	1470200	1489555	19355	chromosome 19 open reading frame 25
PA134919853	255057	C19orf26	chr19	1225059	1247990	22931	chromosome 19 open reading frame 26
PA134924870	64073	C19orf33	chr19	38784804	38798646	13842	chromosome 19 open reading frame 33
PA134922698	374872	C19orf35	chr19	2271631	2292181	20550	chromosome 19 open reading frame 35
PA162378624	255809	C19orf38	chr19	10937304	10983466	46162	chromosome 19 open reading frame 38
PA144596473	91442	C19orf40	chr19	33453140	33471401	18261	chromosome 19 open reading frame 40
PA144596476	79002	C19orf43	chr19	12838454	12855529	17075	chromosome 19 open reading frame 43
PA145149498	84167	C19orf44	chr19	16597187	16635180	37993	chromosome 19 open reading frame 44
PA145149520	374877	C19orf45	chr19	7552445	7576336	23891	chromosome 19 open reading frame 45
PA145149543	126526	C19orf47	chr19	40823967	40864434	40467	chromosome 19 open reading frame 47
PA145149544	84798	C19orf48	chr19	51297961	51317974	20013	chromosome 19 open reading frame 48
PA147358399	90580	C19orf52	chr19	11029424	11043917	14493	chromosome 19 open reading frame 52
PA147358407	28974	C19orf53	chr19	13875257	13892587	17330	chromosome 19 open reading frame 53
PA147358417	284325	C19orf54	chr19	41243761	41266533	22772	chromosome 19 open reading frame 54
PA162378679	79173	C19orf57	chr19	13990168	14026909	36741	chromosome 19 open reading frame 57
PA162378719	55049	C19orf60	chr19	18689495	18706147	16652	chromosome 19 open reading frame 60
PA162378809	55337	C19orf66	chr19	10186806	10206928	20122	chromosome 19 open reading frame 66
PA162378830	646457	C19orf67	chr19	14189444	14206607	17163	chromosome 19 open reading frame 67
PA162378847	374920	C19orf68	chr19	48665210	48703516	38306	chromosome 19 open reading frame 68
PA162378863	125988	C19orf70	chr19	5675425	5690911	15486	chromosome 19 open reading frame 70
PA164716956	100128569	C19orf71	chr19	3528674	3547121	18447	chromosome 19 open reading frame 71
PA164717000	55150	C19orf73	chr19	49618654	49632397	13743	chromosome 19 open reading frame 73
PA164717007	10438	C1D	chr2	68266332	68300159	33827	C1D nuclear receptor corepressor
PA134971259	56913	C1GALT1	chr7	7212178	7291282	79104	core 1 synthase, glycoprotein-N-acetylgalactosamine 3-beta-galactosyltransferase 1
PA134974626	29071	C1GALT1C1	chrX	119756529	119774005	17476	C1GALT1-specific chaperone 1
PA25622	712	C1QA	chr1	22953118	22969175	16057	complement component 1, q subcomponent, A chain
PA25623	713	C1QB	chr1	22969682	22991130	21448	complement component 1, q subcomponent, B chain
PA25624	708	C1QBP	chr17	5333099	5352471	19372	complement component 1, q subcomponent binding protein
PA25626	714	C1QC	chr1	22959969	22977603	17634	complement component 1, q subcomponent, C chain
PA134951551	10882	C1QL1	chr17	43034061	43055644	21583	complement component 1, q subcomponent-like 1
PA134915960	165257	C1QL2	chr2	119910819	119926471	15652	complement component 1, q subcomponent-like 2
PA134891919	389941	C1QL3	chr10	16552742	16574004	21262	complement component 1, q subcomponent-like 3
PA142672536	338761	C1QL4	chr12	49723200	49740971	17771	complement component 1, q subcomponent-like 4
PA25628	114897	C1QTNF1	chr17	77009016	77048870	39854	C1q and tumor necrosis factor related protein 1
PA25629	114898	C1QTNF2	chr5	159771761	159807657	35896	C1q and tumor necrosis factor related protein 2
PA25630	114899	C1QTNF3	chr5	34014963	34053371	38408	C1q and tumor necrosis factor related protein 3
PA25631	114900	C1QTNF4	chr11	47608216	47625961	17745	C1q and tumor necrosis factor related protein 4
PA25632	114902	C1QTNF5	chr11	119206644	119227383	20739	C1q and tumor necrosis factor related protein 5
PA25633	114904	C1QTNF6	chr22	37573206	37604341	31135	C1q and tumor necrosis factor related protein 6
PA25634	114905	C1QTNF7	chr4	15331560	15450791	119231	C1q and tumor necrosis factor related protein 7
PA134914298	390664	C1QTNF8	chr16	1135226	1156244	21018	C1q and tumor necrosis factor related protein 8
PA145008937	338872	C1QTNF9	chr13	24873686	24899669	25983	C1q and tumor necrosis factor related protein 9
PA25635	715	C1R	chr12	7238205	7255043	16838	complement component 1, r subcomponent
PA134957759	51279	C1RL	chr12	7243000	7271869	28869	complement component 1, r subcomponent-like
PA25636	716	C1S	chr12	7157819	7181336	23517	complement component 1, s subcomponent
PA142672484	200159	C1orf100	chr1	244505937	244555390	49453	chromosome 1 open reading frame 100
PA142672485	257044	C1orf101	chr1	244614673	244806664	191991	chromosome 1 open reading frame 101
PA142672489	92346	C1orf105	chr1	172379828	172440969	61141	chromosome 1 open reading frame 105
PA142672490	55765	C1orf106	chr1	200850627	200887864	37237	chromosome 1 open reading frame 106
PA142672493	54955	C1orf109	chr1	38144242	38168007	23765	chromosome 1 open reading frame 109
PA142672494	339512	C1orf110	chr1	162817766	162848605	30839	chromosome 1 open reading frame 110
PA142672495	284680	C1orf111	chr1	162340515	162357017	16502	chromosome 1 open reading frame 111
PA142672496	55732	C1orf112	chr1	169753224	169825229	72005	chromosome 1 open reading frame 112
PA142672499	79762	C1orf115	chr1	220853628	220875499	21871	chromosome 1 open reading frame 115
PA142672500	79098	C1orf116	chr1	207188866	207218555	29689	chromosome 1 open reading frame 116
PA142672440	127687	C1orf122	chr1	38263473	38278126	14653	chromosome 1 open reading frame 122
PA142672441	54987	C1orf123	chr1	53676771	53696289	19518	chromosome 1 open reading frame 123
PA142672445	148345	C1orf127	chr1	11003530	11052094	48564	chromosome 1 open reading frame 127
PA142672449	128061	C1orf131	chr1	231356509	231386933	30424	chromosome 1 open reading frame 131
PA142672459	400757	C1orf141	chr1	67554859	67610654	55795	chromosome 1 open reading frame 141
PA142672463	388649	C1orf146	chr1	92673573	92714367	40794	chromosome 1 open reading frame 146
PA142672409	93190	C1orf158	chr1	12796163	12824102	27939	chromosome 1 open reading frame 158
PA142672410	54991	C1orf159	chr1	1014198	1061736	47538	chromosome 1 open reading frame 159
PA142672413	128346	C1orf162	chr1	112006474	112024134	17660	chromosome 1 open reading frame 162
PA142672417	284498	C1orf167	chr1	11816805	11841367	24562	chromosome 1 open reading frame 167
PA142672418	199920	C1orf168	chr1	57181477	57295369	113892	chromosome 1 open reading frame 168
PA143485318	339448	C1orf174	chr1	3802697	3826857	24160	chromosome 1 open reading frame 174
PA142672425	163747	C1orf177	chr1	55261736	55310937	49201	chromosome 1 open reading frame 177
PA142672433	284546	C1orf185	chr1	51432129	51616754	184625	chromosome 1 open reading frame 185
PA142672434	440712	C1orf186	chr1	206235872	206298236	62364	chromosome 1 open reading frame 186
PA142672400	388701	C1orf189	chr1	154168561	154188841	20280	chromosome 1 open reading frame 189
PA145149814	127003	C1orf194	chr1	109645573	109666484	20911	chromosome 1 open reading frame 194
PA143485319	84886	C1orf198	chr1	230969865	231015335	45470	chromosome 1 open reading frame 198
PA142672405	284677	C1orf204	chr1	159801264	159835544	34280	chromosome 1 open reading frame 204
PA25610	81563	C1orf21	chr1	184346150	184601155	255005	chromosome 1 open reading frame 21
PA144596510	149466	C1orf210	chr1	43744554	43761334	16780	chromosome 1 open reading frame 210
PA162378892	127703	C1orf216	chr1	36176477	36194790	18313	chromosome 1 open reading frame 216
PA164717033	400793	C1orf226	chr1	162338696	162359608	20912	chromosome 1 open reading frame 226
PA164717053	339541	C1orf228	chr1	45130370	45194263	63893	chromosome 1 open reading frame 228
PA165750489	388759	C1orf229	chr1	247270462	247285719	15257	chromosome 1 open reading frame 229
PA134934744	54953	C1orf27	chr1	186334890	186393503	58613	chromosome 1 open reading frame 27
PA38781	79169	C1orf35	chr1	228285428	228303112	17684	chromosome 1 open reading frame 35
PA134961848	25912	C1orf43	chr1	154176183	154203273	27090	chromosome 1 open reading frame 43
PA134861089	79078	C1orf50	chr1	43222916	43244413	21497	chromosome 1 open reading frame 50
PA142672503	148423	C1orf52	chr1	85712636	85735355	22719	chromosome 1 open reading frame 52
PA142672504	388722	C1orf53	chr1	197861682	197879497	17815	chromosome 1 open reading frame 53
PA142672505	79630	C1orf54	chr1	150234687	150256335	21648	chromosome 1 open reading frame 54
PA142672507	54964	C1orf56	chr1	151010259	151026896	16637	chromosome 1 open reading frame 56
PA142672511	10485	C1orf61	chr1	156371048	156436441	65393	chromosome 1 open reading frame 61
PA142672514	149563	C1orf64	chr1	16320731	16336184	15453	chromosome 1 open reading frame 64
PA142672518	100129271	C1orf68	chr1	152681998	152695905	13907	chromosome 1 open reading frame 68
PA142672523	148304	C1orf74	chr1	209952662	209967890	15228	chromosome 1 open reading frame 74
PA142672533	112770	C1orf85	chr1	156259478	156275480	16002	chromosome 1 open reading frame 85
PA142672470	199990	C1orf86	chr1	2112899	2154159	41260	chromosome 1 open reading frame 86
PA142672471	127795	C1orf87	chr1	60453066	60549442	96376	chromosome 1 open reading frame 87
PA142672478	84970	C1orf94	chr1	34622624	34687732	65108	chromosome 1 open reading frame 94
PA142672479	375057	C1orf95	chr1	226726501	226799915	73414	chromosome 1 open reading frame 95
PA25637	717	C2	chr6	31855562	31916449	60887	complement component 2
PA25684	128653	C20orf141	chr20	2785633	2799476	13843	chromosome 20 open reading frame 141
PA25687	128864	C20orf144	chr20	32240092	32254721	14629	chromosome 20 open reading frame 144
PA25708	128826	C20orf166	chr20	61137660	61170971	33311	chromosome 20 open reading frame 166
PA25716	140873	C20orf173	chr20	34105569	34127481	21912	chromosome 20 open reading frame 173
PA134905007	25943	C20orf194	chr20	3226948	3398587	171639	chromosome 20 open reading frame 194
PA142672215	79025	C20orf195	chr20	62174373	62191061	16688	chromosome 20 open reading frame 195
PA145149476	149840	C20orf196	chr20	5721043	5847558	126515	chromosome 20 open reading frame 196
PA145149486	284756	C20orf197	chr20	58620980	58651008	30028	chromosome 20 open reading frame 197
PA165392338	400831	C20orf202	chr20	1174098	1191918	17820	chromosome 20 open reading frame 202
PA25740	55969	C20orf24	chr20	35224137	35243960	19823	chromosome 20 open reading frame 24
PA25742	54976	C20orf27	chr20	3731146	3759035	27889	chromosome 20 open reading frame 27
PA25787	100128496	C20orf78	chr20	18787372	18820839	33467	chromosome 20 open reading frame 78
PA25793	128602	C20orf85	chr20	56715983	56739186	23203	chromosome 20 open reading frame 85
PA25803	140680	C20orf96	chr20	248504	281419	32915	chromosome 20 open reading frame 96
PA25816	755	C21orf2	chr21	45745827	45769285	23458	chromosome 21 open reading frame 2
PA25828	8209	C21orf33	chr21	45543476	45625835	82359	chromosome 21 open reading frame 33
PA25853	54058	C21orf58	chr21	47717344	47753813	36469	chromosome 21 open reading frame 58
PA25854	56683	C21orf59	chr21	33970977	33995174	24197	chromosome 21 open reading frame 59
PA25857	56245	C21orf62	chr21	34159984	34196053	36069	chromosome 21 open reading frame 62
PA25879	54149	C21orf91	chr21	19158284	19201703	43419	chromosome 21 open reading frame 91
PA134933953	150248	C22orf15	chr22	24092622	24111050	18428	chromosome 22 open reading frame 15
PA38355	84645	C22orf23	chr22	38336057	38359676	23619	chromosome 22 open reading frame 23
PA134944653	25775	C22orf24	chr22	32326507	32351336	24829	chromosome 22 open reading frame 24
PA145149415	79680	C22orf29	chr22	19830661	19852371	21710	chromosome 22 open reading frame 29
PA145149441	25770	C22orf31	chr22	29451660	29467922	16262	chromosome 22 open reading frame 31
PA162378995	128977	C22orf39	chr22	19425409	19445755	20346	chromosome 22 open reading frame 39
PA164717091	150297	C22orf42	chr22	32541993	32565510	23517	chromosome 22 open reading frame 42
PA165378333	79640	C22orf46	chr22	42076547	42097140	20593	chromosome 22 open reading frame 46
PA162379018	25966	C2CD2	chr21	43302219	43384066	81847	C2 calcium-dependent domain containing 2
PA162379049	9854	C2CD2L	chr11	118967771	118991304	23533	C2CD2-like
PA162379082	26005	C2CD3	chr11	73720759	73892064	171305	C2 calcium-dependent domain containing 3
PA165478510	145741	C2CD4A	chr15	62349176	62366116	16940	C2 calcium-dependent domain containing 4A
PA165478519	388125	C2CD4B	chr15	62452734	62468359	15625	C2 calcium-dependent domain containing 4B
PA165393218	126567	C2CD4C	chr19	402443	419170	16727	C2 calcium-dependent domain containing 4C
PA165750504	100191040	C2CD4D	chr1	151807339	151823033	15694	C2 calcium-dependent domain containing 4D
PA143485515	9847	C2CD5	chr12	22598511	22707452	108941	C2 calcium-dependent domain containing 5
PA134861678	150590	C2orf15	chr2	99748185	99770950	22765	chromosome 2 open reading frame 15
PA134977296	84226	C2orf16	chr2	27789389	27808589	19200	chromosome 2 open reading frame 16
PA164717121	29798	C2orf27A	chr2	132469973	132527977	58004	chromosome 2 open reading frame 27A
PA164717134	408029	C2orf27B	chr2	132549534	132569234	19700	chromosome 2 open reading frame 27B
PA147358728	84417	C2orf40	chr2	106672113	106697611	25498	chromosome 2 open reading frame 40
PA147358740	54980	C2orf42	chr2	70374017	70428151	54134	chromosome 2 open reading frame 42
PA147358698	60526	C2orf43	chr2	20880788	21032890	152102	chromosome 2 open reading frame 43
PA147358716	80304	C2orf44	chr2	24249206	24280296	31090	chromosome 2 open reading frame 44
PA162379149	79568	C2orf47	chr2	200810040	200831848	21808	chromosome 2 open reading frame 47
PA162379166	348738	C2orf48	chr2	10271509	10354856	83347	chromosome 2 open reading frame 48
PA162379179	79074	C2orf49	chr2	105943714	105979514	35800	chromosome 2 open reading frame 49
PA162379180	130813	C2orf50	chr2	11263179	11289916	26737	chromosome 2 open reading frame 50
PA162379226	79919	C2orf54	chr2	241822465	241846267	23802	chromosome 2 open reading frame 54
PA162379291	165100	C2orf57	chr2	232447575	232461994	14419	chromosome 2 open reading frame 57
PA162379319	285051	C2orf61	chr2	47311130	47392517	81387	chromosome 2 open reading frame 61
PA162379428	401027	C2orf66	chr2	197666139	197685000	18861	chromosome 2 open reading frame 66
PA162379474	388969	C2orf68	chr2	85829376	85849179	19803	chromosome 2 open reading frame 68
PA162379487	205327	C2orf69	chr2	200765979	200795996	30017	chromosome 2 open reading frame 69
PA162379496	339778	C2orf70	chr2	26775427	26805395	29968	chromosome 2 open reading frame 70
PA162379508	388939	C2orf71	chr2	29281556	29307127	25571	chromosome 2 open reading frame 71
PA162379516	257407	C2orf72	chr2	231892281	231917429	25148	chromosome 2 open reading frame 72
PA162379532	129852	C2orf73	chr2	54548006	54591714	43708	chromosome 2 open reading frame 73
PA162379547	339804	C2orf74	chr2	61362221	61394964	32743	chromosome 2 open reading frame 74
PA162379558	130355	C2orf76	chr2	120056793	120134451	77658	chromosome 2 open reading frame 76
PA162379600	388960	C2orf78	chr2	74001316	74047274	45958	chromosome 2 open reading frame 78
PA162379620	389073	C2orf80	chr2	209027071	209064969	37898	chromosome 2 open reading frame 80
PA162379643	388963	C2orf81	chr2	74638303	74654934	16631	chromosome 2 open reading frame 81
PA162379659	389084	C2orf82	chr2	233723724	233744111	20387	chromosome 2 open reading frame 82
PA164717149	56918	C2orf83	chr2	228471806	228508036	36230	chromosome 2 open reading frame 83
PA164717227	84281	C2orf88	chr2	190734282	191071210	336928	chromosome 2 open reading frame 88
PA25897	718	C3	chr19	6674846	6730662	55816	complement component 3
PA25898	719	C3AR1	chr12	8207919	8228955	21036	complement component 3a receptor 1
PA134883066	57415	C3orf14	chr3	62294648	62324888	30240	chromosome 3 open reading frame 14
PA134948355	25871	C3orf17	chr3	112718291	112748555	30264	chromosome 3 open reading frame 17
PA134941482	51161	C3orf18	chr3	50592456	50618458	26002	chromosome 3 open reading frame 18
PA134977176	84077	C3orf20	chr3	14706606	14817543	110937	chromosome 3 open reading frame 20
PA142672383	152065	C3orf22	chr3	126242842	126287808	44966	chromosome 3 open reading frame 22
PA142672391	152405	C3orf30	chr3	118854997	118882674	27677	chromosome 3 open reading frame 30
PA142672394	285315	C3orf33	chr3	155477401	155534076	56675	chromosome 3 open reading frame 33
PA142672396	339883	C3orf35	chr3	37416477	37479988	63511	chromosome 3 open reading frame 35
PA142672397	80111	C3orf36	chr3	133643989	133658656	14667	chromosome 3 open reading frame 36
PA142672399	285237	C3orf38	chr3	88188875	88210115	21240	chromosome 3 open reading frame 38
PA143485328	79669	C3orf52	chr3	111795175	111840073	44898	chromosome 3 open reading frame 52
PA143485334	205428	C3orf58	chr3	143680640	143714210	33570	chromosome 3 open reading frame 58
PA143485337	375341	C3orf62	chr3	49303030	49324864	21834	chromosome 3 open reading frame 62
PA162379670	200844	C3orf67	chr3	58717199	59045804	328605	chromosome 3 open reading frame 67
PA162379707	285382	C3orf70	chr3	184792838	184880802	87964	chromosome 3 open reading frame 70
PA165696932	152118	C3orf79	chr3	153192284	153223486	31202	chromosome 3 open reading frame 79
PA25903	720	C4A	chr6	31939834	31973457	33623	complement component 4A (Rodgers blood group)
PA25904	721	C4B	chr6	31972572	32006195	33623	complement component 4B (Chido blood group)
PA25905	722	C4BPA	chr1	207267583	207321317	53734	complement component 4 binding protein, alpha
PA25908	725	C4BPB	chr1	207252210	207276338	24128	complement component 4 binding protein, beta
PA134913125	84103	C4orf17	chr4	100422161	100466460	44299	chromosome 4 open reading frame 17
PA144596500	55286	C4orf19	chr4	37445552	37598132	152580	chromosome 4 open reading frame 19
PA145008853	255119	C4orf22	chr4	81246861	81887910	641049	chromosome 4 open reading frame 22
PA145008917	152816	C4orf26	chr4	76471258	76494103	22845	chromosome 4 open reading frame 26
PA145149735	54969	C4orf27	chr4	170647619	170689093	41474	chromosome 4 open reading frame 27
PA147358673	80167	C4orf29	chr4	128876411	128960478	84067	chromosome 4 open reading frame 29
PA164717306	401152	C4orf3	chr4	120214574	120235600	21026	chromosome 4 open reading frame 3
PA162379734	132720	C4orf32	chr4	113056553	113113237	56684	chromosome 4 open reading frame 32
PA162379743	132321	C4orf33	chr4	130004829	130037487	32658	chromosome 4 open reading frame 33
PA162379784	132989	C4orf36	chr4	87794358	87834820	40462	chromosome 4 open reading frame 36
PA162379953	152940	C4orf45	chr4	159811684	159966333	154649	chromosome 4 open reading frame 45
PA162379968	201725	C4orf46	chr4	159584827	159603407	18580	chromosome 4 open reading frame 46
PA162379983	441054	C4orf47	chr4	186337220	186373982	36762	chromosome 4 open reading frame 47
PA164717315	401115	C4orf48	chr4	2033720	2048697	14977	chromosome 4 open reading frame 48
PA165663217	389197	C4orf50	chr4	5955839	6000166	44327	chromosome 4 open reading frame 50
PA165663246	646603	C4orf51	chr4	146591356	146656949	65593	chromosome 4 open reading frame 51
PA25910	10141	C4orf6	chr4	5516883	5532528	15645	chromosome 4 open reading frame 6
PA25911	727	C5	chr9	123711613	123822554	110941	complement component 5
PA25920	728	C5AR1	chr19	47803104	47828327	25223	complement component 5a receptor 1
PA28920	27202	C5AR2	chr19	47825404	47848272	22868	complement component 5a receptor 2
PA134898147	56951	C5orf15	chr5	133288198	133314406	26208	chromosome 5 open reading frame 15
PA144596503	55322	C5orf22	chr5	31522373	31558165	35792	chromosome 5 open reading frame 22
PA144596504	79614	C5orf23	chr5	32778946	32794820	15874	chromosome 5 open reading frame 23
PA144596505	134553	C5orf24	chr5	134171370	134198425	27055	chromosome 5 open reading frame 24
PA162380004	64417	C5orf28	chr5	43441354	43494171	52817	chromosome 5 open reading frame 28
PA162380017	90355	C5orf30	chr5	102584442	102617361	32919	chromosome 5 open reading frame 30
PA162380068	375444	C5orf34	chr5	43483803	43525273	41470	chromosome 5 open reading frame 34
PA162380158	153571	C5orf38	chr5	2742058	2758511	16453	chromosome 5 open reading frame 38
PA162380188	65250	C5orf42	chr5	37076423	37259530	183107	chromosome 5 open reading frame 42
PA162380286	51149	C5orf45	chr5	179260927	179295867	34940	chromosome 5 open reading frame 45
PA162380305	389336	C5orf46	chr5	147266579	147296101	29522	chromosome 5 open reading frame 46
PA162380318	133491	C5orf47	chr5	173406162	173436143	29981	chromosome 5 open reading frame 47
PA162380347	134121	C5orf49	chr5	7827491	7861603	34112	chromosome 5 open reading frame 49
PA162380371	285636	C5orf51	chr5	41894423	41924738	30315	chromosome 5 open reading frame 51
PA164717340	100190949	C5orf52	chr5	157088561	157110162	21601	chromosome 5 open reading frame 52
PA164717357	116349	C5orf55	chr5	438613	453258	14645	chromosome 5 open reading frame 55
PA165660191	441108	C5orf56	chr5	131736465	131814736	78271	chromosome 5 open reading frame 56
PA165660204	133874	C5orf58	chr5	169649916	169676235	26319	chromosome 5 open reading frame 58
PA165660205	285679	C5orf60	chr5	179065545	179082083	16538	chromosome 5 open reading frame 60
PA25921	729	C6	chr5	41139248	41271588	132340	complement component 6
PA25922	221491	C6orf1	chr6	34211157	34226904	15747	chromosome 6 open reading frame 1
PA25923	10665	C6orf10	chr6	32257475	32349705	92230	chromosome 6 open reading frame 10
PA134935866	64771	C6orf106	chr6	34552065	34674625	122560	chromosome 6 open reading frame 106
PA134917499	85411	C6orf114	chr6	13466510	13496416	29906	chromosome 6 open reading frame 114
PA134954942	168090	C6orf118	chr6	165690153	165733111	42958	chromosome 6 open reading frame 118
PA134992326	387263	C6orf120	chr6	170092238	170109402	17164	chromosome 6 open reading frame 120
PA134935851	647024	C6orf132	chr6	42065857	42120715	54858	chromosome 6 open reading frame 132
PA134962744	221545	C6orf136	chr6	30604816	30623987	19171	chromosome 6 open reading frame 136
PA134885117	135398	C6orf141	chr6	49508113	49526166	18053	chromosome 6 open reading frame 141
PA134866404	29113	C6orf15	chr6	31076000	31090332	14332	chromosome 6 open reading frame 15
PA134938121	206412	C6orf163	chr6	88044571	88078381	33810	chromosome 6 open reading frame 163
PA134983540	154313	C6orf165	chr6	88107690	88177191	69501	chromosome 6 open reading frame 165
PA134925567	154386	C6orf195	chr6	2619972	2645298	25326	chromosome 6 open reading frame 195
PA134906041	404220	C6orf201	chr6	4069440	4134000	64560	chromosome 6 open reading frame 201
PA134898244	51250	C6orf203	chr6	107339407	107375546	36139	chromosome 6 open reading frame 203
PA134870747	79624	C6orf211	chr6	151763422	151794236	30814	chromosome 6 open reading frame 211
PA162380399	389384	C6orf222	chr6	36280534	36314662	34128	chromosome 6 open reading frame 222
PA162380428	221416	C6orf223	chr6	43958337	43976695	18358	chromosome 6 open reading frame 223
PA164717364	441150	C6orf226	chr6	42855003	42868554	13551	chromosome 6 open reading frame 226
PA25926	80739	C6orf25	chr6	31681121	31697487	16366	chromosome 6 open reading frame 25
PA38785	57827	C6orf47	chr6	31623075	31638549	15474	chromosome 6 open reading frame 47
PA38786	50854	C6orf48	chr6	31792693	31810541	17848	chromosome 6 open reading frame 48
PA134991266	347744	C6orf52	chr6	10668651	10705030	36379	chromosome 6 open reading frame 52
PA134932684	135154	C6orf57	chr6	71266625	71301606	34981	chromosome 6 open reading frame 57
PA134881952	352999	C6orf58	chr6	127888319	127915963	27644	chromosome 6 open reading frame 58
PA134946342	81688	C6orf62	chr6	24702089	24731064	28975	chromosome 6 open reading frame 62
PA134986915	221477	C6orf89	chr6	36843640	36899740	56100	chromosome 6 open reading frame 89
PA25941	730	C7	chr5	40899599	40986041	86442	complement component 7
PA134976499	79020	C7orf25	chr7	42945223	42961689	16466	chromosome 7 open reading frame 25
PA134951741	79034	C7orf26	chr7	6619681	6651357	31676	chromosome 7 open reading frame 26
PA134924921	136895	C7orf31	chr7	25161819	25229966	68147	chromosome 7 open reading frame 31
PA134962911	202865	C7orf33	chr7	148277657	148315952	38295	chromosome 7 open reading frame 33
PA134972511	135927	C7orf34	chr7	142626603	142640957	14354	chromosome 7 open reading frame 34
PA147358601	55262	C7orf43	chr7	99749043	99766338	17295	chromosome 7 open reading frame 43
PA162380533	78996	C7orf49	chr7	134847532	134865578	18046	chromosome 7 open reading frame 49
PA162380546	84310	C7orf50	chr7	1033623	1187911	154288	chromosome 7 open reading frame 50
PA164717374	154791	C7orf55	chr7	139015196	139034065	18869	chromosome 7 open reading frame 55
PA162380613	136288	C7orf57	chr7	48065108	48103894	38786	chromosome 7 open reading frame 57
PA162380700	154743	C7orf60	chr7	112456202	112589932	133730	chromosome 7 open reading frame 60
PA162380715	402573	C7orf61	chr7	100051238	100072063	20825	chromosome 7 open reading frame 61
PA162380726	219557	C7orf62	chr7	88420420	88435031	14611	chromosome 7 open reading frame 62
PA164717398	401335	C7orf65	chr7	47684842	47704246	19404	chromosome 7 open reading frame 65
PA164717407	154907	C7orf66	chr7	108521038	108534637	13599	chromosome 7 open reading frame 66
PA164717466	80099	C7orf69	chr7	47824889	47862445	37556	chromosome 7 open reading frame 69
PA165617664	285941	C7orf71	chr7	26667490	26689924	22434	chromosome 7 open reading frame 71
PA165617678	100130988	C7orf72	chr7	50125682	50201852	76170	chromosome 7 open reading frame 72
PA25951	731	C8A	chr1	57310443	57386894	76451	complement component 8, alpha polypeptide
PA25952	732	C8B	chr1	57391883	57443213	51330	complement component 8, beta polypeptide
PA25953	733	C8G	chr9	139829333	139844426	15093	complement component 8, gamma polypeptide
PA134881233	492307	C8orf22	chr8	49956895	49991642	34747	chromosome 8 open reading frame 22
PA142672350	286122	C8orf31	chr8	144110679	144138720	28041	chromosome 8 open reading frame 31
PA142672352	65265	C8orf33	chr8	146267823	146284416	16593	chromosome 8 open reading frame 33
PA142672353	116328	C8orf34	chr8	69232957	69734258	501301	chromosome 8 open reading frame 34
PA142672356	157657	C8orf37	chr8	96254141	96291707	37566	chromosome 8 open reading frame 37
PA25962	56892	C8orf4	chr8	40000987	40015827	14840	chromosome 8 open reading frame 4
PA142672363	56260	C8orf44	chr8	67569787	67600797	31010	chromosome 8 open reading frame 44
PA142672365	254778	C8orf46	chr8	67395491	67433759	38268	chromosome 8 open reading frame 46
PA142672367	157773	C8orf48	chr8	13414352	13428797	14445	chromosome 8 open reading frame 48
PA142672321	541565	C8orf58	chr8	22447114	22464663	17549	chromosome 8 open reading frame 58
PA142672322	401466	C8orf59	chr8	86123288	86142643	19355	chromosome 8 open reading frame 59
PA142672337	203076	C8orf74	chr8	10520147	10561103	40956	chromosome 8 open reading frame 74
PA142672339	84933	C8orf76	chr8	124229196	124263656	34460	chromosome 8 open reading frame 76
PA162380827	414919	C8orf82	chr8	145748599	145764485	15886	chromosome 8 open reading frame 82
PA164717510	389649	C8orf86	chr8	38365352	38396180	30828	chromosome 8 open reading frame 86
PA25968	735	C9	chr5	39281377	39374655	93278	complement component 9
PA134958095	51490	C9orf114	chr9	131578930	131602299	23369	chromosome 9 open reading frame 114
PA134878696	138162	C9orf116	chr9	138384026	138401761	17735	chromosome 9 open reading frame 116
PA134929148	286207	C9orf117	chr9	130459263	130479303	20040	chromosome 9 open reading frame 117
PA134884589	445577	C9orf129	chr9	96077481	96118696	41215	chromosome 9 open reading frame 129
PA145149697	138724	C9orf131	chr9	35031102	35048988	17886	chromosome 9 open reading frame 131
PA145149705	138255	C9orf135	chr9	72425731	72524148	98417	chromosome 9 open reading frame 135
PA145149721	401563	C9orf139	chr9	139911916	139934234	22318	chromosome 9 open reading frame 139
PA143485344	286257	C9orf142	chr9	139876870	139891428	14558	chromosome 9 open reading frame 142
PA134988229	401546	C9orf152	chr9	112958841	112980413	21572	chromosome 9 open reading frame 152
PA134962664	389766	C9orf153	chr9	88832180	88884572	52392	chromosome 9 open reading frame 153
PA134875112	51531	C9orf156	chr9	100659380	100694852	35472	chromosome 9 open reading frame 156
PA25973	79095	C9orf16	chr9	130912539	130929207	16668	chromosome 9 open reading frame 16
PA144596496	158055	C9orf163	chr9	139367947	139383519	15572	chromosome 9 open reading frame 163
PA164717521	401535	C9orf170	chr9	89753559	89777641	24082	chromosome 9 open reading frame 170
PA164717530	389799	C9orf171	chr9	135275430	135451734	176304	chromosome 9 open reading frame 171
PA165585544	389813	C9orf172	chr9	139725733	139744884	19151	chromosome 9 open reading frame 172
PA165585550	441476	C9orf173	chr9	140135713	140150935	15222	chromosome 9 open reading frame 173
PA134950467	84688	C9orf24	chr9	34376017	34407898	31881	chromosome 9 open reading frame 24
PA25978	84909	C9orf3	chr9	97478886	97852500	373614	chromosome 9 open reading frame 3
PA134985448	85026	C9orf37	chr9	140506784	140523308	16524	chromosome 9 open reading frame 37
PA134870430	55071	C9orf40	chr9	77558499	77577802	19303	chromosome 9 open reading frame 40
PA134929393	138199	C9orf41	chr9	77592936	77653326	60390	chromosome 9 open reading frame 41
PA134972642	257169	C9orf43	chr9	116162924	116194964	32040	chromosome 9 open reading frame 43
PA134983814	286223	C9orf47	chr9	91595778	91614057	18279	chromosome 9 open reading frame 47
PA142672314	375759	C9orf50	chr9	132371504	132393055	21551	chromosome 9 open reading frame 50
PA134955143	138240	C9orf57	chr9	74663275	74697728	34453	chromosome 9 open reading frame 57
PA134865965	84267	C9orf64	chr9	86550226	86581665	31439	chromosome 9 open reading frame 64
PA134953147	157983	C9orf66	chr9	210108	225893	15785	chromosome 9 open reading frame 66
PA134944430	90120	C9orf69	chr9	139003427	139020731	17304	chromosome 9 open reading frame 69
PA134908144	203228	C9orf72	chr9	27543543	27583864	40321	chromosome 9 open reading frame 72
PA134929438	51759	C9orf78	chr9	132586564	132607572	21008	chromosome 9 open reading frame 78
PA134876692	158401	C9orf84	chr9	114445901	114567556	121655	chromosome 9 open reading frame 84
PA134985322	138241	C9orf85	chr9	74516190	74591373	75183	chromosome 9 open reading frame 85
PA134909664	84270	C9orf89	chr9	95848450	95878565	30115	chromosome 9 open reading frame 89
PA25983	11092	C9orf9	chr9	135744282	135768419	24137	chromosome 9 open reading frame 9
PA134931542	203197	C9orf91	chr9	117363706	117411703	47997	chromosome 9 open reading frame 91
PA25984	759	CA1	chr8	86237458	86300342	62884	carbonic anhydrase I
PA25985	56934	CA10	chr17	49704674	50247377	542703	carbonic anhydrase X
PA25986	770	CA11	chr19	49138272	49159451	21179	carbonic anhydrase XI
PA25987	771	CA12	chr15	63612730	63684326	71596	carbonic anhydrase XII
PA134891311	377677	CA13	chr8	86147716	86199302	51586	carbonic anhydrase XIII
PA25988	23632	CA14	chr1	150219554	150240478	20924	carbonic anhydrase XIV
PA25989	760	CA2	chr8	86366131	86396721	30590	carbonic anhydrase II
PA25990	761	CA3	chr8	86341056	86364269	23213	carbonic anhydrase III, muscle specific
PA25991	762	CA4	chr17	58217302	58239907	22605	carbonic anhydrase IV
PA25992	763	CA5A	chr16	87918625	87980173	61548	carbonic anhydrase VA, mitochondrial
PA25993	11238	CA5B	chrX	15746412	15808748	62336	carbonic anhydrase VB, mitochondrial
PA134953520	340591	CA5BP1	chrX	15683039	15724474	41435	carbonic anhydrase VB pseudogene 1
PA25995	765	CA6	chr1	8995893	9038151	42258	carbonic anhydrase VI
PA25996	766	CA7	chr16	66868282	66891052	22770	carbonic anhydrase VII
PA25997	767	CA8	chr8	61098423	61203954	105531	carbonic anhydrase VIII
PA25998	768	CA9	chr9	35663915	35684156	20241	carbonic anhydrase IX
PA134943744	79886	CAAP1	chr9	26837683	26902826	65143	caspase activity and apoptosis inhibitor 1
PA128394663	51719	CAB39	chr2	231567557	231688790	121233	calcium binding protein 39
PA134913801	81617	CAB39L	chr13	49879786	50028221	148435	calcium binding protein 39-like
PA164717549	23523	CABIN1	chr22	24397642	24577596	179954	calcineurin binding protein 1
PA134880184	91768	CABLES1	chr18	20704528	20843434	138906	Cdk5 and Abl enzyme substrate 1
PA25692	81928	CABLES2	chr20	60960686	60992339	31653	Cdk5 and Abl enzyme substrate 2
PA26000	9478	CABP1	chr12	121068422	121108129	39707	calcium binding protein 1
PA26001	51475	CABP2	chr11	67283418	67301085	17667	calcium binding protein 2
PA26003	57010	CABP4	chr11	67209886	67232245	22359	calcium binding protein 4
PA26004	56344	CABP5	chr19	48529640	48557311	27671	calcium binding protein 5
PA134928335	164633	CABP7	chr22	30106344	30130822	24478	calcium binding protein 7
PA162379775	85438	CABS1	chr4	71190671	71205833	15162	calcium-binding protein, spermatid-specific 1
PA26005	26256	CABYR	chr18	21708920	21744564	35644	calcium binding tyrosine-(Y)-phosphorylation regulated
PA25982	11094	CACFD1	chr9	136315087	136338909	23822	calcium channel flower domain containing 1
PA142672211	57685	CACHD1	chr1	64926476	65161741	235265	cache domain containing 1
PA26007	773	CACNA1A	chr19	13314256	13627274	313018	calcium channel, voltage-dependent, P/Q type, alpha 1A subunit
PA26008	774	CACNA1B	chr9	140762241	141022076	259835	calcium channel, voltage-dependent, N type, alpha 1B subunit
PA83	775	CACNA1C	chr12	2069952	2810115	740163	calcium channel, voltage-dependent, L type, alpha 1C subunit
PA84	776	CACNA1D	chr3	53519076	53850179	331103	calcium channel, voltage-dependent, L type, alpha 1D subunit
PA26009	777	CACNA1E	chr1	181442447	181778920	336473	calcium channel, voltage-dependent, R type, alpha 1E subunit
PA26010	778	CACNA1F	chrX	49058523	49099833	41310	calcium channel, voltage-dependent, L type, alpha 1F subunit
PA381	8913	CACNA1G	chr17	48628429	48707835	79406	calcium channel, voltage-dependent, T type, alpha 1G subunit
PA380	8912	CACNA1H	chr16	1193241	1274772	81531	calcium channel, voltage-dependent, T type, alpha 1H subunit
PA26011	8911	CACNA1I	chr22	39956758	40088740	131982	calcium channel, voltage-dependent, T type, alpha 1I subunit
PA85	779	CACNA1S	chr1	201005635	201091694	86059	calcium channel, voltage-dependent, L type, alpha 1S subunit
PA86	781	CACNA2D1	chr7	81572760	82083031	510271	calcium channel, voltage-dependent, alpha 2/delta subunit 1
PA26012	9254	CACNA2D2	chr3	50397230	50550892	153662	calcium channel, voltage-dependent, alpha 2/delta subunit 2
PA26013	55799	CACNA2D3	chr3	54146620	55111584	964964	calcium channel, voltage-dependent, alpha 2/delta subunit 3
PA130546913	93589	CACNA2D4	chr12	1898123	2037870	139747	calcium channel, voltage-dependent, alpha 2/delta subunit 4
PA87	782	CACNB1	chr17	37326709	37363956	37247	calcium channel, voltage-dependent, beta 1 subunit
PA88	783	CACNB2	chr10	18419373	18833688	414315	calcium channel, voltage-dependent, beta 2 subunit
PA89	784	CACNB3	chr12	49198215	49225726	27511	calcium channel, voltage-dependent, beta 3 subunit
PA26014	785	CACNB4	chr2	152686285	152965593	279308	calcium channel, voltage-dependent, beta 4 subunit
PA26015	786	CACNG1	chr17	65030652	65055913	25261	calcium channel, voltage-dependent, gamma subunit 1
PA26016	10369	CACNG2	chr22	36953916	37108690	154774	calcium channel, voltage-dependent, gamma subunit 2
PA26017	10368	CACNG3	chr16	24256874	24376737	119863	calcium channel, voltage-dependent, gamma subunit 3
PA26018	27092	CACNG4	chr17	64950980	65032518	81538	calcium channel, voltage-dependent, gamma subunit 4
PA26019	27091	CACNG5	chr17	64821235	64884941	63706	calcium channel, voltage-dependent, gamma subunit 5
PA26020	59285	CACNG6	chr19	54484403	54518920	34517	calcium channel, voltage-dependent, gamma subunit 6
PA26021	59284	CACNG7	chr19	54402704	54450195	47491	calcium channel, voltage-dependent, gamma subunit 7
PA26022	59283	CACNG8	chr19	54456290	54496469	40179	calcium channel, voltage-dependent, gamma subunit 8
PA134932683	58509	CACTIN	chr19	3607626	3636813	29187	cactin, spliceosome C complex subunit
PA134869023	143384	CACUL1	chr10	120430679	120524758	94079	CDK2-associated, cullin domain 1
PA134894213	27101	CACYBP	chr1	174958571	174984163	25592	calcyclin binding protein
PA26023	790	CAD	chr2	27430258	27469660	39402	carbamoyl-phosphate synthetase 2, aspartate transcarbamylase, and dihydroorotase
PA29764	23705	CADM1	chr11	115036933	115385241	348308	cell adhesion molecule 1
PA162380882	253559	CADM2	chr3	84998133	86126579	1128446	cell adhesion molecule 2
PA162380906	57863	CADM3	chr1	159131377	159175932	44555	cell adhesion molecule 3
PA162380931	199731	CADM4	chr19	44123519	44153991	30472	cell adhesion molecule 4
PA26024	8618	CADPS	chr3	62381021	62871064	490043	Ca++-dependent secretion activator
PA26025	93664	CADPS2	chr7	121955478	122536813	581335	Ca++-dependent secretion activator 2
PA134933951	285782	CAGE1	chr6	7323887	7399976	76089	cancer antigen 1
PA26026	793	CALB1	chr8	91067836	91105107	37271	calbindin 1, 28kDa
PA26027	794	CALB2	chr16	71382616	71427341	44725	calbindin 2
PA26029	796	CALCA	chr11	14985214	15003879	18665	calcitonin-related polypeptide alpha
PA26030	797	CALCB	chr11	15085143	15106888	21745	calcitonin-related polypeptide beta
PA128394699	57658	CALCOCO1	chr12	54101902	54131307	29405	calcium binding and coiled-coil domain 1
PA143485407	10241	CALCOCO2	chr17	46898350	46945607	47257	calcium binding and coiled-coil domain 2
PA26032	799	CALCR	chr7	93050799	93214042	163243	calcitonin receptor
PA26033	10203	CALCRL	chr2	188203690	188323021	119331	calcitonin receptor-like
PA26034	800	CALD1	chr7	134454164	134658480	204316	caldesmon 1
PA162380954	255022	CALHM1	chr10	105210144	105228648	18504	calcium homeostasis modulator 1
PA162380963	51063	CALHM2	chr10	105203543	105222162	18619	calcium homeostasis modulator 2
PA162380976	119395	CALHM3	chr10	105229561	105248997	19436	calcium homeostasis modulator 3
PA26035	801	CALM1	chr14	90853327	90877619	24292	calmodulin 1 (phosphorylase kinase, delta)
PA26038	805	CALM2	chr2	47384221	47414229	30008	calmodulin 2 (phosphorylase kinase, delta)
PA26042	808	CALM3	chr19	47094512	47117039	22527	calmodulin 3 (phosphorylase kinase, delta)
PA26044	810	CALML3	chr10	5556924	5571231	14307	calmodulin-like 3
PA134903345	91860	CALML4	chr15	68480043	68508448	28405	calmodulin-like 4
PA134862009	51806	CALML5	chr10	5537658	5551533	13875	calmodulin-like 5
PA134968051	163688	CALML6	chr1	1836266	1851733	15467	calmodulin-like 6
PA26045	83698	CALN1	chr7	71241476	71922136	680660	calneuron 1
PA26046	811	CALR	chr19	13039414	13058304	18890	calreticulin
PA134922944	125972	CALR3	chr19	16586767	16617015	30248	calreticulin 3
PA26047	813	CALU	chr7	128369346	128416477	47131	calumenin
PA162380987	50632	CALY	chr10	135135928	135160482	24554	calcyon neuron-specific vesicular protein
PA26048	8536	CAMK1	chr3	9796029	9821676	25647	calcium/calmodulin-dependent protein kinase I
PA134992438	57118	CAMK1D	chr10	12381583	12874735	493152	calcium/calmodulin-dependent protein kinase ID
PA26049	57172	CAMK1G	chr1	209747045	209790284	43239	calcium/calmodulin-dependent protein kinase IG
PA90	815	CAMK2A	chr5	149596054	149679403	83349	calcium/calmodulin-dependent protein kinase II alpha
PA91	816	CAMK2B	chr7	44253749	44375230	121481	calcium/calmodulin-dependent protein kinase II beta
PA92	817	CAMK2D	chr4	114369188	114693669	324481	calcium/calmodulin-dependent protein kinase II delta
PA93	818	CAMK2G	chr10	75569259	75644349	75090	calcium/calmodulin-dependent protein kinase II gamma
PA142672209	55450	CAMK2N1	chr1	20805884	20822728	16844	calcium/calmodulin-dependent protein kinase II inhibitor 1
PA142672210	94032	CAMK2N2	chr3	183974003	183989251	15248	calcium/calmodulin-dependent protein kinase II inhibitor 2
PA26050	814	CAMK4	chr5	110549947	110833584	283637	calcium/calmodulin-dependent protein kinase IV
PA26051	84254	CAMKK1	chr17	3760609	3806337	45728	calcium/calmodulin-dependent protein kinase kinase 1, alpha
PA26052	10645	CAMKK2	chr12	121672495	121746111	73616	calcium/calmodulin-dependent protein kinase kinase 2, beta
PA142672380	79823	CAMKMT	chr2	44579043	45002731	423688	calmodulin-lysine N-methyltransferase
PA142672205	79012	CAMKV	chr3	49892414	49917655	25241	CaM kinase-like vesicle-associated
PA26053	819	CAMLG	chr5	134064170	134090850	26680	calcium modulating ligand
PA26054	820	CAMP	chr3	48254837	48269981	15144	cathelicidin antimicrobial peptide
PA134866541	157922	CAMSAP1	chr9	138697333	138809060	111727	calmodulin regulated spectrin-associated protein 1
PA142672206	23271	CAMSAP2	chr1	200698686	200832832	134146	calmodulin regulated spectrin-associated protein family, member 2
PA134885087	57662	CAMSAP3	chr19	7650774	7686196	35422	calmodulin regulated spectrin-associated protein family, member 3
PA38688	23261	CAMTA1	chr1	6835384	7832766	997382	calmodulin binding transcription activator 1
PA38689	23125	CAMTA2	chr17	4868287	4900960	32673	calmodulin binding transcription activator 2
PA142672207	55832	CAND1	chr12	67653061	67711388	58327	cullin-associated and neddylation-dissociated 1
PA142672208	23066	CAND2	chr3	12828171	12879313	51142	cullin-associated and neddylation-dissociated 2 (putative)
PA134984439	124583	CANT1	chr17	76984798	77015899	31101	calcium activated nucleotidase 1
PA26055	821	CANX	chr5	179115019	179161642	46623	calnexin
PA399	10487	CAP1	chr1	40495912	40541321	45409	CAP, adenylate cyclase-associated protein 1 (yeast)
PA134989437	10486	CAP2	chr6	17383447	17561023	177576	CAP, adenylate cyclase-associated protein, 2 (yeast)
PA26056	822	CAPG	chr2	85618871	85651197	32326	capping protein (actin filament), gelsolin-like
PA26057	823	CAPN1	chr11	64938686	64982477	43791	calpain 1, (mu/I) large subunit
PA26058	11132	CAPN10	chr2	241516133	241541526	25393	calpain 10
PA26059	11131	CAPN11	chr6	44116548	44155139	38591	calpain 11
PA134863447	147968	CAPN12	chr19	39217832	39245114	27282	calpain 12
PA134931170	92291	CAPN13	chr2	30942637	31040383	97746	calpain 13
PA134888839	440854	CAPN14	chr2	31392922	31466724	73802	calpain 14
PA36019	6650	CAPN15	chr16	567816	607636	39820	calpain 15
PA26060	824	CAPN2	chr1	223879295	223966720	87425	calpain 2, (m/II) large subunit
PA26061	825	CAPN3	chr15	42636545	42707515	70970	calpain 3, (p94)
PA26062	726	CAPN5	chr11	76767992	76840201	72209	calpain 5
PA26063	827	CAPN6	chrX	110485327	110523774	38447	calpain 6
PA26064	23473	CAPN7	chr3	15237733	15297423	59690	calpain 7
PA26065	388743	CAPN8	chr1	223711972	223863436	151464	calpain 8
PA26066	10753	CAPN9	chr1	230873089	230940749	67660	calpain 9
PA26067	826	CAPNS1	chr19	36620918	36644255	23337	calpain, small subunit 1
PA134873146	84290	CAPNS2	chr16	55590584	55604592	14008	calpain, small subunit 2
PA30508	4076	CAPRIN1	chr11	34063230	34127157	63927	cell cycle associated protein 1
PA162381044	65981	CAPRIN2	chr12	30859486	30917448	57962	caprin family member 2
PA26068	828	CAPS	chr19	5903659	5919222	15563	calcyphosine
PA38405	84698	CAPS2	chr12	75666759	75794681	127922	calcyphosine 2
PA142672204	133690	CAPSL	chr5	35901397	35948881	47484	calcyphosine-like
PA26069	829	CAPZA1	chr1	113152075	113217241	65166	capping protein (actin filament) muscle Z-line, alpha 1
PA26071	830	CAPZA2	chr7	116492533	116562315	69782	capping protein (actin filament) muscle Z-line, alpha 2
PA134990260	93661	CAPZA3	chr12	18881045	18895122	14077	capping protein (actin filament) muscle Z-line, alpha 3
PA26072	832	CAPZB	chr1	19662267	19822066	159799	capping protein (actin filament) muscle Z-line, beta
PA134927444	29775	CARD10	chr22	37883400	37925543	42143	caspase recruitment domain family, member 10
PA26073	84433	CARD11	chr7	2942709	3093579	150870	caspase recruitment domain family, member 11
PA134959119	79092	CARD14	chr17	78133791	78186130	52339	caspase recruitment domain family, member 14
PA164717628	114769	CARD16	chr11	104909053	104926051	16998	caspase recruitment domain family, member 16
PA164717641	440068	CARD17	chr11	104960196	104982158	21962	caspase recruitment domain family, member 17
PA164717642	59082	CARD18	chr11	105005448	105020461	15013	caspase recruitment domain family, member 18
PA26076	84674	CARD6	chr5	40831410	40858456	27046	caspase recruitment domain family, member 6
PA134916154	22900	CARD8	chr19	48708343	48769203	60860	caspase recruitment domain family, member 8
PA26077	64170	CARD9	chr9	139255408	139278133	22725	caspase recruitment domain family, member 9
PA24748	79800	CARF	chr2	203766978	203854060	87082	calcium responsive transcription factor
PA38440	23589	CARHSP1	chr16	8943799	8972869	29070	calcium regulated heat stable protein 1, 24kDa
PA164717652	55739	CARKD	chr13	111257807	111295343	37536	carbohydrate kinase domain containing
PA134959553	10498	CARM1	chr19	10972253	11036453	64200	coactivator-associated arginine methyltransferase 1
PA165543288	57571	CARNS1	chr11	67173149	67196078	22929	carnosine synthase 1
PA26079	833	CARS	chr11	3019152	3088681	69529	cysteinyl-tRNA synthetase
PA162381083	79587	CARS2	chr13	111290757	111368480	77723	cysteinyl-tRNA synthetase 2, mitochondrial (putative)
PA162381084	9607	CARTPT	chr5	71004990	71019875	14885	CART prepropeptide
PA134895953	55259	CASC1	chr12	25258223	25358096	99873	cancer susceptibility candidate 1
PA134922846	399726	CASC10	chr10	21780421	21796213	15792	cancer susceptibility candidate 10
PA134948596	22794	CASC3	chr17	38286507	38331431	44924	cancer susceptibility candidate 3
PA142672200	113201	CASC4	chr15	44570909	44710959	140050	cancer susceptibility candidate 4
PA142672201	57082	CASC5	chr15	40876447	40957881	81434	cancer susceptibility candidate 5
PA143485408	64921	CASD1	chr7	94128838	94189331	60493	CAS1 domain containing 1
PA26081	8573	CASK	chrX	41371187	41792415	421228	calcium/calmodulin-dependent serine protein kinase (MAGUK family)
PA134878267	57524	CASKIN1	chr16	2224184	2256479	32295	CASK interacting protein 1
PA134944093	57513	CASKIN2	chr17	73493341	73521664	28323	CASK interacting protein 2
PA26083	834	CASP1	chr11	104893235	104915884	22649	caspase 1, apoptosis-related cysteine peptidase
PA26084	843	CASP10	chr2	202037621	202097129	59508	caspase 10, apoptosis-related cysteine peptidase
PA38776	100506742	CASP12	chr11	104753445	104779397	25952	caspase 12 (gene/pseudogene)
PA26085	23581	CASP14	chr19	15150291	15172104	21813	caspase 14, apoptosis-related cysteine peptidase
PA26086	835	CASP2	chr7	142975308	143007789	32481	caspase 2, apoptosis-related cysteine peptidase
PA26087	836	CASP3	chr4	185545850	185580629	34779	caspase 3, apoptosis-related cysteine peptidase
PA26088	837	CASP4	chr11	104810594	104849325	38731	caspase 4, apoptosis-related cysteine peptidase
PA26089	838	CASP5	chr11	104861967	104903895	41928	caspase 5, apoptosis-related cysteine peptidase
PA26090	839	CASP6	chr4	110606785	110639814	33029	caspase 6, apoptosis-related cysteine peptidase
PA26091	840	CASP7	chr10	115428921	115493668	64747	caspase 7, apoptosis-related cysteine peptidase
PA26092	841	CASP8	chr2	202088166	202155434	67268	caspase 8, apoptosis-related cysteine peptidase
PA26093	9994	CASP8AP2	chr6	90529619	90587155	57536	caspase 8 associated protein 2
PA26094	842	CASP9	chr1	15814896	15861407	46511	caspase 9, apoptosis-related cysteine peptidase
PA26095	844	CASQ1	chr1	160150285	160174676	24391	calsequestrin 1 (fast-twitch, skeletal muscle)
PA26096	845	CASQ2	chr1	116239624	116321426	81802	calsequestrin 2 (cardiac muscle)
PA26097	846	CASR	chr3	121892530	122008350	115820	calcium-sensing receptor
PA162381095	57091	CASS4	chr20	54977168	55037396	60228	Cas scaffolding protein family member 4
PA26098	831	CAST	chr5	95987741	96113387	125646	calpastatin
PA142672203	54897	CASZ1	chr1	10693661	10866733	173072	castor zinc finger 1
PA26099	847	CAT	chr11	34450472	34496607	46135	catalase
PA162379334	375307	CATIP	chr2	219211579	219235817	24238	ciliogenesis associated TTC17 interacting protein
PA38438	117144	CATSPER1	chr11	65781223	65803988	22765	cation channel, sperm associated 1
PA38691	117155	CATSPER2	chr15	43919772	43951039	31267	cation channel, sperm associated 2
PA134911185	347732	CATSPER3	chr5	134293596	134350397	56801	cation channel, sperm associated 3
PA134941696	378807	CATSPER4	chr1	26507119	26532033	24914	cation channel, sperm associated 4
PA162381112	79820	CATSPERB	chr14	92043728	92208413	164685	catsper channel auxiliary subunit beta
PA144596254	257062	CATSPERD	chr19	5710688	5781742	71054	catsper channel auxiliary subunit delta
PA165393235	57828	CATSPERG	chr19	38816443	38864589	48146	catsper channel auxiliary subunit gamma
PA26107	857	CAV1	chr7	116154839	116204239	49400	caveolin 1, caveolae protein, 22kDa
PA26108	858	CAV2	chr7	116129655	116151595	21940	caveolin 2
PA26109	859	CAV3	chr3	8765486	8791451	25965	caveolin 3
PA26112	9139	CBFA2T2	chr20	32067928	32240837	172909	core-binding factor, runt domain, alpha subunit 2; translocated to, 2
PA26113	863	CBFA2T3	chr16	88938263	89053568	115305	core-binding factor, runt domain, alpha subunit 2; translocated to, 3
PA26114	865	CBFB	chr16	67053050	67137961	84911	core-binding factor, beta subunit
PA26115	867	CBL	chr11	119066986	119181859	114873	Cbl proto-oncogene, E3 ubiquitin protein ligase
PA26116	868	CBLB	chr3	105371306	105599354	228048	Cbl proto-oncogene B, E3 ubiquitin protein ligase
PA26117	23624	CBLC	chr19	45271126	45306903	35777	Cbl proto-oncogene C, E3 ubiquitin protein ligase
PA134960329	79872	CBLL1	chr7	107373942	107405112	31170	Cbl proto-oncogene-like 1, E3 ubiquitin protein ligase
PA26118	869	CBLN1	chr16	49308828	49325742	16914	cerebellin 1 precursor
PA26119	147381	CBLN2	chr18	70200915	70221723	20808	cerebellin 2 precursor
PA134885212	643866	CBLN3	chr14	24892738	24908731	15993	cerebellin 3 precursor
PA26120	140689	CBLN4	chr20	54569413	54590528	21115	cerebellin 4 precursor
PA26121	873	CBR1	chr21	37432285	37448462	16177	carbonyl reductase 1
PA26122	874	CBR3	chr21	37496614	37521860	25246	carbonyl reductase 3
PA144596471	84869	CBR4	chr4	169812774	169941468	128694	carbonyl reductase 4
PA26123	875	CBS	chr21	44470301	44506472	36171	cystathionine-beta-synthase
PA26124	55871	CBWD1	chr9	118038	189077	71039	COBW domain containing 1
PA26125	150472	CBWD2	chr2	114185268	114256781	71513	COBW domain containing 2
PA134863724	445571	CBWD3	chr9	70846839	70917932	71093	COBW domain containing 3
PA142672196	220869	CBWD5	chr9	70429004	70500171	71167	COBW domain containing 5
PA145149332	644019	CBWD6	chr9	69201538	69272593	71055	COBW domain containing 6
PA145149368	728013	CBWD7	chr9	42661901	42717961	56060	COBW domain containing 7
PA26126	10951	CBX1	chr17	46144414	46188883	44469	chromobox homolog 1
PA26127	84733	CBX2	chr17	77741977	77764449	22472	chromobox homolog 2
PA26128	11335	CBX3	chr7	26230831	26256227	25396	chromobox homolog 3
PA26129	8535	CBX4	chr17	77803955	77823222	19267	chromobox homolog 4
PA26130	23468	CBX5	chr12	54621730	54683915	62185	chromobox homolog 5
PA26131	23466	CBX6	chr22	39254468	39278258	23790	chromobox homolog 6
PA26132	23492	CBX7	chr22	39523777	39558661	34884	chromobox homolog 7
PA26133	57332	CBX8	chr17	77765176	77780915	15739	chromobox homolog 8
PA25886	25776	CBY1	chr22	39042658	39072859	30201	chibby homolog 1 (Drosophila)
PA162381185	646019	CBY3	chr5	179102559	179117975	15416	chibby homolog 3 (Drosophila)
PA142672197	54862	CC2D1A	chr19	14006956	14044693	37737	coiled-coil and C2 domain containing 1A
PA142672198	200014	CC2D1B	chr1	52813265	52841877	28612	coiled-coil and C2 domain containing 1B
PA162381194	57545	CC2D2A	chr4	15461489	15606594	145105	coiled-coil and C2 domain containing 2A
PA162381273	387707	CC2D2B	chr10	97711331	97796496	85165	coiled-coil and C2 domain containing 2B
PA134920227	55749	CCAR1	chr10	70470956	70555134	84178	cell division cycle and apoptosis regulator 1
PA134993792	57805	CCAR2	chr8	22452145	22480984	28839	cell cycle and apoptosis regulator 2
PA134880094	147372	CCBE1	chr18	57095171	57374860	279689	collagen and calcium binding EGF domains 1
PA26138	883	CCBL1	chr9	131592392	131654354	61962	cysteine conjugate-beta lyase, cytoplasmic
PA162381274	56267	CCBL2	chr1	89398456	89468643	70187	cysteine conjugate-beta lyase 2
PA144596468	112869	CCDC101	chr16	28555249	28606111	50862	coiled-coil domain containing 101
PA144596469	92922	CCDC102A	chr16	57543090	57580477	37387	coiled-coil domain containing 102A
PA134948675	79839	CCDC102B	chr18	66372466	66759517	387051	coiled-coil domain containing 102B
PA145008596	388389	CCDC103	chr17	42967080	42986541	19461	coiled-coil domain containing 103
PA145008634	126402	CCDC105	chr19	15111539	15137083	25544	coiled-coil domain containing 105
PA145008652	29903	CCDC106	chr19	56148934	56167527	18593	coiled-coil domain containing 106
PA145008668	203260	CCDC107	chr9	35648279	35664500	16221	coiled-coil domain containing 107
PA145008681	255101	CCDC108	chr2	219864568	219916273	51705	coiled-coil domain containing 108
PA145008731	55013	CCDC109B	chr4	110471355	110611872	140517	coiled-coil domain containing 109B
PA162381283	256309	CCDC110	chr4	186363336	186402913	39577	coiled-coil domain containing 110
PA145008783	153733	CCDC112	chr5	114599885	114642458	42573	coiled-coil domain containing 112
PA145149245	29070	CCDC113	chr16	58273840	58320740	46900	coiled-coil domain containing 113
PA145149267	93233	CCDC114	chr19	48796709	48835191	38482	coiled-coil domain containing 114
PA145149287	84317	CCDC115	chr2	131092814	131110383	17569	coiled-coil domain containing 115
PA145149301	164592	CCDC116	chr22	21977086	21994616	17530	coiled-coil domain containing 116
PA145149315	150275	CCDC117	chr22	29158662	29188283	29621	coiled-coil domain containing 117
PA134970849	151903	CCDC12	chr3	46960220	47033500	73280	coiled-coil domain containing 12
PA145149329	90060	CCDC120	chrX	48900961	48930510	29549	coiled-coil domain containing 120
PA147358222	79635	CCDC121	chr2	27845408	27861898	16490	coiled-coil domain containing 121
PA147358230	160857	CCDC122	chr13	44407488	44463826	56338	coiled-coil domain containing 122
PA147358292	115098	CCDC124	chr19	18033824	18057794	23970	coiled-coil domain containing 124
PA147358306	202243	CCDC125	chr5	68573519	68638623	65104	coiled-coil domain containing 125
PA162381284	90693	CCDC126	chr7	23626998	23687327	60329	coiled-coil domain containing 126
PA162381297	133957	CCDC127	chr5	201875	228333	26458	coiled-coil domain containing 127
PA162381298	223075	CCDC129	chr7	31543685	31701334	157649	coiled-coil domain containing 129
PA134974073	152206	CCDC13	chr3	42746764	42824745	77981	coiled-coil domain containing 13
PA162381331	81576	CCDC130	chr19	13832574	13877108	44534	coiled-coil domain containing 130
PA162381332	55610	CCDC132	chr7	92851653	92993435	141782	coiled-coil domain containing 132
PA162381361	79879	CCDC134	chr22	42186636	42231175	44539	coiled-coil domain containing 134
PA162381381	64753	CCDC136	chr7	128421464	128465187	43723	coiled-coil domain containing 136
PA162381422	339230	CCDC137	chr17	79623761	79643937	20176	coiled-coil domain containing 137
PA162381439	165055	CCDC138	chr2	109393208	109496047	102839	coiled-coil domain containing 138
PA134990564	64770	CCDC14	chr3	123613152	123690255	77103	coiled-coil domain containing 14
PA162381440	151278	CCDC140	chr2	223152866	223172936	20070	coiled-coil domain containing 140
PA162381449	285025	CCDC141	chr2	179691484	179924841	233357	coiled-coil domain containing 141
PA162381450	84865	CCDC142	chr2	74696959	74720357	23398	coiled-coil domain containing 142
PA162381473	9720	CCDC144A	chr17	16583549	16681311	97762	coiled-coil domain containing 144A
PA162381474	284047	CCDC144B	chr17	18438114	18538930	100816	coiled-coil domain containing 144B (pseudogene)
PA164717677	339184	CCDC144NL	chr17	20763708	20809453	45745	coiled-coil domain containing 144 family, N-terminal like
PA162381475	57639	CCDC146	chr7	76741934	76927534	185600	coiled-coil domain containing 146
PA162381559	130940	CCDC148	chr2	159024869	159323297	298428	coiled-coil domain containing 148
PA162381560	91050	CCDC149	chr4	24804739	24991826	187087	coiled-coil domain containing 149
PA142672175	80071	CCDC15	chr11	124814017	124914385	100368	coiled-coil domain containing 15
PA162381583	284992	CCDC150	chr2	197494278	197600530	106252	coiled-coil domain containing 150
PA162381584	115948	CCDC151	chr19	11528272	11556853	28581	coiled-coil domain containing 151
PA162381615	100129792	CCDC152	chr5	42746920	42805539	58619	coiled-coil domain containing 152
PA162381639	283152	CCDC153	chr11	119057963	119082160	24197	coiled-coil domain containing 153
PA162381640	645811	CCDC154	chr16	1481389	1504490	23101	coiled-coil domain containing 154
PA162381684	147872	CCDC155	chr19	49881475	49924256	42781	coiled-coil domain containing 155
PA164717678	550631	CCDC157	chr22	30742627	30775818	33191	coiled-coil domain containing 157
PA164717707	339965	CCDC158	chr4	77231192	77343285	112093	coiled-coil domain containing 158
PA165393298	126075	CCDC159	chr19	11447160	11468620	21460	coiled-coil domain containing 159
PA165756450	347475	CCDC160	chrX	133361077	133383237	22160	coiled-coil domain containing 160
PA134874211	221262	CCDC162P	chr6	109605506	109632423	26917	coiled-coil domain containing 162, pseudogene
PA134900129	154467	CCDC167	chr6	37447696	37477700	30004	coiled-coil domain containing 167
PA165505081	643677	CCDC168	chr13	103378717	103421422	42705	coiled-coil domain containing 168
PA162378105	728591	CCDC169	chr13	36798179	36881992	83813	coiled-coil domain containing 169
PA142672177	149483	CCDC17	chr1	46082716	46100424	17708	coiled-coil domain containing 17
PA134876442	80129	CCDC170	chr6	151805175	151945328	140153	coiled-coil domain containing 170
PA134921892	203238	CCDC171	chr9	15542872	15974897	432025	coiled-coil domain containing 171
PA134867240	374355	CCDC172	chr10	118073940	118142541	68601	coiled-coil domain containing 172
PA162379577	129881	CCDC173	chr2	170498935	170560931	61996	coiled-coil domain containing 173
PA134914840	51244	CCDC174	chr3	14683253	14717166	33913	coiled-coil domain containing 174
PA134933838	729665	CCDC175	chr14	59968785	60053549	84764	coiled-coil domain containing 175
PA134886442	80127	CCDC176	chr14	74476054	74535795	59741	coiled-coil domain containing 176
PA134979792	374864	CCDC178	chr18	30514225	31030685	516460	coiled-coil domain containing 178
PA142672178	343099	CCDC18	chr1	93636038	93747769	111731	coiled-coil domain containing 18
PA165585576	100499483	CCDC180	chr9	100059910	100142577	82667	coiled-coil domain containing 180
PA142672498	57821	CCDC181	chr1	169361108	169439907	78799	coiled-coil domain containing 181
PA134944889	84960	CCDC183	chr9	139680790	139705193	24403	coiled-coil domain containing 183
PA162377998	387856	CCDC184	chr12	48567366	48582709	15343	coiled-coil domain containing 184
PA142672515	164127	CCDC185	chr1	223556715	223571812	15097	coiled-coil domain containing 185
PA134904295	55088	CCDC186	chr10	115878974	115944364	65390	coiled-coil domain containing 186
PA134947763	28952	CCDC22	chrX	49081927	49109987	28060	coiled-coil domain containing 22
PA142672181	374969	CCDC23	chr1	43269723	43293059	23336	coiled-coil domain containing 23
PA142672182	149473	CCDC24	chr1	44447280	44465200	17920	coiled-coil domain containing 24
PA142672183	55246	CCDC25	chr8	27587833	27640170	52337	coiled-coil domain containing 25
PA142672185	148870	CCDC27	chr1	3658965	3691209	32244	coiled-coil domain containing 27
PA134939277	25901	CCDC28A	chr6	139084657	139117456	32799	coiled-coil domain containing 28A
PA142672186	79140	CCDC28B	chr1	32656202	32673991	17789	coiled-coil domain containing 28B
PA134863738	83643	CCDC3	chr10	12935625	13151762	216137	coiled-coil domain containing 3
PA165750513	728621	CCDC30	chr1	42990560	43123335	132775	coiled-coil domain containing 30
PA142672188	80125	CCDC33	chr15	74518630	74631813	113183	coiled-coil domain containing 33
PA142672189	91057	CCDC34	chr11	27357061	27394795	37734	coiled-coil domain containing 34
PA142672191	339834	CCDC36	chr3	49225861	49298636	72775	coiled-coil domain containing 36
PA142672192	348807	CCDC37	chr3	126103751	126158399	54648	coiled-coil domain containing 37
PA142672193	120935	CCDC38	chr12	96257826	96346428	88602	coiled-coil domain containing 38
PA142672194	339829	CCDC39	chr3	180328360	180407300	78940	coiled-coil domain containing 39
PA142672195	55036	CCDC40	chr17	78000431	78077412	76981	coiled-coil domain containing 40
PA142672159	146849	CCDC42	chr17	8630246	8658154	27908	coiled-coil domain containing 42
PA165512456	387885	CCDC42B	chr12	113577543	113600081	22538	coiled-coil domain containing 42B
PA142672160	124808	CCDC43	chr17	42751805	42777355	25550	coiled-coil domain containing 43
PA142672164	57003	CCDC47	chr17	61819610	61861088	41478	coiled-coil domain containing 47
PA25902	152137	CCDC50	chr3	191036874	191119459	82585	coiled-coil domain containing 50
PA142672167	79714	CCDC51	chr3	48470580	48491529	20949	coiled-coil domain containing 51
PA142672169	51019	CCDC53	chr12	102403717	102465902	62185	coiled-coil domain containing 53
PA142672170	84692	CCDC54	chr3	107086188	107100481	14293	coiled-coil domain containing 54
PA142672173	284001	CCDC57	chr17	80056333	80180705	124372	coiled-coil domain containing 57
PA143485410	131076	CCDC58	chr3	122075436	122112074	36638	coiled-coil domain containing 58
PA143485412	29080	CCDC59	chr12	82743083	82762584	19501	coiled-coil domain containing 59
PA134904022	8030	CCDC6	chr10	61545505	61676414	130909	coiled-coil domain containing 6
PA143485413	160777	CCDC60	chr12	119762517	119981852	219335	coiled-coil domain containing 60
PA162381685	729440	CCDC61	chr19	46488719	46524874	36155	coiled-coil domain containing 61
PA143485414	84660	CCDC62	chr12	123249056	123314927	65871	coiled-coil domain containing 62
PA143485415	160762	CCDC63	chr12	111274757	111348339	73582	coiled-coil domain containing 63
PA143485416	92558	CCDC64	chr12	120417648	120535299	117651	coiled-coil domain containing 64
PA162381686	146439	CCDC64B	chr16	3074683	3096950	22267	coiled-coil domain containing 64B
PA143485417	85478	CCDC65	chr12	49287893	49328696	40803	coiled-coil domain containing 65
PA143485418	285331	CCDC66	chr3	56581184	56658864	77680	coiled-coil domain containing 66
PA143485419	159989	CCDC67	chr11	93053156	93174636	121480	coiled-coil domain containing 67
PA143485420	80323	CCDC68	chr18	52565740	52636739	70999	coiled-coil domain containing 68
PA128394640	26112	CCDC69	chr5	150557613	150613654	56041	coiled-coil domain containing 69
PA134879457	79741	CCDC7	chr10	32725041	32866492	141451	coiled-coil domain containing 7
PA143485421	83446	CCDC70	chr13	52426117	52443372	17255	coiled-coil domain containing 70
PA143485422	64925	CCDC71	chr3	49196968	49213785	16817	coiled-coil domain containing 71
PA143485424	493860	CCDC73	chr11	32620626	32826204	205578	coiled-coil domain containing 73
PA143485425	90557	CCDC74A	chr2	132275248	132294239	18991	coiled-coil domain containing 74A
PA143485426	91409	CCDC74B	chr2	130893856	130912707	18851	coiled-coil domain containing 74B
PA143485429	84318	CCDC77	chr12	488516	554811	66295	coiled-coil domain containing 77
PA25539	124093	CCDC78	chr16	769582	786880	17298	coiled-coil domain containing 78
PA162381709	283847	CCDC79	chr16	66785879	66845523	59644	coiled-coil domain containing 79
PA134931534	83987	CCDC8	chr19	46910586	46926919	16333	coiled-coil domain containing 8
PA144596470	151887	CCDC80	chr3	112320407	112369977	49570	coiled-coil domain containing 80
PA128394704	60494	CCDC81	chr11	86075778	86137151	61373	coiled-coil domain containing 81
PA143485431	79780	CCDC82	chr11	96082929	96133083	50154	coiled-coil domain containing 82
PA144596450	220047	CCDC83	chr11	85556144	85634064	77920	coiled-coil domain containing 83
PA144596451	338657	CCDC84	chr11	118858843	118889455	30612	coiled-coil domain containing 84
PA144596452	114800	CCDC85A	chr2	56401258	56616309	215051	coiled-coil domain containing 85A
PA144596453	11007	CCDC85B	chr11	65647875	65662106	14231	coiled-coil domain containing 85B
PA164717760	317762	CCDC85C	chr14	99974603	100080727	106124	coiled-coil domain containing 85C
PA144596454	79080	CCDC86	chr11	60599429	60621561	22132	coiled-coil domain containing 86
PA144596455	55231	CCDC87	chr11	66354640	66370554	15914	coiled-coil domain containing 87
PA162381751	55704	CCDC88A	chr2	55511978	55657057	145079	coiled-coil domain containing 88A
PA162381820	283234	CCDC88B	chr11	64097690	64128006	30316	coiled-coil domain containing 88B
PA162381879	440193	CCDC88C	chr14	91734667	91894188	159521	coiled-coil domain containing 88C
PA144596457	220388	CCDC89	chr11	85391893	85407320	15427	coiled-coil domain containing 89
PA134946561	26093	CCDC9	chr19	47749731	47780329	30598	coiled-coil domain containing 9
PA162381967	60492	CCDC90B	chr11	82969498	83007445	37947	coiled-coil domain containing 90B
PA144596458	55297	CCDC91	chr12	28333360	28706099	372739	coiled-coil domain containing 91
PA144596459	80212	CCDC92	chr12	124417955	124467373	49418	coiled-coil domain containing 92
PA144596460	54520	CCDC93	chr2	118670054	118781739	111685	coiled-coil domain containing 93
PA144596461	55702	CCDC94	chr19	4237111	4272085	34974	coiled-coil domain containing 94
PA144596463	257236	CCDC96	chr4	7039576	7054728	15152	coiled-coil domain containing 96
PA144596464	90324	CCDC97	chr19	41806094	41833788	27694	coiled-coil domain containing 97
PA142672294	196477	CCER1	chr12	91342992	91358953	15961	coiled-coil glutamate-rich protein 1
PA134942738	54535	CCHCR1	chr6	31107216	31136015	28799	coiled-coil alpha-helical rod protein 1
PA26140	881	CCIN	chr9	36155990	36174331	18341	calicin
PA26141	885	CCK	chr3	42296315	42317662	21347	cholecystokinin
PA26142	886	CCKAR	chr4	26480018	26502042	22024	cholecystokinin A receptor
PA26143	887	CCKBR	chr11	6270841	6296363	25522	cholecystokinin B receptor
PA35542	6346	CCL1	chr17	32684347	32700252	15905	chemokine (C-C motif) ligand 1
PA35543	6356	CCL11	chr17	32602687	32618199	15512	chemokine (C-C motif) ligand 11
PA35544	6357	CCL13	chr17	32673471	32688629	15158	chemokine (C-C motif) ligand 13
PA35545	6358	CCL14	chr17	34307692	34323764	16072	chemokine (C-C motif) ligand 14
PA35546	6359	CCL15	chr17	34320476	34339084	18608	chemokine (C-C motif) ligand 15
PA35547	6360	CCL16	chr17	34300529	34320373	19844	chemokine (C-C motif) ligand 16
PA35548	6361	CCL17	chr16	57428679	57452974	24295	chemokine (C-C motif) ligand 17
PA35549	6362	CCL18	chr17	34381643	34401841	20198	chemokine (C-C motif) ligand 18 (pulmonary and activation-regulated)
PA35550	6363	CCL19	chr9	34686567	34701274	14707	chemokine (C-C motif) ligand 19
PA130413151	6347	CCL2	chr17	32572296	32587222	14926	chemokine (C-C motif) ligand 2
PA35551	6364	CCL20	chr2	228668558	228685280	16722	chemokine (C-C motif) ligand 20
PA35552	6366	CCL21	chr9	34706002	34720164	14162	chemokine (C-C motif) ligand 21
PA35553	6367	CCL22	chr16	57382695	57403102	20407	chemokine (C-C motif) ligand 22
PA35554	6368	CCL23	chr17	34337096	34355005	17909	chemokine (C-C motif) ligand 23
PA35555	6369	CCL24	chr7	75437766	75462674	24908	chemokine (C-C motif) ligand 24
PA35556	6370	CCL25	chr19	8107224	8130547	23323	chemokine (C-C motif) ligand 25
PA35557	10344	CCL26	chr7	75395842	75429064	33222	chemokine (C-C motif) ligand 26
PA35558	10850	CCL27	chr9	34658893	34672689	13796	chemokine (C-C motif) ligand 27
PA38463	56477	CCL28	chr5	43373747	43422488	48741	chemokine (C-C motif) ligand 28
PA35559	6348	CCL3	chr17	34412602	34427506	14904	chemokine (C-C motif) ligand 3
PA35560	6349	CCL3L1	chr17	34620842	34635730	14888	chemokine (C-C motif) ligand 3-like 1
PA142672174	414062	CCL3L3	chr17	34519268	34534147	14879	chemokine (C-C motif) ligand 3-like 3
PA35562	6351	CCL4	chr17	34421220	34436014	14794	chemokine (C-C motif) ligand 4
PA35563	9560	CCL4L1	chr17	34528468	34543275	14807	chemokine (C-C motif) ligand 4-like 1
PA142672157	388372	CCL4L2	chr17	34630034	34644841	14807	chemokine (C-C motif) ligand 4-like 2
PA35564	6352	CCL5	chr17	34195495	34217377	21882	chemokine (C-C motif) ligand 5
PA35566	6354	CCL7	chr17	32587235	32602261	15026	chemokine (C-C motif) ligand 7
PA35567	6355	CCL8	chr17	32636066	32651421	15355	chemokine (C-C motif) ligand 8
PA26145	83605	CCM2	chr7	45029345	45119069	89724	cerebral cavernous malformation 2
PA25702	140706	CCM2L	chr20	30588200	30622984	34784	cerebral cavernous malformation 2-like
PA26147	8900	CCNA1	chr13	36995257	37020019	24762	cyclin A1
PA94	890	CCNA2	chr4	122734599	122755153	20554	cyclin A2
PA95	891	CCNB1	chr5	68452837	68477072	24235	cyclin B1
PA134863884	57820	CCNB1IP1	chr14	20776527	20811471	34944	cyclin B1 interacting protein 1, E3 ubiquitin protein ligase
PA26148	9133	CCNB2	chr15	59387284	59420244	32960	cyclin B2
PA38653	85417	CCNB3	chrX	50017540	50097913	80373	cyclin B3
PA26149	892	CCNC	chr6	99987263	100026849	39586	cyclin C
PA75	595	CCND1	chr11	69445873	69472242	26369	cyclin D1
PA26150	894	CCND2	chr12	4372901	4417522	44621	cyclin D2
PA26152	896	CCND3	chr6	41899671	42026610	126939	cyclin D3
PA26154	23582	CCNDBP1	chr15	43467466	43492375	24909	cyclin D-type binding-protein 1
PA96	898	CCNE1	chr19	30292805	30318224	25419	cyclin E1
PA26155	9134	CCNE2	chr8	95889452	95919672	30220	cyclin E2
PA26156	899	CCNF	chr16	2469395	2511859	42464	cyclin F
PA26157	900	CCNG1	chr5	162854573	162875022	20449	cyclin G1
PA26158	901	CCNG2	chr4	78068357	78094213	25856	cyclin G2
PA26159	902	CCNH	chr5	86684310	86718850	34540	cyclin H
PA26160	10983	CCNI	chr4	77965308	78008719	43411	cyclin I
PA162381968	645121	CCNI2	chr5	132073137	132092856	19719	cyclin I family, member 2
PA134911603	54619	CCNJ	chr10	97793159	97823627	30468	cyclin J
PA144596449	79616	CCNJL	chr5	159675666	159749602	73936	cyclin J-like
PA26161	8812	CCNK	chr14	99937695	99980852	43157	cyclin K
PA134980948	57018	CCNL1	chr3	156861291	156888482	27191	cyclin L1
PA134973681	81669	CCNL2	chr1	1318091	1344718	26627	cyclin L2
PA38350	10309	CCNO	chr5	54523980	54539508	15528	cyclin O
PA26163	904	CCNT1	chr12	49079241	49120781	41540	cyclin T1
PA26164	905	CCNT2	chr2	135666363	135719915	53552	cyclin T2
PA162381980	219771	CCNY	chr10	35525953	35863848	337895	cyclin Y
PA162382009	151195	CCNYL1	chr2	208566264	208623898	57634	cyclin Y-like 1
PA162382036	414194	CCNYL2	chr10	42900622	42977688	77066	cyclin Y-like 2
PA162382064	642326	CCNYL3	chr16	34255408	34321685	66277	cyclin Y-like 3
PA134967250	9236	CCPG1	chr15	55644421	55710708	66287	cell cycle progression 1
PA26166	1230	CCR1	chr3	46240200	46259832	19632	chemokine (C-C motif) receptor 1
PA28862	2826	CCR10	chr17	40828420	40843845	15425	chemokine (C-C motif) receptor 10
PA26167	729230	CCR2	chr3	46385235	46405413	20178	chemokine (C-C motif) receptor 2
PA26168	1232	CCR3	chr3	46273872	46311197	37325	chemokine (C-C motif) receptor 3
PA26169	1233	CCR4	chr3	32983066	32999403	16337	chemokine (C-C motif) receptor 4
PA26170	1234	CCR5	chr3	46401633	46420697	19064	chemokine (C-C motif) receptor 5 (gene/pseudogene)
PA26171	1235	CCR6	chr6	167515295	167557168	41873	chemokine (C-C motif) receptor 6
PA26172	1236	CCR7	chr17	38707021	38731736	24715	chemokine (C-C motif) receptor 7
PA26173	1237	CCR8	chr3	39361197	39378171	16974	chemokine (C-C motif) receptor 8
PA26174	10803	CCR9	chr3	45917996	45947667	29671	chemokine (C-C motif) receptor 9
PA26175	9034	CCRL2	chr3	46438721	46457488	18767	chemokine (C-C motif) receptor-like 2
PA26176	25819	CCRN4L	chr4	139926913	139970093	43180	CCR4 carbon catabolite repression 4-like (S. cerevisiae)
PA26177	9973	CCS	chr11	66350630	66376490	25860	copper chaperone for superoxide dismutase
PA142672480	126731	CCSAP	chr1	229453752	229488688	34936	centriole, cilia and spindle-associated protein
PA165663936	401145	CCSER1	chr4	91038684	92526370	1487686	coiled-coil serine-rich protein 1
PA165548597	54462	CCSER2	chr10	86078342	86281276	202934	coiled-coil serine-rich protein 2
PA26179	10576	CCT2	chr12	69969206	70013595	44389	chaperonin containing TCP1, subunit 2 (beta)
PA26180	7203	CCT3	chr1	156275752	156318206	42454	chaperonin containing TCP1, subunit 3 (gamma)
PA26181	10575	CCT4	chr2	62092262	62125806	33544	chaperonin containing TCP1, subunit 4 (delta)
PA26182	22948	CCT5	chr5	10240041	10269501	29460	chaperonin containing TCP1, subunit 5 (epsilon)
PA26183	908	CCT6A	chr7	56109378	56134682	25304	chaperonin containing TCP1, subunit 6A (zeta 1)
PA26184	10693	CCT6B	chr17	33251878	33317968	66090	chaperonin containing TCP1, subunit 6B (zeta 2)
PA26185	10574	CCT7	chr2	73451364	73483150	31786	chaperonin containing TCP1, subunit 7 (eta)
PA26186	10694	CCT8	chr21	30425647	30456010	30363	chaperonin containing TCP1, subunit 8 (theta)
PA162382100	150160	CCT8L2	chr22	17068648	17083700	15052	chaperonin containing TCP1, subunit 8 (theta)-like 2
PA165617711	51622	CCZ1	chr7	5928341	5968605	40264	CCZ1 vacuolar protein trafficking and biogenesis associated homolog (S. cerevisiae)
PA134930339	221960	CCZ1B	chr7	6835566	6875926	40360	CCZ1 vacuolar protein trafficking and biogenesis associated homolog B (S. cerevisiae)
PA29762	9398	CD101	chr1	117534372	117582173	47801	CD101 molecule
PA134949237	135228	CD109	chr6	74395508	74541041	145533	CD109 molecule
PA26188	929	CD14	chr5	140008313	140023286	14973	CD14 molecule
PA26189	977	CD151	chr11	822952	841840	18888	CD151 molecule (Raph blood group)
PA134943137	11126	CD160	chr1	145692798	145725639	32841	CD160 molecule
PA26190	9332	CD163	chr12	7620412	7666414	46002	CD163 molecule
PA142672145	283316	CD163L1	chr12	7504556	7606778	102222	CD163 molecule-like 1
PA26191	8763	CD164	chr6	109684717	109713762	29045	CD164 molecule, sialomucin
PA142672146	388611	CD164L2	chr1	27702596	27719823	17227	CD164 sialomucin-like 2
PA30490	4064	CD180	chr5	66474205	66502617	28412	CD180 molecule
PA26192	930	CD19	chr16	28933082	28953668	20586	CD19 molecule
PA26193	909	CD1A	chr1	158208119	158231059	22940	CD1a molecule
PA26194	910	CD1B	chr1	158294740	158311321	16581	CD1b molecule
PA26195	911	CD1C	chr1	158249563	158267564	18001	CD1c molecule
PA26196	912	CD1D	chr1	158137828	158159217	21389	CD1d molecule
PA26197	913	CD1E	chr1	158313486	158330343	16857	CD1e molecule
PA26198	914	CD2	chr1	117287057	117314851	27794	CD2 molecule
PA30911	4345	CD200	chr3	112041194	112084659	43465	CD200 molecule
PA134922446	131450	CD200R1	chr3	112638532	112703950	65418	CD200 receptor 1
PA164717784	344807	CD200R1L	chr3	112531556	112574797	43241	CD200 receptor 1-like
PA134986203	50489	CD207	chr2	71054343	71072953	18610	CD207 molecule, langerin
PA26199	30835	CD209	chr19	7801879	7822499	20620	CD209 molecule
PA26201	933	CD22	chr19	35810069	35841264	31195	CD22 molecule
PA134911130	10666	CD226	chr18	67527192	67634412	107220	CD226 molecule
PA134905192	51744	CD244	chr1	160796950	160842692	45742	CD244 molecule, natural killer cell receptor 2B4
PA26219	919	CD247	chr1	167396877	167497847	100970	CD247 molecule
PA134864533	57124	CD248	chr11	66078958	66094515	15557	CD248 molecule, endosialin
PA162382107	939	CD27	chr12	6544051	6563884	19833	CD27 molecule
PA134915280	29126	CD274	chr9	5440503	5473567	33064	CD274 molecule
PA142672148	80381	CD276	chr15	73966560	74009859	43299	CD276 molecule
PA26207	940	CD28	chr2	204561198	204606635	45437	CD28 molecule
PA26208	23607	CD2AP	chr6	47435482	47597999	162517	CD2-associated protein
PA26209	10421	CD2BP2	chr16	30359087	30376682	17595	CD2 (cytoplasmic tail) binding protein 2
PA142672149	11314	CD300A	chr17	72452509	72483937	31428	CD300a molecule
PA142672150	10871	CD300C	chr17	72534204	72552310	18106	CD300c molecule
PA142672152	342510	CD300E	chr17	72603022	72629897	26875	CD300e molecule
PA142672151	124599	CD300LB	chr17	72513894	72537613	23719	CD300 molecule-like family member b
PA162382124	100131439	CD300LD	chr17	72573111	72598370	25259	CD300 molecule-like family member d
PA142672153	146722	CD300LF	chr17	72687447	72719169	31722	CD300 molecule-like family member f
PA142672154	146894	CD300LG	chr17	41914145	41943997	29852	CD300 molecule-like family member g
PA142672141	9936	CD302	chr2	160622139	160665115	42976	CD302 molecule
PA142672142	51293	CD320	chr19	8364011	8383439	19428	CD320 molecule
PA26210	945	CD33	chr19	51718335	51746274	27939	CD33 molecule
PA26211	947	CD34	chr1	208056883	208094742	37859	CD34 molecule
PA26212	948	CD36	chr7	80221504	80311593	90089	CD36 molecule (thrombospondin receptor)
PA26213	951	CD37	chr19	49828632	49846863	18231	CD37 molecule
PA26214	952	CD38	chr4	15769921	15853706	83785	CD38 molecule
PA26215	915	CD3D	chr11	118206789	118223459	16670	CD3d molecule, delta (CD3-TCR complex)
PA26216	916	CD3E	chr11	118165295	118189890	24595	CD3e molecule, epsilon (CD3-TCR complex)
PA142672156	10849	CD3EAP	chr19	45899467	45917024	17557	CD3e molecule, epsilon associated protein
PA26217	917	CD3G	chr11	118205032	118227497	22465	CD3g molecule, gamma (CD3-TCR complex)
PA26220	920	CD4	chr12	6888638	6932976	44338	CD4 molecule
PA36612	958	CD40	chr20	44736899	44761384	24485	CD40 molecule, TNF receptor superfamily member 5
PA36626	959	CD40LG	chrX	135720281	135745549	25268	CD40 ligand
PA26221	960	CD44	chr11	35150417	35256949	106532	CD44 molecule (Indian blood group)
PA30700	4179	CD46	chr1	207915383	207971861	56478	CD46 molecule, complement regulatory protein
PA26222	961	CD47	chr3	107758941	107819935	60994	CD47 molecule
PA26223	962	CD48	chr1	160645536	160691641	46105	CD48 molecule
PA26224	921	CD5	chr11	60859930	60898324	38394	CD5 molecule
PA26350	1043	CD52	chr1	26634411	26650014	15603	CD52 molecule
PA26225	963	CD53	chr1	111403821	111445558	41737	CD53 molecule
PA27137	1604	CD55	chr1	207484817	207537311	52494	CD55 molecule, decay accelerating factor for complement (Cromer blood group)
PA26227	965	CD58	chr1	117054156	117123715	69559	CD58 molecule
PA26228	966	CD59	chr11	33721556	33768025	46469	CD59 molecule, complement regulatory protein
PA26229	922	CD5L	chr1	157793861	157821634	27773	CD5 molecule-like
PA26230	923	CD6	chr11	60729113	60790849	61736	CD6 molecule
PA26231	967	CD63	chr12	56116227	56133457	17230	CD63 molecule
PA26232	968	CD68	chr17	7472805	7488429	15624	CD68 molecule
PA26233	969	CD69	chr12	9902082	9923497	21415	CD69 molecule
PA26234	924	CD7	chr17	80269746	80285480	15734	CD7 molecule
PA36627	970	CD70	chr19	6579969	6601163	21194	CD70 molecule
PA26235	971	CD72	chr9	35606976	35628862	21886	CD72 molecule
PA26236	972	CD74	chr5	149778200	149802543	24343	CD74 molecule, major histocompatibility complex, class II invariant chain
PA26237	973	CD79A	chr19	42371190	42388439	17249	CD79a molecule, immunoglobulin-associated alpha
PA26238	974	CD79B	chr17	62003098	62019710	16612	CD79b molecule, immunoglobulin-associated beta
PA26239	941	CD80	chr3	119240140	119288481	48341	CD80 molecule
PA26240	975	CD81	chr11	2387391	2421649	34258	CD81 molecule
PA142672155	3732	CD82	chr11	44577141	44644339	67198	CD82 molecule
PA26241	9308	CD83	chr6	14107487	14140149	32662	CD83 molecule
PA26242	8832	CD84	chr1	160507884	160559306	51422	CD84 molecule
PA26243	942	CD86	chr3	121764209	121842990	78781	CD86 molecule
PA26244	925	CD8A	chr2	87008728	87045519	36791	CD8a molecule
PA26245	926	CD8B	chr2	87039460	87099047	59587	CD8b molecule
PA26247	928	CD9	chr12	6299482	6350437	50955	CD9 molecule
PA25627	22918	CD93	chr20	23056993	23076977	19984	CD93 molecule
PA437	10225	CD96	chr3	111250926	111387843	136917	CD96 molecule
PA26248	976	CD97	chr19	14481403	14522537	41134	CD97 molecule
PA30804	4267	CD99	chrY	2549228	2612350	63122	CD99 molecule
PA30805	83692	CD99L2	chrX	149931809	150077289	145480	CD99 molecule-like 2
PA98	978	CDA	chr1	20905444	20948401	42957	cytidine deaminase
PA134884656	81602	CDADC1	chr13	49812047	49870622	58575	cytidine and dCMP deaminase domain containing 1
PA26249	146059	CDAN1	chr15	43012760	43039417	26657	codanin 1
PA162382148	8872	CDC123	chr10	12227961	12295589	67628	cell division cycle 123
PA26254	8556	CDC14A	chr1	100800598	100988833	188235	cell division cycle 14A
PA26255	8555	CDC14B	chr9	99249807	99392112	142305	cell division cycle 14B
PA26256	8881	CDC16	chr13	114990320	115041150	50830	cell division cycle 16
PA26257	991	CDC20	chr1	43814626	43831874	17248	cell division cycle 20
PA145149217	166979	CDC20B	chr5	54405799	54479005	73206	cell division cycle 20B
PA26258	8697	CDC23	chr5	137520337	137559032	38695	cell division cycle 23
PA26259	993	CDC25A	chr3	48195668	48240153	44485	cell division cycle 25A
PA26260	994	CDC25B	chr20	3757419	3789765	32346	cell division cycle 25B
PA100	995	CDC25C	chr5	137617959	137684064	66105	cell division cycle 25C
PA25974	246184	CDC26	chr9	116026288	116047869	21581	cell division cycle 26
PA26261	996	CDC27	chr17	45192310	45276665	84355	cell division cycle 27
PA26265	997	CDC34	chr19	521720	545087	23367	cell division cycle 34
PA402	11140	CDC37	chr19	10498809	10524271	25462	cell division cycle 37
PA134982210	55664	CDC37L1	chr9	4669566	4709594	40028	cell division cycle 37-like 1
PA134891332	51362	CDC40	chr6	110491624	110556423	64799	cell division cycle 40
PA26266	998	CDC42	chr1	22369120	22422439	53319	cell division cycle 42
PA26267	8476	CDC42BPA	chr1	227174566	227516193	341627	CDC42 binding protein kinase alpha (DMPK-like)
PA26268	9578	CDC42BPB	chr14	103395716	103533742	138026	CDC42 binding protein kinase beta (DMPK-like)
PA134901493	55561	CDC42BPG	chr11	64588661	64622041	33380	CDC42 binding protein kinase gamma (DMPK-like)
PA38430	11135	CDC42EP1	chr22	37946471	37968412	21941	CDC42 effector protein (Rho GTPase binding) 1
PA38396	10435	CDC42EP2	chr11	65072289	65092900	20611	CDC42 effector protein (Rho GTPase binding) 2
PA38429	10602	CDC42EP3	chr2	37866025	37909678	43653	CDC42 effector protein (Rho GTPase binding) 3
PA38439	23580	CDC42EP4	chr17	71276763	71318314	41551	CDC42 effector protein (Rho GTPase binding) 4
PA134989100	148170	CDC42EP5	chr19	54973210	54994422	21212	CDC42 effector protein (Rho GTPase binding) 5
PA134875001	56882	CDC42SE1	chr1	151020447	151042125	21678	CDC42 small effector 1
PA133787056	56990	CDC42SE2	chr5	130589702	130733383	143681	CDC42 small effector 2
PA371	8318	CDC45	chr22	19456984	19511135	54151	cell division cycle 45
PA26270	988	CDC5L	chr6	44345251	44421161	75910	cell division cycle 5-like
PA26271	990	CDC6	chr17	38434146	38462413	28267	cell division cycle 6
PA26272	8317	CDC7	chr1	91956338	91994321	37983	cell division cycle 7
PA29464	79577	CDC73	chr1	193081088	193226945	145857	cell division cycle 73
PA26275	157313	CDCA2	chr8	25306275	25368425	62150	cell division cycle associated 2
PA26276	83461	CDCA3	chr12	6954972	6971128	16156	cell division cycle associated 3
PA26277	55038	CDCA4	chr14	105472910	105497425	24515	cell division cycle associated 4
PA26278	113130	CDCA5	chr11	64830772	64861635	30863	cell division cycle associated 5
PA26280	83879	CDCA7	chr2	174209561	174236718	27157	cell division cycle associated 7
PA142672139	55536	CDCA7L	chr7	21937517	21995542	58025	cell division cycle associated 7-like
PA26281	55143	CDCA8	chr1	38148073	38178391	30318	cell division cycle associated 8
PA142672140	64866	CDCP1	chr3	45120766	45197914	77148	CUB domain containing protein 1
PA143485432	200008	CDCP2	chr1	54601668	54628679	27011	CUB domain containing protein 2
PA26282	999	CDH1	chr16	68761128	68872445	111317	cadherin 1, type 1, E-cadherin (epithelial)
PA26283	1008	CDH10	chr5	24484209	24655085	170876	cadherin 10, type 2 (T2-cadherin)
PA26284	1009	CDH11	chr16	64913794	65170015	256221	cadherin 11, type 2, OB-cadherin (osteoblast)
PA26285	1010	CDH12	chr5	21747870	22863731	1115861	cadherin 12, type 2 (N-cadherin 2)
PA26287	1012	CDH13	chr16	82650399	83833215	1182816	cadherin 13
PA26288	1013	CDH15	chr16	89228163	89264900	36737	cadherin 15, type 1, M-cadherin (myotubule)
PA26289	1014	CDH16	chr16	66939025	66962887	23862	cadherin 16, KSP-cadherin
PA26290	1015	CDH17	chr8	95136394	95239531	103137	cadherin 17, LI cadherin (liver-intestine)
PA26291	1016	CDH18	chr5	19470140	20585972	1115832	cadherin 18, type 2
PA26292	28513	CDH19	chr18	64165320	64281375	116055	cadherin 19, type 2
PA26293	1000	CDH2	chr18	25527930	25767445	239515	cadherin 2, type 1, N-cadherin (neuronal)
PA26294	28316	CDH20	chr18	58990815	59240123	249308	cadherin 20, type 2
PA26295	64405	CDH22	chr20	44799372	44947137	147765	cadherin 22, type 2
PA26296	64072	CDH23	chr10	73146691	73578704	432013	cadherin-related 23
PA26297	64403	CDH24	chr14	23513270	23536747	23477	cadherin 24, type 2
PA26298	60437	CDH26	chr20	58523471	58591772	68301	cadherin 26
PA26299	1001	CDH3	chr16	68668151	68735959	67808	cadherin 3, type 1, P-cadherin (placental)
PA26300	1002	CDH4	chr20	59817482	60518673	701191	cadherin 4, type 1, R-cadherin (retinal)
PA26301	1003	CDH5	chr16	66390525	66441689	51164	cadherin 5, type 2 (vascular endothelium)
PA26302	1004	CDH6	chr5	31183762	31332253	148491	cadherin 6, type 2, K-cadherin (fetal kidney)
PA26303	1005	CDH7	chr18	63407488	63551175	143687	cadherin 7, type 2
PA26304	1006	CDH8	chr16	61678169	62080939	402770	cadherin 8, type 2
PA26305	1007	CDH9	chr5	26877709	27048689	170980	cadherin 9, type 2 (T1-cadherin)
PA33005	92211	CDHR1	chr10	85944391	85982377	37986	cadherin-related family member 1
PA165660231	54825	CDHR2	chr5	175959512	176025769	66257	cadherin-related family member 2
PA165617747	222256	CDHR3	chr7	105507251	105679877	172626	cadherin-related family member 3
PA165696944	389118	CDHR4	chr3	49825165	49847254	22089	cadherin-related family member 4
PA165543311	53841	CDHR5	chr11	613565	635067	21502	cadherin-related family member 5
PA134879441	29965	CDIP1	chr16	4557676	4598816	41140	cell death-inducing p53 target 1
PA26306	10423	CDIPT	chr16	29866678	29884801	18123	CDP-diacylglycerol--inositol 3-phosphatidyltransferase
PA99	983	CDK1	chr10	62528089	62557610	29521	cyclin-dependent kinase 1
PA26307	8558	CDK10	chr16	89743076	89765772	22696	cyclin-dependent kinase 10
PA26263	728642	CDK11A	chr1	1630822	1665999	35177	cyclin-dependent kinase 11A
PA26262	984	CDK11B	chr1	1568100	1600473	32373	cyclin-dependent kinase 11B
PA165431656	51755	CDK12	chr17	37607739	37724398	116659	cyclin-dependent kinase 12
PA26264	8621	CDK13	chr7	39979959	40139733	159774	cyclin-dependent kinase 13
PA33221	5218	CDK14	chr7	90215681	90842905	627224	cyclin-dependent kinase 14
PA165696414	65061	CDK15	chr2	202645177	202763273	118096	cyclin-dependent kinase 15
PA33095	5127	CDK16	chrX	47067445	47092396	24951	cyclin-dependent kinase 16
PA33096	5128	CDK17	chr12	96669039	96804366	135327	cyclin-dependent kinase 17
PA33097	5129	CDK18	chr1	205463684	205504921	41237	cyclin-dependent kinase 18
PA165617767	23097	CDK19	chr6	110928181	111146590	218409	cyclin-dependent kinase 19
PA101	1017	CDK2	chr12	56350556	56369573	19017	cyclin-dependent kinase 2
PA165585688	23552	CDK20	chr9	90578356	90599695	21339	cyclin-dependent kinase 20
PA26308	8099	CDK2AP1	chr12	123742517	123766863	24346	cyclin-dependent kinase 2 associated protein 1
PA128394572	10263	CDK2AP2	chr11	67270961	67286199	15238	cyclin-dependent kinase 2 associated protein 2
PA26309	1018	CDK3	chr17	73986235	74005080	18845	cyclin-dependent kinase 3
PA102	1019	CDK4	chr12	58138510	58156304	17794	cyclin-dependent kinase 4
PA26310	1020	CDK5	chr7	150747899	150765052	17153	cyclin-dependent kinase 5
PA26311	8851	CDK5R1	chr17	30804105	30821271	17166	cyclin-dependent kinase 5, regulatory subunit 1 (p35)
PA26312	8941	CDK5R2	chr2	219814350	219829877	15527	cyclin-dependent kinase 5, regulatory subunit 2 (p39)
PA26313	51654	CDK5RAP1	chr20	31943645	31999375	55730	CDK5 regulatory subunit associated protein 1
PA38632	55755	CDK5RAP2	chr9	123148147	123352448	204301	CDK5 regulatory subunit associated protein 2
PA38633	80279	CDK5RAP3	chr17	46037894	46062152	24258	CDK5 regulatory subunit associated protein 3
PA103	1021	CDK6	chr7	92231235	92475941	244706	cyclin-dependent kinase 6
PA26314	1022	CDK7	chr5	68520622	68576257	55635	cyclin-dependent kinase 7
PA26315	1024	CDK8	chr13	26818262	26982375	164113	cyclin-dependent kinase 8
PA26316	1025	CDK9	chr9	130538305	130556052	17747	cyclin-dependent kinase 9
PA134871999	54901	CDKAL1	chr6	20524688	21235635	710947	CDK5 regulatory subunit associated protein 1-like 1
PA26317	8814	CDKL1	chr14	50793122	50893179	100057	cyclin-dependent kinase-like 1 (CDC2-related kinase)
PA26318	8999	CDKL2	chr4	76498704	76565721	67017	cyclin-dependent kinase-like 2 (CDC2-related kinase)
PA26319	51265	CDKL3	chr5	133568817	133716805	147988	cyclin-dependent kinase-like 3
PA134892546	344387	CDKL4	chr2	39402688	39481114	78426	cyclin-dependent kinase-like 4
PA36218	6792	CDKL5	chrX	18433725	18674749	241024	cyclin-dependent kinase-like 5
PA104	1026	CDKN1A	chr6	36634237	36658116	23879	cyclin-dependent kinase inhibitor 1A (p21, Cip1)
PA105	1027	CDKN1B	chr12	12860302	12878305	18003	cyclin-dependent kinase inhibitor 1B (p27, Kip1)
PA26320	1028	CDKN1C	chr11	2901448	2917063	15615	cyclin-dependent kinase inhibitor 1C (p57, Kip2)
PA106	1029	CDKN2A	chr9	21964751	22004490	39739	cyclin-dependent kinase inhibitor 2A
PA162382149	55602	CDKN2AIP	chr4	184355788	184372348	16560	CDKN2A interacting protein
PA162382150	91368	CDKN2AIPNL	chr5	133734756	133757598	22842	CDKN2A interacting protein N-terminal like
PA26321	1030	CDKN2B	chr9	21999902	22019312	19410	cyclin-dependent kinase inhibitor 2B (p15, inhibits CDK4)
PA26322	1031	CDKN2C	chr1	51424367	51443309	18942	cyclin-dependent kinase inhibitor 2C (p18, inhibits CDK4)
PA26323	1032	CDKN2D	chr19	10674138	10689655	15517	cyclin-dependent kinase inhibitor 2D (p19, inhibits CDK4)
PA26324	1033	CDKN3	chr14	54853657	54889936	36279	cyclin-dependent kinase inhibitor 3
PA165548325	441549	CDNF	chr10	14858251	14889983	31732	cerebral dopamine neurotrophic factor
PA26327	1036	CDO1	chr5	115137430	115162405	24975	cysteine dioxygenase type 1
PA26328	50937	CDON	chr11	125823713	125943187	119474	cell adhesion associated, oncogene regulated
PA162379006	150383	CDPF1	chr22	46636910	46656193	19283	cysteine-rich, DPF motif domain containing 1
PA26330	1038	CDR1	chrX	139862425	139876723	14298	cerebellar degeneration-related protein 1, 34kDa
PA26331	1039	CDR2	chr16	22354257	22395938	41681	cerebellar degeneration-related protein 2, 62kDa
PA142672137	30850	CDR2L	chr17	72973727	73004895	31168	cerebellar degeneration-related protein 2-like
PA134869447	374286	CDRT1	chr17	15488977	15533018	44041	CMT1A duplicated region transcript 1
PA26337	146822	CDRT15	chr17	14136173	14150150	13977	CMT1A duplicated region transcript 15
PA162382160	256223	CDRT15L2	chr17	20473037	20487224	14187	CMT1A duplicated region transcript 15-like 2
PA26340	284040	CDRT4	chr17	15336332	15380925	44593	CMT1A duplicated region transcript 4
PA26346	1040	CDS1	chr4	85494057	85575493	81436	CDP-diacylglycerol synthase (phosphatidate cytidylyltransferase) 1
PA26347	8760	CDS2	chr20	5097407	5181533	84126	CDP-diacylglycerol synthase (phosphatidate cytidylyltransferase) 2
PA26348	1041	CDSN	chr6	31079865	31098252	18387	corneodesmosin
PA145008572	81620	CDT1	chr16	88860186	88878666	18480	chromatin licensing and DNA replication factor 1
PA142672138	55573	CDV3	chr3	133282434	133312118	29684	CDV3 homolog (mouse)
PA26351	1044	CDX1	chr5	149536344	149567121	30777	caudal type homeobox 1
PA26352	1045	CDX2	chr13	28533205	28553505	20300	caudal type homeobox 2
PA26353	1046	CDX4	chrX	72657090	72677421	20331	caudal type homeobox 4
PA26354	9085	CDY1	chrY	27758264	27774049	15785	chromodomain protein, Y-linked, 1
PA134912535	253175	CDY1B	chrY	26188376	26204161	15785	chromodomain protein, Y-linked, 1B
PA26355	9426	CDY2A	chrY	20127667	20142626	14959	chromodomain protein, Y-linked, 2A
PA142672136	203611	CDY2B	chrY	19987140	20002099	14959	chromodomain protein, Y-linked, 2B
PA26356	9425	CDYL	chr6	4696393	4958778	262385	chromodomain protein, Y-like
PA134903387	124359	CDYL2	chr16	80634675	80848175	213500	chromodomain protein, Y-like 2
PA26358	634	CEACAM1	chr19	43008458	43042661	34203	carcinoembryonic antigen-related cell adhesion molecule 1 (biliary glycoprotein)
PA142672131	388551	CEACAM16	chr19	45192421	45216986	24565	carcinoembryonic antigen-related cell adhesion molecule 16
PA142672132	729767	CEACAM18	chr19	51971897	51996859	24962	carcinoembryonic antigen-related cell adhesion molecule 18
PA142672133	56971	CEACAM19	chr19	45164724	45190631	25907	carcinoembryonic antigen-related cell adhesion molecule 19
PA142672135	90273	CEACAM21	chr19	42045886	42096255	50369	carcinoembryonic antigen-related cell adhesion molecule 21
PA26359	1084	CEACAM3	chr19	42290522	42318591	28069	carcinoembryonic antigen-related cell adhesion molecule 3
PA26360	1089	CEACAM4	chr19	42122344	42143442	21098	carcinoembryonic antigen-related cell adhesion molecule 4
PA26361	1048	CEACAM5	chr19	42202530	42237437	34907	carcinoembryonic antigen-related cell adhesion molecule 5
PA26362	4680	CEACAM6	chr19	42249398	42279113	29715	carcinoembryonic antigen-related cell adhesion molecule 6 (non-specific cross reacting antigen)
PA26363	1087	CEACAM7	chr19	42174235	42202196	27961	carcinoembryonic antigen-related cell adhesion molecule 7
PA26364	1088	CEACAM8	chr19	43081393	43109082	27689	carcinoembryonic antigen-related cell adhesion molecule 8
PA26376	1050	CEBPA	chr19	33787840	33803430	15590	CCAAT/enhancer binding protein (C/EBP), alpha
PA26377	1051	CEBPB	chr20	48797120	48812227	15107	CCAAT/enhancer binding protein (C/EBP), beta
PA26378	1052	CEBPD	chr8	48646476	48660726	14250	CCAAT/enhancer binding protein (C/EBP), delta
PA26379	1053	CEBPE	chr14	23583515	23598820	15305	CCAAT/enhancer binding protein (C/EBP), epsilon
PA26380	1054	CEBPG	chr19	33854575	33876592	22017	CCAAT/enhancer binding protein (C/EBP), gamma
PA134977051	10153	CEBPZ	chr2	37425772	37468740	42968	CCAAT/enhancer binding protein (C/EBP), zeta
PA26382	51816	CECR1	chr22	17656681	17712744	56063	cat eye syndrome chromosome region, candidate 1
PA26383	27443	CECR2	chr22	17946630	18036845	90215	cat eye syndrome chromosome region, candidate 2
PA26386	27440	CECR5	chr22	17615410	17656177	40767	cat eye syndrome chromosome region, candidate 5
PA26387	27439	CECR6	chr22	17594189	17612257	18068	cat eye syndrome chromosome region, candidate 6
PA26391	1056	CEL	chr9	135926741	135950250	23509	carboxyl ester lipase
PA27734	1990	CELA1	chr12	51719227	51750463	31236	chymotrypsin-like elastase family, member 1
PA165750794	63036	CELA2A	chr1	15773223	15801586	28363	chymotrypsin-like elastase family, member 2A
PA165750841	51032	CELA2B	chr1	15792596	15820895	28299	chymotrypsin-like elastase family, member 2B
PA27736	10136	CELA3A	chr1	22318149	22342035	23886	chymotrypsin-like elastase family, member 3A
PA27737	23436	CELA3B	chr1	22293418	22318847	25429	chymotrypsin-like elastase family, member 3B
PA27045	10658	CELF1	chr11	47484489	47584792	100303	CUGBP, Elav-like family member 1
PA27046	10659	CELF2	chr10	10828851	11381674	552823	CUGBP, Elav-like family member 2
PA36654	11189	CELF3	chr1	151669534	151699290	29756	CUGBP, Elav-like family member 3
PA25428	56853	CELF4	chr18	34820003	35156000	335997	CUGBP, Elav-like family member 4
PA25429	60680	CELF5	chr19	3214701	3300074	85373	CUGBP, Elav-like family member 5
PA25430	60677	CELF6	chr15	72574068	72622525	48457	CUGBP, Elav-like family member 6
PA26393	9620	CELSR1	chr22	46753731	46943067	189336	cadherin, EGF LAG seven-pass G-type receptor 1
PA26394	1952	CELSR2	chr1	109782641	109821378	38737	cadherin, EGF LAG seven-pass G-type receptor 2
PA26395	1951	CELSR3	chr3	48670896	48710348	39452	cadherin, EGF LAG seven-pass G-type receptor 3
PA134967531	57214	CEMIP	chr15	81061712	81246999	185287	cell migration inducing protein, hyaluronan binding
PA162382169	752014	CEMP1	chr16	2577036	2591409	14373	cementum protein 1
PA145149163	51286	CEND1	chr11	784110	800126	16016	cell cycle exit and neuronal differentiation 1
PA26396	1058	CENPA	chr2	26998857	27026935	28078	centromere protein A
PA26397	1059	CENPB	chr20	3761498	3777337	15839	centromere protein B, 80kDa
PA165449826	92806	CENPBD1	chr16	90033183	90049240	16057	CENPB DNA-binding domains containing 1
PA26398	1060	CENPC	chr4	68334989	68421256	86267	centromere protein C
PA26400	1062	CENPE	chr4	104023963	104129566	105603	centromere protein E, 312kDa
PA26401	1063	CENPF	chr1	214766522	214840914	74392	centromere protein F, 350/400kDa
PA26402	64946	CENPH	chr5	68475375	68509184	33809	centromere protein H
PA28385	2491	CENPI	chrX	100343178	100421667	78489	centromere protein I
PA26403	55835	CENPJ	chr13	25453412	25507027	53615	centromere protein J
PA145149171	64105	CENPK	chr5	64810593	64868995	58402	centromere protein K
PA142672406	91687	CENPL	chr1	173765688	173804325	38637	centromere protein L
PA25885	79019	CENPM	chr22	42331531	42353155	21624	centromere protein M
PA143485397	55839	CENPN	chr16	81030103	81069712	39609	centromere protein N
PA145149197	79172	CENPO	chr2	25006175	25048245	42070	centromere protein O
PA145149143	401541	CENPP	chr9	95077741	95380446	302705	centromere protein P
PA134973276	55166	CENPQ	chr6	49421054	49463820	42766	centromere protein Q
PA142672263	80152	CENPT	chr16	67859060	67891361	32301	centromere protein T
PA134893791	79682	CENPU	chr4	185612219	185665286	53067	centromere protein U
PA164717842	201161	CENPV	chr17	16242831	16266812	23981	centromere protein V
PA165617841	387103	CENPW	chr6	126650660	126673548	22888	centromere protein W
PA144596418	9731	CEP104	chr1	3725645	3783797	58152	centrosomal protein 104kDa
PA142672163	201134	CEP112	chr17	63628658	64198212	569554	centrosomal protein 112kDa
PA164717857	153241	CEP120	chr5	122677579	122769286	91707	centrosomal protein 120kDa
PA142672283	145508	CEP128	chr14	80959821	81418105	458284	centrosomal protein 128kDa
PA134920867	22994	CEP131	chr17	79160393	79206751	46358	centrosomal protein 131kDa
PA128394551	9662	CEP135	chr4	56804974	56902529	97555	centrosomal protein 135kDa
PA142672126	22995	CEP152	chr15	49027135	49114092	86957	centrosomal protein 152kDa
PA134972331	22832	CEP162	chr6	84830960	84947335	116375	centrosomal protein 162kDa
PA142672127	22897	CEP164	chr11	117174792	117286982	112190	centrosomal protein 164kDa
PA128395757	9859	CEP170	chr1	243284730	243429284	144554	centrosomal protein 170kDa
PA134863153	283638	CEP170B	chr14	105321650	105366107	44457	centrosomal protein 170B
PA142672395	84984	CEP19	chr3	196430144	196449131	18987	centrosomal protein 19kDa
PA142672129	55125	CEP192	chr18	12981352	13128052	146700	centrosomal protein 192kDa
PA26415	11190	CEP250	chr20	34032988	34108360	75372	centrosomal protein 250kDa
PA143485433	80184	CEP290	chr12	88439790	88545993	106203	centrosomal protein 290kDa
PA142671597	85459	CEP295	chr11	93384816	93466522	81706	centrosomal protein 295kDa
PA143485434	9857	CEP350	chr1	179913908	180087015	173107	centrosomal protein 350kDa
PA37039	95681	CEP41	chr7	130030612	130091051	60439	centrosomal protein 41kDa
PA134933992	80817	CEP44	chr4	175194828	175258506	63678	centrosomal protein 44kDa
PA25475	55165	CEP55	chr10	95246369	95291849	45480	centrosomal protein 55kDa
PA142672123	9702	CEP57	chr11	95513625	95568857	55232	centrosomal protein 57kDa
PA134980921	285753	CEP57L1	chr6	109406329	109488115	81786	centrosomal protein 57kDa-like 1
PA134872811	221017	CEP57L1P1	chr10	72139122	72153376	14254	centrosomal protein 57kDa-like 1 pseudogene 1
PA142672124	80254	CEP63	chr3	134194575	134296855	102280	centrosomal protein 63kDa
PA134991391	23177	CEP68	chr2	65273495	65317142	43647	centrosomal protein 68kDa
PA128394729	80321	CEP70	chr3	138210186	138323187	113001	centrosomal protein 70kDa
PA142672125	55722	CEP72	chr5	602405	658807	56402	centrosomal protein 72kDa
PA134916911	79959	CEP76	chr18	12658748	12712776	54028	centrosomal protein 76kDa
PA134937066	84131	CEP78	chr9	80840978	80889799	48821	centrosomal protein 78kDa
PA142672158	51134	CEP83	chr12	94699056	94863764	164708	centrosomal protein 83kDa
PA142672180	64793	CEP85	chr1	26550644	26608529	57885	centrosomal protein 85kDa
PA134984681	387119	CEP85L	chr6	118778935	119041238	262303	centrosomal protein 85kDa-like
PA147358250	84902	CEP89	chr19	33366904	33472930	106026	centrosomal protein 89kDa
PA142672162	90799	CEP95	chr17	62492878	62537069	44191	centrosomal protein 95kDa
PA162382176	79598	CEP97	chr3	101433436	101492404	58968	centrosomal protein 97kDa
PA134892657	10390	CEPT1	chr1	111672249	111730724	58475	choline/ethanolamine phosphotransferase 1
PA26417	9350	CER1	chr9	14716731	14732715	15984	cerberus 1, DAN family BMP antagonist
PA162382177	51148	CERCAM	chr9	131163854	131202630	38776	cerebral endothelial cell adhesion molecule
PA134958321	64781	CERK	chr22	47077307	47144152	66845	ceramide kinase
PA134984780	375298	CERKL	chr2	182398399	182531834	133435	ceramide kinase-like
PA30299	10715	CERS1	chr19	18976361	19017396	41035	ceramide synthase 1
PA30300	29956	CERS2	chr1	150934649	150957479	22830	ceramide synthase 2
PA134873153	204219	CERS3	chr15	100937600	101094925	157325	ceramide synthase 3
PA134915173	79603	CERS4	chr19	8264217	8330305	66088	ceramide synthase 4
PA134882694	91012	CERS5	chr12	50520581	50571154	50573	ceramide synthase 5
PA134925480	253782	CERS6	chr2	169302759	169634644	331885	ceramide synthase 6
PA107	1066	CES1	chr16	55833763	55877098	43335	carboxylesterase 1
PA377	8824	CES2	chr16	66958347	66981999	23652	carboxylesterase 2
PA26418	23491	CES3	chr16	66985132	67012052	26920	carboxylesterase 3
PA142672130	221223	CES5A	chr16	55877066	55999943	122877	carboxylesterase 5A
PA26419	1068	CETN1	chr18	570369	584524	14155	centrin, EF-hand protein, 1
PA26420	1069	CETN2	chrX	151992871	152009301	16430	centrin, EF-hand protein, 2
PA26421	1070	CETN3	chr5	89686528	89715611	29083	centrin, EF-hand protein, 3
PA108	1071	CETP	chr16	56985835	57020757	34922	cholesteryl ester transfer protein, plasma
PA142672403	257177	CFAP126	chr1	161331521	161347664	16143	cilia and flagella associated protein 126
PA162378384	29105	CFAP20	chr16	58144496	58173296	28800	cilia and flagella associated protein 20
PA145008608	112942	CFAP36	chr2	55736740	55775216	38476	cilia and flagella associated protein 36
PA134981723	80217	CFAP43	chr10	105886646	106002120	115474	cilia and flagella associated protein 43
PA134928828	55779	CFAP44	chr3	113002777	113170361	167584	cilia and flagella associated protein 44
PA142672179	25790	CFAP45	chr1	159839154	159879906	40752	cilia and flagella associated protein 45
PA38084	146845	CFAP52	chr17	9469944	9549776	79832	cilia and flagella associated protein 52
PA134960690	220136	CFAP53	chr18	47750563	47802865	52302	cilia and flagella associated protein 53
PA142670598	149465	CFAP57	chr1	43628001	43679549	51548	cilia and flagella associated protein 57
PA162381518	159686	CFAP58	chr10	106103522	106217848	114326	cilia and flagella associated protein 58
PA25741	26074	CFAP61	chr20	20023158	20344346	321188	cilia and flagella associated protein 61
PA162380735	79846	CFAP69	chr7	89864488	89943377	78889	cilia and flagella associated protein 69
PA134881300	118491	CFAP70	chr10	75010516	75128617	118101	cilia and flagella associated protein 70
PA142671598	85452	CFAP74	chr1	1881752	1945276	63524	cilia and flagella associated protein 74
PA134887257	57587	CFAP97	chr4	186077819	186135182	57363	cilia and flagella associated protein 97
PA25341	629	CFB	chr6	31903721	31922861	19140	complement factor B
PA134916180	55997	CFC1	chr2	131346738	131367148	20410	cripto, FRL-1, cryptic family 1
PA162382207	653275	CFC1B	chr2	131268667	131288565	19898	cripto, FRL-1, cryptic family 1B
PA142	1675	CFD	chr19	849665	866624	16959	complement factor D (adipsin)
PA26422	10428	CFDP1	chr16	75324608	75477387	152779	craniofacial development protein 1
PA29261	3075	CFH	chr1	196611008	196719634	108626	complement factor H
PA29265	3078	CFHR1	chr1	196778861	196804319	25458	complement factor H-related 1
PA29267	3080	CFHR2	chr1	196902888	196931356	28468	complement factor H-related 2
PA134909646	10878	CFHR3	chr1	196733925	196766203	32278	complement factor H-related 3
PA134960382	10877	CFHR4	chr1	196847144	196890843	43699	complement factor H-related 4
PA134937417	81494	CFHR5	chr1	196936667	196981804	45137	complement factor H-related 5
PA29641	3426	CFI	chr4	110658848	110733381	74533	complement factor I
PA26423	1072	CFL1	chr11	65619282	65635804	16522	cofilin 1 (non-muscle)
PA26424	1073	CFL2	chr14	35176588	35194029	17441	cofilin 2 (muscle)
PA26425	8837	CFLAR	chr2	201970877	202040411	69534	CASP8 and FADD-like apoptosis regulator
PA33206	5199	CFP	chrX	47480612	47499704	19092	complement factor properdin
PA109	1080	CFTR	chr7	117110017	117311719	201702	cystic fibrosis transmembrane conductance regulator (ATP-binding cassette sub-family C, member 7)
PA26433	1081	CGA	chr6	87792216	87814865	22649	glycoprotein hormones, alpha polypeptide
PA26434	1082	CGB	chr19	49523126	49537632	14506	chorionic gonadotropin, beta polypeptide
PA26435	114335	CGB1	chr19	49535826	49550191	14365	chorionic gonadotropin, beta polypeptide 1
PA26436	114336	CGB2	chr19	49525130	49539495	14365	chorionic gonadotropin, beta polypeptide 2
PA26437	93659	CGB5	chr19	49537102	49551568	14466	chorionic gonadotropin, beta polypeptide 5
PA26438	94027	CGB7	chr19	49554531	49571603	17072	chorionic gonadotropin, beta polypeptide 7
PA26439	94115	CGB8	chr19	49547895	49562368	14473	chorionic gonadotropin, beta polypeptide 8
PA26441	8545	CGGBP1	chr3	88098100	88209016	110916	CGG triplet repeat binding protein 1
PA134938123	57530	CGN	chr1	151473331	151514168	40837	cingulin
PA134972287	84952	CGNL1	chr15	57658703	57845925	187222	cingulin-like 1
PA134984105	10669	CGREF1	chr2	27319159	27351995	32836	cell growth regulator with EF-hand domain 1
PA134985671	10668	CGRRF1	chr14	54966587	55008334	41747	cell growth regulator with ring finger domain 1
PA26443	9023	CH25H	chr10	90962694	90977071	14377	cholesterol 25-hydroxylase
PA142672119	79094	CHAC1	chr15	41235636	41251717	16081	ChaC glutathione-specific gamma-glutamylcyclotransferase 1
PA142672120	494143	CHAC2	chr2	53984929	54005320	20391	ChaC, cation transport regulator homolog 2 (E. coli)
PA26445	1101	CHAD	chr17	48538853	48557242	18389	chondroadherin
PA162382224	150356	CHADL	chr22	41602861	41646935	44074	chondroadherin-like
PA26446	10036	CHAF1A	chr19	4392660	4446394	53734	chromatin assembly factor 1, subunit A (p150)
PA26447	8208	CHAF1B	chr21	37747689	37792125	44436	chromatin assembly factor 1, subunit B (p60)
PA162410749	283489	CHAMP1	chr13	115069965	115095803	25838	chromosome alignment maintaining phosphoprotein 1
PA26448	1103	CHAT	chr10	50807141	50876150	69009	choline O-acetyltransferase
PA134964437	118487	CHCHD1	chr10	75531808	75546406	14598	coiled-coil-helix-coiled-coil-helix domain containing 1
PA162382225	400916	CHCHD10	chr22	24105021	24120141	15120	coiled-coil-helix-coiled-coil-helix domain containing 10
PA134974636	51142	CHCHD2	chr7	56166266	56184187	17921	coiled-coil-helix-coiled-coil-helix domain containing 2
PA134983108	54927	CHCHD3	chr7	132466623	132776839	310216	coiled-coil-helix-coiled-coil-helix domain containing 3
PA134990707	131474	CHCHD4	chr3	14150577	14176371	25794	coiled-coil-helix-coiled-coil-helix domain containing 4
PA25896	84269	CHCHD5	chr2	113332023	113349617	17594	coiled-coil-helix-coiled-coil-helix domain containing 5
PA134899331	84303	CHCHD6	chr3	126413063	126682263	269200	coiled-coil-helix-coiled-coil-helix domain containing 6
PA134883538	79145	CHCHD7	chr8	57114315	57134178	19863	coiled-coil-helix-coiled-coil-helix domain containing 7
PA26451	1105	CHD1	chr5	98186689	98274522	87833	chromodomain helicase DNA binding protein 1
PA26452	9557	CHD1L	chr1	146704291	146770447	66156	chromodomain helicase DNA binding protein 1-like
PA26453	1106	CHD2	chr15	93432286	93574237	141951	chromodomain helicase DNA binding protein 2
PA26454	1107	CHD3	chr17	7778096	7819075	40979	chromodomain helicase DNA binding protein 3
PA26455	1108	CHD4	chr12	6676248	6726551	50303	chromodomain helicase DNA binding protein 4
PA134969178	26038	CHD5	chr1	6158847	6250194	91347	chromodomain helicase DNA binding protein 5
PA134974700	84181	CHD6	chr20	40027741	40257133	229392	chromodomain helicase DNA binding protein 6
PA134948695	55636	CHD7	chr8	61581321	61783587	202266	chromodomain helicase DNA binding protein 7
PA134957052	57680	CHD8	chr14	21850353	21934276	83923	chromodomain helicase DNA binding protein 8
PA128394727	80205	CHD9	chr16	53078905	53364414	285509	chromodomain helicase DNA binding protein 9
PA145149062	286464	CHDC2	chrX	36047125	36166187	119062	calponin homology domain containing 2
PA134873121	55349	CHDH	chr3	53847324	53890420	43096	choline dehydrogenase
PA110	1111	CHEK1	chr11	125485031	125549150	64119	checkpoint kinase 1
PA404	11200	CHEK2	chr22	29080731	29147822	67091	checkpoint kinase 2
PA26459	10523	CHERP	chr19	16625700	16663341	37641	calcium homeostasis endoplasmic reticulum protein
PA134898949	55743	CHFR	chr12	133413937	133491459	77522	checkpoint with forkhead and ring finger domains, E3 ubiquitin protein ligase
PA26461	1113	CHGA	chr14	93379445	93404638	25193	chromogranin A (parathyroid secretory protein 1)
PA26462	1114	CHGB	chr20	5881974	5909007	27033	chromogranin B (secretogranin 1)
PA26463	1116	CHI3L1	chr1	203145059	203165978	20919	chitinase 3-like 1 (cartilage glycoprotein-39)
PA26464	1117	CHI3L2	chr1	111760281	111789062	28781	chitinase 3-like 2
PA142672117	27159	CHIA	chr1	111823474	111866188	42714	chitinase, acidic
PA26465	53344	CHIC1	chrX	72772984	72909937	136953	cysteine-rich hydrophobic domain 1
PA26466	26511	CHIC2	chr4	54871540	54941562	70022	cysteine-rich hydrophobic domain 2
PA142672118	66005	CHID1	chr11	864859	925058	60199	chitinase domain containing 1
PA26467	1118	CHIT1	chr1	203182207	203208860	26653	chitinase 1 (chitotriosidase)
PA26468	1119	CHKA	chr11	67817326	67898858	81532	choline kinase alpha
PA26469	1120	CHKB	chr22	51014387	51031428	17041	choline kinase beta
PA26470	10752	CHL1	chr3	228279	454100	225821	cell adhesion molecule L1-like
PA26471	1121	CHM	chrX	85113185	85312566	199381	choroideremia (Rab escort protein 1)
PA26472	1122	CHML	chr1	241789166	241809232	20066	choroideremia-like (Rab escort protein 2)
PA33085	5119	CHMP1A	chr16	89707839	89734193	26354	charged multivesicular body protein 1A
PA142672110	57132	CHMP1B	chr18	11841389	11857448	16059	charged multivesicular body protein 1B
PA142672111	27243	CHMP2A	chr19	59059933	59076495	16562	charged multivesicular body protein 2A
PA142672112	25978	CHMP2B	chr3	87266413	87307698	41285	charged multivesicular body protein 2B
PA134920495	51652	CHMP3	chr2	86727553	86800620	73067	charged multivesicular body protein 3
PA134888743	29082	CHMP4A	chr14	24675787	24693036	17249	charged multivesicular body protein 4A
PA25721	128866	CHMP4B	chr20	32389110	32445173	56063	charged multivesicular body protein 4B
PA142672113	92421	CHMP4C	chr8	82634688	82674750	40062	charged multivesicular body protein 4C
PA134903143	51510	CHMP5	chr9	33254877	33285067	30190	charged multivesicular body protein 5
PA142672114	79643	CHMP6	chr17	78955641	78976933	21292	charged multivesicular body protein 6
PA142672115	91782	CHMP7	chr8	23091150	23122512	31362	charged multivesicular body protein 7
PA26473	1123	CHN1	chr2	175661042	175880671	219629	chimerin 1
PA26474	1124	CHN2	chr7	29223991	29556944	332953	chimerin 2
PA26475	140578	CHODL	chr21	19390190	19642687	252497	chondrolectin
PA26476	26973	CHORDC1	chr11	89930597	89966532	35935	cysteine and histidine-rich domain (CHORD) containing 1
PA162382245	79586	CHPF	chr2	220400669	220418487	17818	chondroitin polymerizing factor
PA165617920	54480	CHPF2	chr7	150919575	150938913	19338	chondroitin polymerizing factor 2
PA26477	56994	CHPT1	chr12	102081417	102125852	44435	choline phosphotransferase 1
PA26481	54108	CHRAC1	chr8	141511397	141530252	18855	chromatin accessibility complex 1
PA26482	8646	CHRD	chr3	184087861	184110617	22756	chordin
PA134933380	91851	CHRDL1	chrX	109914084	110049286	135202	chordin-like 1
PA134883081	25884	CHRDL2	chr11	74404474	74452227	47753	chordin-like 2
PA26483	89832	CHRFAM7A	chr15	30649769	30695864	46095	CHRNA7 (cholinergic receptor, nicotinic, alpha 7, exons 5-10) and FAM7A (family with sequence similarity 7A, exons A-E) fusion
PA26484	1128	CHRM1	chr11	62673151	62699012	25861	cholinergic receptor, muscarinic 1
PA111	1129	CHRM2	chr7	136543399	136706720	163321	cholinergic receptor, muscarinic 2
PA112	1131	CHRM3	chr1	239539876	240081750	541874	cholinergic receptor, muscarinic 3
PA26485	1132	CHRM4	chr11	46402335	46423122	20787	cholinergic receptor, muscarinic 4
PA26486	1133	CHRM5	chr15	34250446	34360295	109849	cholinergic receptor, muscarinic 5
PA26487	1134	CHRNA1	chr2	175609320	175639200	29880	cholinergic receptor, nicotinic, alpha 1 (muscle)
PA26488	57053	CHRNA10	chr11	3683817	3702614	18797	cholinergic receptor, nicotinic, alpha 10 (neuronal)
PA26489	1135	CHRNA2	chr8	27314278	27346813	32535	cholinergic receptor, nicotinic, alpha 2 (neuronal)
PA113	1136	CHRNA3	chr15	78882394	78923637	41243	cholinergic receptor, nicotinic, alpha 3 (neuronal)
PA26490	1137	CHRNA4	chr20	61971662	62019487	47825	cholinergic receptor, nicotinic, alpha 4 (neuronal)
PA26491	1138	CHRNA5	chr15	78847862	78890611	42749	cholinergic receptor, nicotinic, alpha 5 (neuronal)
PA26492	8973	CHRNA6	chr8	42604763	42633929	29166	cholinergic receptor, nicotinic, alpha 6 (neuronal)
PA114	1139	CHRNA7	chr15	32312686	32465384	152698	cholinergic receptor, nicotinic, alpha 7 (neuronal)
PA26493	55584	CHRNA9	chr4	40327346	40360234	32888	cholinergic receptor, nicotinic, alpha 9 (neuronal)
PA26494	1140	CHRNB1	chr17	7338406	7363932	25526	cholinergic receptor, nicotinic, beta 1 (muscle)
PA115	1141	CHRNB2	chr1	154530257	154555354	25097	cholinergic receptor, nicotinic, beta 2 (neuronal)
PA26495	1142	CHRNB3	chr8	42542562	42595209	52647	cholinergic receptor, nicotinic, beta 3 (neuronal)
PA26496	1143	CHRNB4	chr15	78913636	78943587	29951	cholinergic receptor, nicotinic, beta 4 (neuronal)
PA26497	1144	CHRND	chr2	233380870	233404375	23505	cholinergic receptor, nicotinic, delta (muscle)
PA26498	1145	CHRNE	chr17	4798064	4816369	18305	cholinergic receptor, nicotinic, epsilon (muscle)
PA26499	1146	CHRNG	chr2	233394424	233414038	19614	cholinergic receptor, nicotinic, gamma (muscle)
PA26501	8534	CHST1	chr11	45666239	45697206	30967	carbohydrate (keratan sulfate Gal-6) sulfotransferase 1
PA134920179	9486	CHST10	chr2	101005322	101044130	38808	carbohydrate sulfotransferase 10
PA134875681	50515	CHST11	chr12	104840692	105158792	318100	carbohydrate (chondroitin 4) sulfotransferase 11
PA134969008	55501	CHST12	chr7	2433195	2477242	44047	carbohydrate (chondroitin 4) sulfotransferase 12
PA134976803	166012	CHST13	chr3	126233131	126265134	32003	carbohydrate (chondroitin 4) sulfotransferase 13
PA162382258	113189	CHST14	chr15	40753160	40768357	15197	carbohydrate (N-acetylgalactosamine 4-0) sulfotransferase 14
PA165548385	51363	CHST15	chr10	125762669	125863200	100531	carbohydrate (N-acetylgalactosamine 4-sulfate 6-O) sulfotransferase 15
PA26502	9435	CHST2	chr3	142828618	142845856	17238	carbohydrate (N-acetylglucosamine-6-O) sulfotransferase 2
PA26503	9469	CHST3	chr10	73714120	73776322	62202	carbohydrate (chondroitin 6) sulfotransferase 3
PA26504	10164	CHST4	chr16	71550023	71575493	25470	carbohydrate (N-acetylglucosamine 6-O) sulfotransferase 4
PA26505	23563	CHST5	chr16	75559428	75580180	20752	carbohydrate (N-acetylglucosamine 6-O) sulfotransferase 5
PA26506	4166	CHST6	chr16	75504022	75538926	34904	carbohydrate (N-acetylglucosamine 6-O) sulfotransferase 6
PA26507	56548	CHST7	chrX	46423192	46460838	37646	carbohydrate (N-acetylglucosamine 6-O) sulfotransferase 7
PA26508	64377	CHST8	chr19	34102861	34267414	164553	carbohydrate (N-acetylgalactosamine 4-0) sulfotransferase 8
PA134888782	83539	CHST9	chr18	24491554	24775302	283748	carbohydrate (N-acetylgalactosamine 4-0) sulfotransferase 9
PA26509	22856	CHSY1	chr15	101712928	101802137	89209	chondroitin sulfate synthase 1
PA162382259	337876	CHSY3	chr5	129230389	129525327	294938	chondroitin sulfate synthase 3
PA134908713	63922	CHTF18	chr16	828622	851074	22452	CTF18, chromosome transmission fidelity factor 18 homolog (S. cerevisiae)
PA164717934	54921	CHTF8	chr16	69148912	69176493	27581	CTF8, chromosome transmission fidelity factor 8 homolog (S. cerevisiae)
PA142672526	26097	CHTOP	chr1	153596458	153621782	25324	chromatin target of PRMT1
PA26510	1147	CHUK	chr10	101945123	101999367	54244	conserved helix-loop-helix ubiquitous kinase
PA134982480	91612	CHURC1	chr14	65371079	65413635	42556	churchill domain containing 1
PA162382269	9391	CIAO1	chr2	96921884	96942917	21033	cytosolic iron-sulfur assembly component 1
PA134978864	57019	CIAPIN1	chr16	57459081	57491439	32358	cytokine induced apoptosis inhibitor 1
PA134921053	148523	CIART	chr1	150245229	150262501	17272	circadian associated repressor of transcription
PA38423	10519	CIB1	chr15	90770477	90818991	48514	calcium and integrin binding 1 (calmyrin)
PA134927274	10518	CIB2	chr15	78393948	78433877	39929	calcium and integrin binding family member 2
PA134867741	117286	CIB3	chr19	16269179	16294286	25107	calcium and integrin binding family member 3
PA162382288	130106	CIB4	chr2	26801073	26874211	73138	calcium and integrin binding family member 4
PA26513	23152	CIC	chr19	42778734	42802949	24215	capicua transcriptional repressor
PA26514	1149	CIDEA	chr18	12244318	12280594	36276	cell death-inducing DFFA-like effector a
PA26515	27141	CIDEB	chr14	24771393	24790576	19183	cell death-inducing DFFA-like effector b
PA134923736	63924	CIDEC	chr3	9905394	9931938	26544	cell death-inducing DFFA-like effector c
PA30795	4261	CIITA	chr16	10961055	11021840	60785	class II, major histocompatibility complex, transactivator
PA26518	8483	CILP	chr15	65485337	65513840	28503	cartilage intermediate layer protein, nucleotide pyrophosphohydrolase
PA134970563	148113	CILP2	chr19	19639057	19660468	21411	cartilage intermediate layer protein 2
PA165478684	51550	CINP	chr14	102811619	102839253	27634	cyclin-dependent kinase 2 interacting protein
PA134877961	85457	CIPC	chr14	77554578	77586630	32052	CLOCK-interacting pacemaker
PA165696415	9541	CIR1	chr2	175209878	175270443	60565	corepressor interacting with RBPJ, 1
PA26519	1153	CIRBP	chr19	1259267	1277809	18542	cold inducible RNA binding protein
PA26520	84916	CIRH1A	chr16	69156499	69205937	49438	cirrhosis, autosomal recessive 1A (cirhin)
PA162382289	55847	CISD1	chr10	60018862	60053752	34890	CDGSH iron sulfur domain 1
PA162382300	493856	CISD2	chr4	103739224	103816964	77740	CDGSH iron sulfur domain 2
PA162382311	284106	CISD3	chr17	36876510	36894858	18348	CDGSH iron sulfur domain 3
PA26521	1154	CISH	chr3	50640885	50659262	18377	cytokine inducible SH2-containing protein
PA26522	11113	CIT	chr12	120120595	120325095	204500	citron rho-interacting serine/threonine kinase
PA26523	4435	CITED1	chrX	71518488	71537037	18549	Cbp/p300-interacting transactivator, with Glu/Asp-rich carboxy-terminal domain, 1
PA26524	10370	CITED2	chr6	139690392	139705787	15395	Cbp/p300-interacting transactivator, with Glu/Asp-rich carboxy-terminal domain, 2
PA38643	163732	CITED4	chr1	41323728	41338018	14290	Cbp/p300-interacting transactivator, with Glu/Asp-rich carboxy-terminal domain, 4
PA134883336	25792	CIZ1	chr9	130925344	130976662	51318	CDKN1A interacting zinc finger protein 1
PA26526	26586	CKAP2	chr13	53019495	53053763	34268	cytoskeleton associated protein 2
PA144596448	150468	CKAP2L	chr2	113492444	113532254	39810	cytoskeleton associated protein 2-like
PA26527	10970	CKAP4	chr12	106628659	106651713	23054	cytoskeleton-associated protein 4
PA142672107	9793	CKAP5	chr11	46762084	46877859	115775	cytoskeleton associated protein 5
PA26528	1152	CKB	chr14	103982995	103999196	16201	creatine kinase, brain
PA26531	51192	CKLF	chr16	66576466	66606832	30366	chemokine-like factor
PA26532	1158	CKM	chr19	45806671	45836302	29631	creatine kinase, muscle
PA142672108	548596	CKMT1A	chr15	43975084	43994420	19336	creatine kinase, mitochondrial 1A
PA26533	1159	CKMT1B	chr15	43875055	43894604	19549	creatine kinase, mitochondrial 1B
PA26534	1160	CKMT2	chr5	80518605	80565217	46612	creatine kinase, mitochondrial 2 (sarcomeric)
PA38791	1163	CKS1B	chr1	154937118	154954725	17607	CDC28 protein kinase regulatory subunit 1B
PA26536	1164	CKS2	chr9	91916113	91934618	18505	CDC28 protein kinase regulatory subunit 2
PA38436	23332	CLASP1	chr2	122092352	122417052	324700	cytoplasmic linker associated protein 1
PA38435	23122	CLASP2	chr3	33534737	33769705	234968	cytoplasmic linker associated protein 2
PA134961731	11129	CLASRP	chr19	45532298	45577214	44916	CLK4-associating serine/arginine rich protein
PA26541	1178	CLC	chr19	40218893	40238669	19776	Charcot-Leyden crystal galectin
PA26542	1179	CLCA1	chr1	86924526	86968977	44451	chloride channel accessory 1
PA26543	9635	CLCA2	chr1	86879769	86925241	45472	chloride channel accessory 2
PA26544	9629	CLCA3P	chr1	87089959	87124059	34100	chloride channel accessory 3, pseudogene
PA26545	22802	CLCA4	chr1	87002759	87049437	46678	chloride channel accessory 4
PA142672105	23155	CLCC1	chr1	109469130	109516121	46991	chloride channel CLIC-like 1
PA142672106	23529	CLCF1	chr11	67128635	67151648	23013	cardiotrophin-like cytokine factor 1
PA26546	1180	CLCN1	chr7	143003219	143052097	48878	chloride channel, voltage-sensitive 1
PA26547	1181	CLCN2	chr3	184060973	184089439	28466	chloride channel, voltage-sensitive 2
PA26548	1182	CLCN3	chr4	170531672	170647338	115666	chloride channel, voltage-sensitive 3
PA26549	1183	CLCN4	chrX	10114985	10208700	93715	chloride channel, voltage-sensitive 4
PA26550	1184	CLCN5	chrX	49677225	49866892	189667	chloride channel, voltage-sensitive 5
PA26551	1185	CLCN6	chr1	11856153	11906201	50048	chloride channel, voltage-sensitive 6
PA26552	1186	CLCN7	chr16	1491934	1535085	43151	chloride channel, voltage-sensitive 7
PA26553	1187	CLCNKA	chr1	16338486	16363548	25062	chloride channel, voltage-sensitive Ka
PA26554	1188	CLCNKB	chr1	16360231	16386821	26590	chloride channel, voltage-sensitive Kb
PA26557	9076	CLDN1	chr3	190020490	190050235	29745	claudin 1
PA26558	9071	CLDN10	chr13	96075853	96235010	159157	claudin 10
PA26559	5010	CLDN11	chr3	170126653	170155479	28826	claudin 11
PA26560	9069	CLDN12	chr7	90022648	90048268	25620	claudin 12
PA26561	23562	CLDN14	chr21	37829919	37958867	128948	claudin 14
PA26562	24146	CLDN15	chr7	100872373	100892101	19728	claudin 15
PA26563	10686	CLDN16	chr3	190095661	190132932	37271	claudin 16
PA26564	26285	CLDN17	chr21	31535241	31548971	13730	claudin 17
PA26565	51208	CLDN18	chr3	137707658	137755494	47836	claudin 18
PA26566	149461	CLDN19	chr1	43195764	43215925	20161	claudin 19
PA26567	9075	CLDN2	chrX	106133394	106177091	43697	claudin 2
PA26568	49861	CLDN20	chr6	155575147	155600682	25535	claudin 20
PA26570	53842	CLDN22	chr4	184236220	184251927	15707	claudin 22
PA134961253	137075	CLDN23	chr8	8549666	8564617	14951	claudin 23
PA165663373	100132463	CLDN24	chr4	184239917	184253579	13662	claudin 24
PA165543379	644672	CLDN25	chr11	113640518	113654207	13689	claudin 25
PA26571	1365	CLDN3	chr7	73180327	73194600	14273	claudin 3
PA26572	1364	CLDN4	chr7	73235193	73250015	14822	claudin 4
PA26573	7122	CLDN5	chr22	19507547	19525068	17521	claudin 5
PA26574	9074	CLDN6	chr16	3061713	3078188	16475	claudin 6
PA26575	1366	CLDN7	chr17	7160222	7176863	16641	claudin 7
PA26576	9073	CLDN8	chr21	31583324	31598469	15145	claudin 8
PA26577	9080	CLDN9	chr16	3052457	3067506	15049	claudin 9
PA25901	56650	CLDND1	chr3	98216628	98251910	35282	claudin domain containing 1
PA144596447	125875	CLDND2	chr19	51867352	51882498	15146	claudin domain containing 2
PA134975011	10462	CLEC10A	chr17	6974856	6993626	18770	C-type lectin domain family 10, member A
PA34996	6320	CLEC11A	chr19	51216588	51231981	15393	C-type lectin domain family 11, member A
PA142672094	160364	CLEC12A	chr12	10093915	10150704	56789	C-type lectin domain family 12, member A
PA162382325	387837	CLEC12B	chr12	10153231	10174399	21168	C-type lectin domain family 12, member B
PA134890576	161198	CLEC14A	chr14	38720205	38735575	15370	C-type lectin domain family 14, member A
PA162382340	23274	CLEC16A	chr16	11028345	11279046	250701	C-type lectin domain family 16, member A
PA164717947	388512	CLEC17A	chr19	14683896	14724956	41060	C-type lectin domain family 17, member A
PA164717976	348174	CLEC18A	chr16	69974608	70001250	26642	C-type lectin domain family 18, member A
PA164718007	497190	CLEC18B	chr16	74439529	74465368	25839	C-type lectin domain family 18, member B
PA164718038	283971	CLEC18C	chr16	70197928	70224050	26122	C-type lectin domain family 18, member C
PA142672097	51267	CLEC1A	chr12	10220012	10261655	41643	C-type lectin domain family 1, member A
PA142672098	51266	CLEC1B	chr12	10142660	10163381	20721	C-type lectin domain family 1, member B
PA142672099	387836	CLEC2A	chr12	10048272	10094980	46708	C-type lectin domain family 2, member A
PA26582	9976	CLEC2B	chr12	10001968	10032458	30490	C-type lectin domain family 2, member B
PA142672100	29121	CLEC2D	chr12	9812304	9855151	42847	C-type lectin domain family 2, member D
PA142672101	154790	CLEC2L	chr7	139198674	139232731	34057	C-type lectin domain family 2, member L
PA26578	10143	CLEC3A	chr16	78046443	78069003	22560	C-type lectin domain family 3, member A
PA36590	7123	CLEC3B	chr3	45057759	45080563	22804	C-type lectin domain family 3, member B
PA26584	50856	CLEC4A	chr12	8266228	8294203	27975	C-type lectin domain family 4, member A
PA26585	170482	CLEC4C	chr12	7877235	7912069	34834	C-type lectin domain family 4, member C
PA134916109	338339	CLEC4D	chr12	8656136	8677962	21826	C-type lectin domain family 4, member D
PA26586	26253	CLEC4E	chr12	8682901	8703558	20657	C-type lectin domain family 4, member E
PA134968842	165530	CLEC4F	chr2	71032775	71057732	24957	C-type lectin domain family 4, member F
PA142672104	339390	CLEC4G	chr19	7790843	7807057	16214	C-type lectin domain family 4, member G
PA26200	10332	CLEC4M	chr19	7818035	7837491	19456	C-type lectin domain family 4, member M
PA26583	23601	CLEC5A	chr7	141624157	141656783	32626	C-type lectin domain family 5, member A
PA26579	93978	CLEC6A	chr12	8598591	8633926	35335	C-type lectin domain family 6, member A
PA26581	64581	CLEC7A	chr12	10266376	10292868	26492	C-type lectin domain family 7, member A
PA142672093	283420	CLEC9A	chr12	10173276	10221612	48336	C-type lectin domain family 9, member A
PA162382341	160365	CLECL1	chr12	9865456	9895895	30439	C-type lectin-like 1
PA26587	1047	CLGN	chr4	141306607	141358815	52208	calmegin
PA162379359	130162	CLHC1	chr2	55396683	55469699	73016	clathrin heavy chain linker domain containing 1
PA26588	1192	CLIC1	chr6	31695358	31715095	19737	chloride intracellular channel 1
PA26589	1193	CLIC2	chrX	154502500	154573997	71497	chloride intracellular channel 2
PA26590	9022	CLIC3	chr9	139886060	139902200	16140	chloride intracellular channel 3
PA26591	25932	CLIC4	chr1	25061760	25173815	112055	chloride intracellular channel 4
PA26592	53405	CLIC5	chr6	45863188	46058085	194897	chloride intracellular channel 5
PA26593	54102	CLIC6	chr21	36031612	36093525	61913	chloride intracellular channel 6
PA145149115	9685	CLINT1	chr5	157209751	157296183	86432	clathrin interactor 1
PA162382349	6249	CLIP1	chr12	122752981	122917179	164198	CAP-GLY domain containing linker protein 1
PA27085	7461	CLIP2	chr7	73693805	73823273	129468	CAP-GLY domain containing linker protein 2
PA162382439	25999	CLIP3	chr19	36502562	36533797	31235	CAP-GLY domain containing linker protein 3
PA162382440	79745	CLIP4	chr2	29310542	29409679	99137	CAP-GLY domain containing linker protein family, member 4
PA26594	1195	CLK1	chr2	201714732	201739467	24735	CDC-like kinase 1
PA26595	1196	CLK2	chr1	155229659	155253305	23646	CDC-like kinase 2
PA26597	1198	CLK3	chr15	74888327	74925542	37215	CDC-like kinase 3
PA26598	57396	CLK4	chr5	178026664	178064093	37429	CDC-like kinase 4
PA142672095	574028	CLLU1	chr12	92805307	92827778	22471	chronic lymphocytic leukemia up-regulated 1
PA142672096	574016	CLLU1OS	chr12	92810870	92831924	21054	chronic lymphocytic leukemia up-regulated 1 opposite strand
PA134945356	79789	CLMN	chr14	95645276	95796245	150969	calmin (calponin-like, transmembrane)
PA26601	1201	CLN3	chr16	28485600	28515897	30297	ceroid-lipofuscinosis, neuronal 3
PA26603	1203	CLN5	chr13	77556059	77579652	23593	ceroid-lipofuscinosis, neuronal 5
PA26604	54982	CLN6	chr15	68496330	68532081	35751	ceroid-lipofuscinosis, neuronal 6, late infantile, variant
PA26606	2055	CLN8	chr8	1693944	1737736	43792	ceroid-lipofuscinosis, neuronal 8 (epilepsy, progressive with mental retardation)
PA164718067	116449	CLNK	chr4	10488838	10696386	207548	cytokine-dependent hematopoietic cell linker
PA26607	1207	CLNS1A	chr11	77324196	77358851	34655	chloride channel, nucleotide-sensitive, 1A
PA26609	9575	CLOCK	chr4	56291068	56423076	132008	clock circadian regulator
PA162382477	10978	CLP1	chr11	57415216	57432337	17121	cleavage and polyadenylation factor I subunit 1
PA142672092	81570	CLPB	chr11	72000469	72155724	155255	ClpB caseinolytic peptidase B homolog (E. coli)
PA26610	8192	CLPP	chr19	6351463	6371915	20452	caseinolytic mitochondrial matrix peptidase proteolytic subunit
PA26611	1208	CLPS	chr6	35759759	35775121	15362	colipase, pancreatic
PA134984810	340204	CLPSL1	chr6	35738831	35758841	20010	colipase-like 1
PA134977993	389383	CLPSL2	chr6	35734343	35750329	15986	colipase-like 2
PA26613	1209	CLPTM1	chr19	45447842	45499604	51762	cleft lip and palate associated transmembrane protein 1
PA147358156	81037	CLPTM1L	chr5	1314869	1355180	40311	CLPTM1-like
PA26614	10845	CLPX	chr15	65439784	65487563	47779	caseinolytic mitochondrial matrix peptidase chaperone subunit
PA37231	7401	CLRN1	chr3	150640950	150700786	59836	clarin 1
PA162382499	645104	CLRN2	chr4	17506788	17531727	24939	clarin 2
PA162382510	119467	CLRN3	chr10	129673114	129701211	28097	clarin 3
PA134920757	63967	CLSPN	chr1	36182819	36245568	62749	claspin
PA38238	22883	CLSTN1	chr1	9786079	9894550	108471	calsyntenin 1
PA38239	64084	CLSTN2	chr3	139644027	140289919	645892	calsyntenin 2
PA38320	9746	CLSTN3	chr12	7271681	7314541	42860	calsyntenin 3
PA26616	1211	CLTA	chr9	36180853	36215059	34206	clathrin, light chain A
PA26617	1212	CLTB	chr5	175816456	175853570	37114	clathrin, light chain B
PA26618	1213	CLTC	chr17	57687050	57777317	90267	clathrin, heavy chain (Hc)
PA26619	8218	CLTCL1	chr22	19163986	19289247	125261	clathrin, heavy chain-like 1
PA26620	1191	CLU	chr8	27451434	27482328	30894	clusterin
PA128394600	23059	CLUAP1	chr16	3540945	3592048	51103	clusterin associated protein 1
PA142671614	23277	CLUH	chr17	2589680	2625053	35373	clustered mitochondria (cluA/CLU1) homolog
PA165450130	100132341	CLUHP3	chr16	31701934	31721758	19824	clustered mitochondria (cluA/CLU1) homolog pseudogene 3
PA26621	27098	CLUL1	chr18	586998	653298	66300	clusterin-like 1 (retinal)
PA165585423	157807	CLVS1	chr8	62190514	62417204	226690	clavesin 1
PA165617885	134829	CLVS2	chr6	123307582	123388063	80481	clavesin 2
PA26622	171425	CLYBL	chr13	100248919	100552388	303469	citrate lyase beta like
PA26623	1215	CMA1	chr14	24971712	24987471	15759	chymase 1, mast cell
PA38519	55907	CMAS	chr12	22189108	22221608	32500	cytidine monophosphate N-acetylneuraminic acid synthetase
PA162382521	134147	CMBL	chr5	10274707	10318168	43461	carboxymethylenebutenolidase homolog (Pseudomonas)
PA162382538	152100	CMC1	chr3	28272838	28364264	91426	C-x(9)-C motif containing 1
PA143485398	56942	CMC2	chr16	81006699	81050713	44014	C-x(9)-C motif containing 2
PA164723191	100272147	CMC4	chrX	154286897	154309547	22650	C-x(9)-C motif containing 4
PA26640	1240	CMKLR1	chr12	108678821	108743094	64273	chemokine-like receptor 1
PA162382539	51727	CMPK1	chr1	47789469	47847511	58042	cytidine monophosphate (UMP-CMP) kinase 1, cytosolic
PA162382556	129607	CMPK2	chr2	6977684	7016766	39082	cytidine monophosphate (UMP-CMP) kinase 2, mitochondrial
PA142672387	84319	CMSS1	chr3	99526678	99900476	373798	cms1 ribosomal small subunit homolog (yeast)
PA38811	113540	CMTM1	chr16	66589849	66616038	26189	CKLF-like MARVEL transmembrane domain containing 1
PA38812	146225	CMTM2	chr16	66603351	66625178	21827	CKLF-like MARVEL transmembrane domain containing 2
PA38813	123920	CMTM3	chr16	66627935	66650795	22860	CKLF-like MARVEL transmembrane domain containing 3
PA38814	146223	CMTM4	chr16	66645653	66740610	94957	CKLF-like MARVEL transmembrane domain containing 4
PA38815	116173	CMTM5	chr14	23836017	23851981	15964	CKLF-like MARVEL transmembrane domain containing 5
PA38816	54918	CMTM6	chr3	32519804	32554403	34599	CKLF-like MARVEL transmembrane domain containing 6
PA38817	112616	CMTM7	chr3	32423163	32499333	76170	CKLF-like MARVEL transmembrane domain containing 7
PA38818	152189	CMTM8	chr3	32270171	32414817	144646	CKLF-like MARVEL transmembrane domain containing 8
PA162389052	23070	CMTR1	chr6	37390907	37453637	62730	cap methyltransferase 1
PA162389041	55783	CMTR2	chr16	71312292	71333509	21217	cap methyltransferase 2
PA37868	202333	CMYA5	chr5	78975659	79099049	123390	cardiomyopathy associated 5
PA142672090	168975	CNBD1	chr8	87868676	88397955	529279	cyclic nucleotide binding domain containing 1
PA25694	140894	CNBD2	chr20	34546529	34621622	75093	cyclic nucleotide binding domain containing 2
PA37737	7555	CNBP	chr3	128883658	128912810	29152	CCHC-type zinc finger, nucleic acid binding protein
PA134907547	84735	CNDP1	chr18	72191692	72255261	63569	carnosine dipeptidase 1 (metallopeptidase M20 family)
PA134975242	55748	CNDP2	chr18	72153500	72193689	40189	CNDP dipeptidase 2 (metallopeptidase M20 family)
PA162406208	255919	CNEP1R1	chr16	50049121	50073999	24878	CTD nuclear envelope phosphatase 1 regulatory subunit 1
PA134938429	84518	CNFN	chr19	42888171	42904444	16273	cornifelin
PA26658	1259	CNGA1	chr4	47934994	48028646	93652	cyclic nucleotide gated channel alpha 1
PA26659	1260	CNGA2	chrX	150893218	150917036	23818	cyclic nucleotide gated channel alpha 2
PA26660	1261	CNGA3	chr2	98952618	99018064	65446	cyclic nucleotide gated channel alpha 3
PA26661	1262	CNGA4	chr11	6246724	6270066	23342	cyclic nucleotide gated channel alpha 4
PA26662	1258	CNGB1	chr16	57913244	58015020	101776	cyclic nucleotide gated channel beta 1
PA26663	54714	CNGB3	chr8	87583163	87765903	182740	cyclic nucleotide gated channel beta 3
PA134864821	10175	CNIH1	chr14	54890647	54918148	27501	cornichon family AMPA receptor auxiliary protein 1
PA134887358	254263	CNIH2	chr11	66035672	66054685	19013	cornichon family AMPA receptor auxiliary protein 2
PA134929862	149111	CNIH3	chr1	224724563	224931269	206706	cornichon family AMPA receptor auxiliary protein 3
PA142672091	29097	CNIH4	chr1	224534513	224570154	35641	cornichon family AMPA receptor auxiliary protein 4
PA134901167	10256	CNKSR1	chr1	26493981	26519375	25394	connector enhancer of kinase suppressor of Ras 1
PA134867759	22866	CNKSR2	chrX	21382532	21675813	293281	connector enhancer of kinase suppressor of Ras 2
PA134880153	154043	CNKSR3	chr6	154723433	154841753	118320	CNKSR family member 3
PA26665	1264	CNN1	chr19	11639579	11664139	24560	calponin 1, basic, smooth muscle
PA26666	1265	CNN2	chr19	1016274	1042064	25790	calponin 2
PA26667	1266	CNN3	chr1	95359507	95402735	43228	calponin 3, acidic
PA26668	26507	CNNM1	chr10	101078856	101157087	78231	cyclin and CBS domain divalent metal cation transport mediator 1
PA26669	54805	CNNM2	chr10	104668075	104841344	173269	cyclin and CBS domain divalent metal cation transport mediator 2
PA26670	26505	CNNM3	chr2	97470950	97504121	33171	cyclin and CBS domain divalent metal cation transport mediator 3
PA26671	26504	CNNM4	chr2	97416639	97480628	63989	cyclin and CBS domain divalent metal cation transport mediator 4
PA26672	23019	CNOT1	chr16	58550850	58673790	122940	CCR4-NOT transcription complex, subunit 1
PA134862503	25904	CNOT10	chr3	32716637	32818367	101730	CCR4-NOT transcription complex, subunit 10
PA134899354	55571	CNOT11	chr2	101859345	101889778	30433	CCR4-NOT transcription complex, subunit 11
PA26673	4848	CNOT2	chr12	70626774	70751773	124999	CCR4-NOT transcription complex, subunit 2
PA26674	4849	CNOT3	chr19	54631436	54662446	31010	CCR4-NOT transcription complex, subunit 3
PA26675	4850	CNOT4	chr7	135043547	135204875	161328	CCR4-NOT transcription complex, subunit 4
PA26677	57472	CNOT6	chr5	179911412	180008358	96946	CCR4-NOT transcription complex, subunit 6
PA38480	246175	CNOT6L	chr4	78631541	78750764	119223	CCR4-NOT transcription complex, subunit 6-like
PA26678	29883	CNOT7	chr8	17083737	17114387	30650	CCR4-NOT transcription complex, subunit 7
PA26679	9337	CNOT8	chr5	154227755	154259352	31597	CCR4-NOT transcription complex, subunit 8
PA26680	1267	CNP	chr17	40108737	40132754	24017	2',3'-cyclic nucleotide 3' phosphodiesterase
PA134874121	27013	CNPPD1	chr2	220033619	220052885	19266	cyclin Pas1/PHO80 domain containing 1
PA162382571	285888	CNPY1	chr7	155290953	155336539	45586	canopy FGF signaling regulator 1
PA162382584	10330	CNPY2	chr12	56701212	56720128	18916	canopy FGF signaling regulator 2
PA162382601	10695	CNPY3	chr6	42886860	42914666	27806	canopy FGF signaling regulator 3
PA162382618	245812	CNPY4	chr7	99707265	99726131	18866	canopy FGF signaling regulator 4
PA26681	1268	CNR1	chr6	88846583	88886063	39480	cannabinoid receptor 1 (brain)
PA26682	1269	CNR2	chr1	24194005	24295549	101544	cannabinoid receptor 2 (macrophage)
PA162382635	25927	CNRIP1	chr2	68508303	68557183	48880	cannabinoid receptor interacting protein 1
PA165751017	163882	CNST	chr1	246719639	246834884	115245	consortin, connexin sorting protein
PA142672089	124817	CNTD1	chr17	40940609	40966605	25996	cyclin N-terminal domain containing 1
PA144596444	79935	CNTD2	chr19	40725115	40742674	17559	cyclin N-terminal domain containing 2
PA26683	1270	CNTF	chr11	58380146	58396206	16060	ciliary neurotrophic factor
PA26684	1271	CNTFR	chr9	34548425	34600713	52288	ciliary neurotrophic factor receptor
PA162382646	54875	CNTLN	chr9	17124989	17506921	381932	centlein, centrosomal protein
PA26685	1272	CNTN1	chr12	41076244	41469214	392970	contactin 1
PA26686	6900	CNTN2	chr1	205002340	205050173	47833	contactin 2 (axonal)
PA26687	5067	CNTN3	chr3	74308719	74673587	364868	contactin 3 (plasmacytoma associated)
PA26688	152330	CNTN4	chr3	2130550	3102645	972095	contactin 4
PA26689	53942	CNTN5	chr11	98881706	100232616	1350910	contactin 5
PA26690	27255	CNTN6	chr3	1124342	1448278	323936	contactin 6
PA26691	8506	CNTNAP1	chr17	40824632	40855011	30379	contactin associated protein 1
PA26692	26047	CNTNAP2	chr7	145803453	148121090	2317637	contactin associated protein-like 2
PA134963289	79937	CNTNAP3	chr9	39067196	39298300	231104	contactin associated protein-like 3
PA142672087	728577	CNTNAP3B	chr9	43674885	43925476	250591	contactin associated protein-like 3B
PA134874662	85445	CNTNAP4	chr16	76301176	76596135	294959	contactin associated protein-like 4
PA134898715	129684	CNTNAP5	chr2	124772864	125675954	903090	contactin associated protein-like 5
PA26414	11064	CNTRL	chr9	123827170	123942888	115718	centriolin
PA143485436	116840	CNTROB	chr17	7825442	7856237	30795	centrobin, centrosomal BRCA2 interacting protein
PA162380473	55744	COA1	chr7	43645052	43779140	134088	cytochrome c oxidase assembly factor 1 homolog (S. cerevisiae)
PA142672172	28958	COA3	chr17	40946636	40960743	14107	cytochrome c oxidase assembly factor 3
PA142672121	51287	COA4	chr11	73580712	73597890	17178	cytochrome c oxidase assembly factor 4 homolog (S. cerevisiae)
PA162379390	493753	COA5	chr2	99212786	99234981	22195	cytochrome c oxidase assembly factor 5
PA25617	388753	COA6	chr1	234498932	234522795	23863	cytochrome c oxidase assembly factor 6
PA142672414	65260	COA7	chr1	53149014	53174038	25024	cytochrome c oxidase assembly factor 7 (putative)
PA134867942	80347	COASY	chr17	40703485	40721299	17814	CoA synthase
PA134869580	23242	COBL	chr7	51080909	51394515	313606	cordon-bleu WH2 repeat protein
PA134990267	22837	COBLL1	chr2	165533695	165708678	174983	cordon-bleu WH2 repeat protein-like 1
PA26693	1690	COCH	chr14	31333741	31367285	33544	cochlin
PA26696	9382	COG1	chr17	71179070	71207646	28576	component of oligomeric golgi complex 1
PA26697	22796	COG2	chr1	230768202	230832731	64529	component of oligomeric golgi complex 2
PA38602	83548	COG3	chr13	46029030	46113833	84803	component of oligomeric golgi complex 3
PA38603	25839	COG4	chr16	70511472	70567457	55985	component of oligomeric golgi complex 4
PA26698	10466	COG5	chr7	106839189	107214959	375770	component of oligomeric golgi complex 5
PA38604	57511	COG6	chr13	40219764	40368802	149038	component of oligomeric golgi complex 6
PA38605	91949	COG7	chr16	23396814	23474583	77769	component of oligomeric golgi complex 7
PA38606	84342	COG8	chr16	69359524	69383526	24002	component of oligomeric golgi complex 8
PA26700	8161	COIL	chr17	55012560	55048411	35851	coilin
PA26701	1300	COL10A1	chr6	116437085	116457296	20211	collagen, type X, alpha 1
PA26702	1301	COL11A1	chr1	103339023	103584052	245029	collagen, type XI, alpha 1
PA26703	1302	COL11A2	chr6	33127469	33170245	42776	collagen, type XI, alpha 2
PA26704	1303	COL12A1	chr6	75791042	75925623	134581	collagen, type XII, alpha 1
PA26706	1305	COL13A1	chr10	71551644	71721904	170260	collagen, type XIII, alpha 1
PA26707	7373	COL14A1	chr8	121127347	121387273	259926	collagen, type XIV, alpha 1
PA26708	1306	COL15A1	chr9	101695995	101836074	140079	collagen, type XV, alpha 1
PA26709	1307	COL16A1	chr1	32114848	32179768	64920	collagen, type XVI, alpha 1
PA26710	1308	COL17A1	chr10	105788046	105855638	67592	collagen, type XVII, alpha 1
PA26711	80781	COL18A1	chr21	46815058	46936634	121576	collagen, type XVIII, alpha 1
PA165378436	378832	COL18A1-AS1	chr21	46836631	46854985	18354	COL18A1 antisense RNA 1
PA26712	1310	COL19A1	chr6	70566448	70925157	358709	collagen, type XIX, alpha 1
PA35041	1277	COL1A1	chr17	48258457	48289003	30546	collagen, type I, alpha 1
PA35042	1278	COL1A2	chr7	94013873	94063544	49671	collagen, type I, alpha 2
PA142672086	57642	COL20A1	chr20	61914538	61965285	50747	collagen, type XX, alpha 1
PA26714	81578	COL21A1	chr6	55918388	56122544	204156	collagen, type XXI, alpha 1
PA134914705	169044	COL22A1	chr8	139597478	139936236	338758	collagen, type XXII, alpha 1
PA134899251	91522	COL23A1	chr5	177661617	178027573	365956	collagen, type XXIII, alpha 1
PA134932695	255631	COL24A1	chr1	86191916	86632121	440205	collagen, type XXIV, alpha 1
PA134912284	84570	COL25A1	chr4	109728877	110233799	504922	collagen, type XXV, alpha 1
PA134887081	136227	COL26A1	chr7	100996101	101205304	209203	collagen, type XXVI, alpha 1
PA134990818	85301	COL27A1	chr9	116908231	117075975	167744	collagen, type XXVII, alpha 1
PA143485437	340267	COL28A1	chr7	7395244	7585460	190216	collagen, type XXVIII, alpha 1
PA26715	1280	COL2A1	chr12	48363748	48408285	44537	collagen, type II, alpha 1
PA26716	1281	COL3A1	chr2	189829099	189880472	51373	collagen, type III, alpha 1
PA26717	1282	COL4A1	chr13	110798310	110969496	171186	collagen, type IV, alpha 1
PA26718	1284	COL4A2	chr13	110949631	111168374	218743	collagen, type IV, alpha 2
PA26719	1285	COL4A3	chr2	228019281	228182508	163227	collagen, type IV, alpha 3 (Goodpasture antigen)
PA26720	10087	COL4A3BP	chr5	74663928	74817806	153878	collagen, type IV, alpha 3 (Goodpasture antigen) binding protein
PA26721	1286	COL4A4	chr2	227864427	228039275	174848	collagen, type IV, alpha 4
PA26722	1287	COL4A5	chrX	107673019	107943775	270756	collagen, type IV, alpha 5
PA26723	1288	COL4A6	chrX	107395837	107692704	296867	collagen, type IV, alpha 6
PA26724	1289	COL5A1	chr9	137523651	137739689	216038	collagen, type V, alpha 1
PA26725	1290	COL5A2	chr2	189893641	190054668	161027	collagen, type V, alpha 2
PA26726	50509	COL5A3	chr19	10067237	10131147	63910	collagen, type V, alpha 3
PA26727	1291	COL6A1	chr21	47391663	47427963	36300	collagen, type VI, alpha 1
PA26728	1292	COL6A2	chr21	47508033	47555763	47730	collagen, type VI, alpha 2
PA26729	1293	COL6A3	chr2	238229655	238332850	103195	collagen, type VI, alpha 3
PA165696956	256076	COL6A5	chr3	130054359	130206690	152331	collagen, type VI, alpha 5
PA165697087	131873	COL6A6	chr3	130226198	130398890	172692	collagen, type VI, alpha 6
PA26730	1294	COL7A1	chr3	48598506	48642593	44087	collagen, type VII, alpha 1
PA26731	1295	COL8A1	chr3	99347440	99521061	173621	collagen, type VIII, alpha 1
PA26732	1296	COL8A2	chr1	36557840	36601305	43465	collagen, type VIII, alpha 2
PA26733	1297	COL9A1	chr6	70922743	71022786	100043	collagen, type IX, alpha 1
PA26734	1298	COL9A2	chr1	40763162	40792939	29777	collagen, type IX, alpha 2
PA26735	1299	COL9A3	chr20	61438414	61475511	37097	collagen, type IX, alpha 3
PA165543240	120376	COLCA2	chr11	111159976	111182353	22377	colorectal cancer associated 2
PA26736	10584	COLEC10	chr8	119954527	120122207	167680	collectin sub-family member 10 (C-type lectin)
PA26737	78989	COLEC11	chr2	3632422	3695234	62812	collectin sub-family member 11
PA26738	81035	COLEC12	chr18	316355	510729	194374	collectin sub-family member 12
PA134991138	79709	COLGALT1	chr19	17656511	17696968	40457	collagen beta(1-O)galactosyltransferase 1
PA25606	23127	COLGALT2	chr1	183895988	184016904	120916	collagen beta(1-O)galactosyltransferase 2
PA26743	8292	COLQ	chr3	15488640	15573277	84637	collagen-like tail subunit (single strand of homotrimer) of asymmetric acetylcholinesterase
PA134891368	150684	COMMD1	chr2	62105904	62366205	260301	copper metabolism (Murr1) domain containing 1
PA134862606	51397	COMMD10	chr5	115410727	115631978	221251	COMM domain containing 10
PA134923363	51122	COMMD2	chr3	149453257	149480287	27030	COMM domain containing 2
PA134864927	23412	COMMD3	chr10	22595312	22612246	16934	COMM domain containing 3
PA134993083	54939	COMMD4	chr15	75618352	75637268	18916	COMM domain containing 4
PA134873412	28991	COMMD5	chr8	146072551	146088932	16381	COMM domain containing 5
PA134906013	170622	COMMD6	chr13	76096350	76121991	25641	COMM domain containing 6
PA25799	149951	COMMD7	chr20	31287493	31341814	54321	COMM domain containing 7
PA134876825	54951	COMMD8	chr4	47449815	47475676	25861	COMM domain containing 8
PA134930445	29099	COMMD9	chr11	36290842	36320999	30157	COMM domain containing 9
PA26744	1311	COMP	chr19	18890583	18912114	21531	cartilage oligomeric matrix protein
PA117	1312	COMT	chr22	19919263	19960498	41235	catechol-O-methyltransferase
PA134961676	118881	COMTD1	chr10	76989760	77005802	16042	catechol-O-methyltransferase domain containing 1
PA26746	1314	COPA	chr1	160255377	160323354	67977	coatomer protein complex, subunit alpha
PA26747	1315	COPB1	chr11	14476049	14531441	55392	coatomer protein complex, subunit beta 1
PA26748	9276	COPB2	chr3	139073433	139118522	45089	coatomer protein complex, subunit beta 2 (beta prime)
PA26750	11316	COPE	chr19	19007323	19040199	32876	coatomer protein complex, subunit epsilon
PA26752	22820	COPG1	chr3	128958453	128999616	41163	coatomer protein complex, subunit gamma 1
PA143485403	55352	COPRS	chr17	30175884	30196326	20442	coordinator of PRMT5, differentiation stimulator
PA134952445	9318	COPS2	chr15	49414471	49457854	43383	COP9 signalosome subunit 2
PA26755	8533	COPS3	chr17	17146938	17194617	47679	COP9 signalosome subunit 3
PA26756	51138	COPS4	chr4	83946239	83999971	53732	COP9 signalosome subunit 4
PA26757	10987	COPS5	chr8	67952314	67984562	32248	COP9 signalosome subunit 5
PA134919933	10980	COPS6	chr7	99676583	99692823	16240	COP9 signalosome subunit 6
PA26758	50813	COPS7A	chr12	6823150	6844041	20891	COP9 signalosome subunit 7A
PA26759	64708	COPS7B	chr2	232636388	232676958	40570	COP9 signalosome subunit 7B
PA134968686	10920	COPS8	chr2	237983870	238010489	26619	COP9 signalosome subunit 8
PA26760	22818	COPZ1	chr12	54708874	54748635	39761	coatomer protein complex, subunit zeta 1
PA134862698	51226	COPZ2	chr17	46100533	46130908	30375	coatomer protein complex, subunit zeta 2
PA143485439	93058	COQ10A	chr12	56650642	56667750	17108	coenzyme Q10 homolog A (S. cerevisiae)
PA143485440	80219	COQ10B	chr2	198308231	198342851	34620	coenzyme Q10 homolog B (S. cerevisiae)
PA142672084	27235	COQ2	chr4	84181972	84216067	34095	coenzyme Q2 4-hydroxybenzoate polyprenyltransferase
PA134934287	51805	COQ3	chr6	99814279	99852082	37803	coenzyme Q3 methyltransferase
PA134957951	51117	COQ4	chr9	131074791	131099351	24560	coenzyme Q4
PA143485438	84274	COQ5	chr12	120938082	120976964	38882	coenzyme Q5 homolog, methyltransferase (S. cerevisiae)
PA134940980	51004	COQ6	chr14	74406637	74432815	26178	coenzyme Q6 monooxygenase
PA26761	10229	COQ7	chr16	19068917	19094417	25500	coenzyme Q7 homolog, ubiquinone (yeast)
PA142672085	57017	COQ9	chr16	57471337	57498187	26850	coenzyme Q9
PA134972424	10699	CORIN	chr4	47593015	47850395	257380	corin, serine peptidase
PA26768	11151	CORO1A	chr16	30184731	30203397	18666	coronin, actin binding protein, 1A
PA26769	57175	CORO1B	chr11	67202518	67221371	18853	coronin, actin binding protein, 1B
PA26770	23603	CORO1C	chr12	109035885	109135326	99441	coronin, actin binding protein, 1C
PA26771	7464	CORO2A	chr9	100880257	100964956	84699	coronin, actin binding protein, 2A
PA26772	10391	CORO2B	chr15	68841614	69023145	181531	coronin, actin binding protein, 2B
PA134869901	84940	CORO6	chr17	27938774	27959926	21152	coronin 6
PA134910806	79585	CORO7	chr16	4401543	4476962	75419	coronin 7
PA26773	1325	CORT	chr1	10499776	10515060	15284	cortistatin
PA38522	23406	COTL1	chr16	84596202	84661669	65467	coactosin-like F-actin binding protein 1
PA26776	1352	COX10	chr17	13962719	14114996	152277	COX10 heme A:farnesyltransferase cytochrome c oxidase assembly factor
PA26777	1353	COX11	chr17	53026259	53056064	29805	COX11 cytochrome c oxidase copper chaperone
PA143485391	84987	COX14	chr12	50493418	50517240	23822	COX14 cytochrome c oxidase assembly factor
PA26779	1355	COX15	chr10	101452886	101502423	49537	cytochrome c oxidase assembly homolog 15 (yeast)
PA162382755	51241	COX16	chr14	70788798	70836448	47650	COX16 cytochrome c oxidase assembly homolog (S. cerevisiae)
PA26780	10063	COX17	chr3	119385372	119406243	20871	COX17 cytochrome c oxidase copper chaperone
PA145008543	285521	COX18	chr4	73917416	73945476	28060	COX18 cytochrome c oxidase assembly factor
PA145008561	90639	COX19	chr7	1001486	1025235	23749	COX19 cytochrome c oxidase assembly factor
PA134976890	116228	COX20	chr1	244988608	245011359	22751	COX20 cytochrome c oxidase assembly factor
PA26781	1327	COX4I1	chr16	85823173	85843608	20435	cytochrome c oxidase subunit IV isoform 1
PA26783	84701	COX4I2	chr20	30215685	30235837	20152	cytochrome c oxidase subunit IV isoform 2 (lung)
PA26784	9377	COX5A	chr15	75209616	75240495	30879	cytochrome c oxidase subunit Va
PA26786	1329	COX5B	chr2	98252521	98267657	15136	cytochrome c oxidase subunit Vb
PA26794	1337	COX6A1	chr12	120865893	120881545	15652	cytochrome c oxidase subunit VIa polypeptide 1
PA26796	1339	COX6A2	chr16	31436052	31449749	13697	cytochrome c oxidase subunit VIa polypeptide 2
PA26797	1340	COX6B1	chr19	36129125	36152686	23561	cytochrome c oxidase subunit VIb polypeptide 1 (ubiquitous)
PA26800	1343	COX6B1P3	chr22	40955193	40968685	13492	cytochrome c oxidase subunit VIb polypeptide 1 (ubiquitous) pseudogene 3
PA134869389	125965	COX6B2	chr19	55858070	55876182	18112	cytochrome c oxidase subunit VIb polypeptide 2 (testis)
PA26802	1345	COX6C	chr8	100887223	100916242	29019	cytochrome c oxidase subunit VIc
PA26805	1346	COX7A1	chr19	36638824	36653771	14947	cytochrome c oxidase subunit VIIa polypeptide 1 (muscle)
PA26806	1347	COX7A2	chr6	75944391	75963644	19253	cytochrome c oxidase subunit VIIa polypeptide 2 (liver)
PA26807	9167	COX7A2L	chr2	42574640	42606150	31510	cytochrome c oxidase subunit VIIa polypeptide 2 like
PA26809	1349	COX7B	chrX	77144961	77163881	18920	cytochrome c oxidase subunit VIIb
PA134885922	170712	COX7B2	chr4	46733844	46921252	187408	cytochrome c oxidase subunit VIIb2
PA26812	1350	COX7C	chr5	85903784	85919583	15799	cytochrome c oxidase subunit VIIc
PA26814	1351	COX8A	chr11	63732079	63747015	14936	cytochrome c oxidase subunit VIIIA (ubiquitous)
PA134909890	341947	COX8C	chr14	93803537	93817700	14163	cytochrome c oxidase subunit VIIIC
PA26815	1356	CP	chr3	148877197	148949832	72635	ceruloplasmin (ferroxidase)
PA26816	1357	CPA1	chr7	130010290	130030949	20659	carboxypeptidase A1 (pancreatic)
PA26817	1358	CPA2	chr7	129896703	129932638	35935	carboxypeptidase A2 (pancreatic)
PA26818	1359	CPA3	chr3	148573043	148617874	44831	carboxypeptidase A3 (mast cell)
PA26819	51200	CPA4	chr7	129922974	129967020	44046	carboxypeptidase A4
PA26820	93979	CPA5	chr7	129974630	130011571	36941	carboxypeptidase A5
PA38444	57094	CPA6	chr8	68331405	68668620	337215	carboxypeptidase A6
PA134915057	27151	CPAMD8	chr19	17000762	17147625	146863	C3 and PZP-like, alpha-2-macroglobulin domain containing 8
PA26821	1360	CPB1	chr3	148498917	148580979	82062	carboxypeptidase B1 (tissue)
PA26822	1361	CPB2	chr13	46624201	46705318	81117	carboxypeptidase B2 (plasma)
PA26823	1362	CPD	chr17	28695942	28799675	103733	carboxypeptidase D
PA26824	1363	CPE	chr4	166290097	166422482	132385	carboxypeptidase E
PA134929879	64506	CPEB1	chr15	83208948	83326762	117814	cytoplasmic polyadenylation element binding protein 1
PA134864048	132864	CPEB2	chr4	14994298	15074777	80479	cytoplasmic polyadenylation element binding protein 2
PA134903478	22849	CPEB3	chr10	93803452	94060875	257423	cytoplasmic polyadenylation element binding protein 3
PA134869176	80315	CPEB4	chr5	173305331	173390313	84982	cytoplasmic polyadenylation element binding protein 4
PA162380636	79974	CPED1	chr7	120618751	120940498	321747	cadherin-like and PC-esterase domain containing 1
PA26826	10815	CPLX1	chr4	775745	829945	54200	complexin 1
PA26827	10814	CPLX2	chr5	175213542	175314024	100482	complexin 2
PA142672081	594855	CPLX3	chr15	75108951	75127136	18185	complexin 3
PA134902350	339302	CPLX4	chr18	56959634	56995881	36247	complexin 4
PA26828	1368	CPM	chr12	69241955	69367020	125065	carboxypeptidase M
PA26829	1369	CPN1	chr10	101799065	101851642	52577	carboxypeptidase N, polypeptide 1
PA26830	1370	CPN2	chr3	194057494	194082063	24569	carboxypeptidase N, polypeptide 2
PA26831	8904	CPNE1	chr20	34210953	34262878	51925	copine I
PA26832	221184	CPNE2	chr16	57116455	57185281	68826	copine II
PA26833	8895	CPNE3	chr8	87516656	87576726	60070	copine III
PA26834	131034	CPNE4	chr3	131249413	131769152	519739	copine IV
PA26835	57699	CPNE5	chr6	36705549	36817220	111671	copine V
PA26836	9362	CPNE6	chr14	24530046	24550309	20263	copine VI (neuronal)
PA26837	27132	CPNE7	chr16	89632176	89666654	34478	copine VII
PA134980029	144402	CPNE8	chr12	39043002	39310395	267393	copine VIII
PA142672082	151835	CPNE9	chr3	9735510	9774592	39082	copine family member IX
PA164741367	130749	CPO	chr2	207794278	207837198	42920	carboxypeptidase O
PA134979958	1371	CPOX	chr3	98293677	98322470	28793	coproporphyrinogen oxidase
PA164718110	55313	CPPED1	chr16	12750656	12907744	157088	calcineurin-like phosphoesterase domain containing 1
PA26840	1373	CPS1	chr2	211332406	211546831	214425	carbamoyl-phosphate synthase 1, mitochondrial
PA26841	29894	CPSF1	chr8	145615446	145644733	29287	cleavage and polyadenylation specific factor 1, 160kDa
PA26842	53981	CPSF2	chr14	92578298	92633543	55245	cleavage and polyadenylation specific factor 2, 100kDa
PA26843	51692	CPSF3	chr2	9553666	9616239	62573	cleavage and polyadenylation specific factor 3, 73kDa
PA142672080	54973	CPSF3L	chr1	1243965	1270067	26102	cleavage and polyadenylation specific factor 3-like
PA26844	10898	CPSF4	chr7	99026563	99057996	31433	cleavage and polyadenylation specific factor 4, 30kDa
PA162382768	642843	CPSF4L	chr17	71241588	71268019	26431	cleavage and polyadenylation specific factor 4-like
PA26846	11052	CPSF6	chr12	69623317	69671138	47821	cleavage and polyadenylation specific factor 6, 68kDa
PA165543380	79869	CPSF7	chr11	61167120	61207464	40344	cleavage and polyadenylation specific factor 7, 59kDa
PA26847	1374	CPT1A	chr11	68519088	68621878	102790	carnitine palmitoyltransferase 1A (liver)
PA26848	1375	CPT1B	chr22	51004290	51027096	22806	carnitine palmitoyltransferase 1B (muscle)
PA134922321	126129	CPT1C	chr19	50184363	50219988	35625	carnitine palmitoyltransferase 1C
PA26849	1376	CPT2	chr1	53652101	53682869	30768	carnitine palmitoyltransferase 2
PA162389853	80772	CPTP	chr1	1250143	1267276	17133	ceramide-1-phosphate transfer protein
PA26850	54504	CPVL	chr7	29032247	29235213	202966	carboxypeptidase, vitellogenic-like
PA26852	53336	CPXCR1	chrX	87992226	88012786	20560	CPX chromosome region, candidate 1
PA162382779	56265	CPXM1	chr20	2771715	2791292	19577	carboxypeptidase X (M14 family), member 1
PA134866722	119587	CPXM2	chr10	125502152	125661500	159348	carboxypeptidase X (M14 family), member 2
PA26854	8532	CPZ	chr4	8584387	8624488	40101	carboxypeptidase Z
PA26855	1378	CR1	chr1	207659473	207818110	158637	complement component (3b/4b) receptor 1 (Knops blood group)
PA26856	1379	CR1L	chr1	207808458	207900036	91578	complement component (3b/4b) receptor 1-like
PA26857	1380	CR2	chr1	207617645	207666240	48595	complement component (3d/Epstein Barr virus) receptor 2
PA26858	1381	CRABP1	chr15	78622666	78643572	20906	cellular retinoic acid binding protein 1
PA26859	1382	CRABP2	chr1	156666398	156685608	19210	cellular retinoic acid binding protein 2
PA144596438	84766	CRACR2A	chr12	3721494	3872366	150872	calcium release activated channel regulator 2A
PA144596437	283229	CRACR2B	chr11	817585	834991	17406	calcium release activated channel regulator 2B
PA26860	8738	CRADD	chr12	94061121	94292530	231409	CASP2 and RIPK1 domain containing adaptor with death domain
PA26861	57585	CRAMP1L	chr16	1652495	1730909	78414	Crm, cramped-like (Drosophila)
PA26862	1384	CRAT	chr9	131854073	131883070	28997	carnitine O-acetyltransferase
PA26863	23418	CRB1	chr1	197160592	197450585	289993	crumbs family member 1, photoreceptor morphogenesis associated
PA134910460	286204	CRB2	chr9	126108448	126144034	35586	crumbs family member 2
PA134862130	92359	CRB3	chr19	6453788	6470232	16444	crumbs family member 3
PA134926851	51185	CRBN	chr3	3188317	3231401	43084	cereblon
PA164718123	27297	CRCP	chr7	65569805	65622555	52750	CGRP receptor component
PA162382812	54544	CRCT1	chr1	152476978	152491481	14503	cysteine-rich C-terminal 1
PA26864	1385	CREB1	chr2	208384616	208473284	88668	cAMP responsive element binding protein 1
PA26865	10488	CREB3	chr9	35722317	35740005	17688	cAMP responsive element binding protein 3
PA134960108	90993	CREB3L1	chr11	46289189	46345972	56783	cAMP responsive element binding protein 3-like 1
PA134914841	64764	CREB3L2	chr7	137556725	137696847	140122	cAMP responsive element binding protein 3-like 2
PA134882161	84699	CREB3L3	chr19	4143598	4176051	32453	cAMP responsive element binding protein 3-like 3
PA134922919	148327	CREB3L4	chr1	153930315	153949840	19525	cAMP responsive element binding protein 3-like 4
PA134930491	9586	CREB5	chr7	28328940	28868511	539571	cAMP responsive element binding protein 5
PA26866	1387	CREBBP	chr16	3772055	3940121	168066	CREB binding protein
PA26868	1389	CREBL2	chr12	12754831	12801041	46210	cAMP responsive element binding protein-like 2
PA162380187	153222	CREBRF	chr5	172473355	172569291	95936	CREB3 regulatory factor
PA162382821	58487	CREBZF	chr11	85365608	85386182	20574	CREB/ATF bZIP transcription factor
PA26869	8804	CREG1	chr1	167507250	167533056	25806	cellular repressor of E1A-stimulated genes 1
PA134876243	200407	CREG2	chr2	101961816	102013965	52149	cellular repressor of E1A-stimulated genes 2
PA26870	78987	CRELD1	chr3	9965478	9990097	24619	cysteine-rich with EGF-like domains 1
PA142672079	79174	CRELD2	chr22	50302283	50324188	21905	cysteine-rich with EGF-like domains 2
PA26871	1390	CREM	chr10	35405769	35504886	99117	cAMP responsive element modulator
PA119	1392	CRH	chr8	67085612	67100846	15234	corticotropin releasing hormone
PA26873	1393	CRHBP	chr5	76238680	76268299	29619	corticotropin releasing hormone binding protein
PA26874	1394	CRHR1	chr17	43687710	43916194	228484	corticotropin releasing hormone receptor 1
PA26875	1395	CRHR2	chr7	30688559	30749719	61160	corticotropin releasing hormone receptor 2
PA26877	51232	CRIM1	chr2	36573370	36781278	207908	cysteine rich transmembrane BMP regulator 1 (chordin-like)
PA26878	1396	CRIP1	chr14	105942892	105958128	15236	cysteine-rich protein 1 (intestinal)
PA26879	1397	CRIP2	chr14	105929275	105949507	20232	cysteine-rich protein 2
PA134929489	401262	CRIP3	chr6	43270211	43287005	16794	cysteine-rich protein 3
PA145149095	285464	CRIPAK	chr4	1375340	1392782	17442	cysteine-rich PAK1 inhibitor
PA145149101	9419	CRIPT	chr2	46834325	46855881	21556	cysteine-rich PDZ-binding protein
PA24605	167	CRISP1	chr6	49798970	49854809	55839	cysteine-rich secretory protein 1
PA36703	7180	CRISP2	chr6	49657071	49691911	34840	cysteine-rich secretory protein 2
PA134880440	10321	CRISP3	chr6	49692089	49722168	30079	cysteine-rich secretory protein 3
PA142672076	83690	CRISPLD1	chr8	75886708	75949793	63085	cysteine-rich secretory protein LCCL domain containing 1
PA142672077	83716	CRISPLD2	chr16	84843587	84946116	102529	cysteine-rich secretory protein LCCL domain containing 2
PA26880	1398	CRK	chr17	1321647	1369561	47914	v-crk avian sarcoma virus CT10 oncogene homolog
PA26881	1399	CRKL	chr22	21261714	21311037	49323	v-crk avian sarcoma virus CT10 oncogene homolog-like
PA26882	9244	CRLF1	chr19	18701035	18727660	26625	cytokine receptor-like factor 1
PA26883	64109	CRLF2	chrY	1261869	1291529	29660	cytokine receptor-like factor 2
PA26884	51379	CRLF3	chr17	29106702	29161778	55076	cytokine receptor-like factor 3
PA25697	54675	CRLS1	chr20	5976739	6023699	46960	cardiolipin synthase 1
PA26885	1400	CRMP1	chr4	5819491	5904785	85294	collapsin response mediator protein 1
PA26886	51340	CRNKL1	chr20	20012005	20046690	34685	crooked neck pre-mRNA splicing factor 1
PA25601	49860	CRNN	chr1	152378719	152396750	18031	cornulin
PA134911945	9696	CROCC	chr1	17238445	17302474	64029	ciliary rootlet coiled-coil, rootletin
PA26887	54677	CROT	chr7	86964951	87032112	67161	carnitine O-octanoyltransferase
PA120	1401	CRP	chr1	159679079	159694396	15317	C-reactive protein, pentraxin-related
PA26899	55118	CRTAC1	chr10	99621757	99800585	178828	cartilage acidic protein 1
PA145149072	56253	CRTAM	chr11	122699255	122746347	47092	cytotoxic and regulatory T cell molecule
PA26900	10491	CRTAP	chr3	33145450	33192265	46815	cartilage associated protein
PA30730	23373	CRTC1	chr19	18784425	18896143	111718	CREB regulated transcription coactivator 1
PA142672073	200186	CRTC2	chr1	153917148	153941132	23984	CREB regulated transcription coactivator 2
PA142672074	64784	CRTC3	chr15	91063118	91191577	128459	CREB regulated transcription coactivator 3
PA26903	1406	CRX	chr19	48313807	48349587	35780	cone-rod homeobox
PA26904	1407	CRY1	chr12	107382142	107497635	115493	cryptochrome circadian clock 1
PA26905	1408	CRY2	chr11	45858669	45907799	49130	cryptochrome circadian clock 2
PA26906	1409	CRYAA	chr21	44579141	44595915	16774	crystallin, alpha A
PA26907	1410	CRYAB	chr11	111776350	111792473	16123	crystallin, alpha B
PA26908	1411	CRYBA1	chr17	27563875	27584512	20637	crystallin, beta A1
PA26909	1412	CRYBA2	chr2	219851912	219868127	16215	crystallin, beta A2
PA26910	1413	CRYBA4	chr22	27007928	27029636	21708	crystallin, beta A4
PA26911	1414	CRYBB1	chr22	26992362	27023991	31629	crystallin, beta B1
PA26912	1415	CRYBB2	chr22	25605612	25630836	25224	crystallin, beta B2
PA26914	1417	CRYBB3	chr22	25585817	25606326	20509	crystallin, beta B3
PA164718140	131544	CRYBG3	chr3	97530537	97666830	136293	beta-gamma crystallin domain containing 3
PA26915	1418	CRYGA	chr2	209022464	209038366	15902	crystallin, gamma A
PA26916	1419	CRYGB	chr2	209004297	209020877	16580	crystallin, gamma B
PA26917	1420	CRYGC	chr2	208989861	209004554	14693	crystallin, gamma C
PA26918	1421	CRYGD	chr2	208983331	208999313	15982	crystallin, gamma D
PA134870586	155051	CRYGN	chr7	151124056	151147256	23200	crystallin, gamma N
PA26922	1427	CRYGS	chr3	186253232	186273049	19817	crystallin, gamma S
PA26923	51084	CRYL1	chr13	20974806	21110012	135206	crystallin, lambda 1
PA26924	1428	CRYM	chr16	21266839	21324404	57565	crystallin, mu
PA26925	1429	CRYZ	chr1	75168170	75209092	40922	crystallin, zeta (quinone reductase)
PA26926	9946	CRYZL1	chr21	34958647	35024160	65513	crystallin, zeta (quinone reductase)-like 1
PA26928	1431	CS	chr12	56662483	56704175	41692	citrate synthase
PA38771	51380	CSAD	chr12	53548447	53585422	36975	cysteine sulfinic acid decarboxylase
PA134962241	158511	CSAG1	chrX	151893228	151912518	19290	chondrosarcoma associated gene 1
PA134919230	728461	CSAG2	chrX	151913686	151931738	18052	CSAG family, member 2
PA162382828	389903	CSAG3	chrX	151873743	151891833	18090	CSAG family, member 3
PA142672071	27254	CSDC2	chr22	41947014	41975670	28656	cold shock domain containing C2, RNA binding
PA142672072	7812	CSDE1	chr1	115256534	115310671	54137	cold shock domain containing E1, RNA-binding
PA26933	1434	CSE1L	chr20	47652783	47716497	63714	CSE1 chromosome segregation 1-like (yeast)
PA26935	1435	CSF1	chr1	110443233	110476616	33383	colony stimulating factor 1 (macrophage)
PA26936	1436	CSF1R	chr5	149429854	149502935	73081	colony stimulating factor 1 receptor
PA26937	1437	CSF2	chr5	131399485	131414863	15378	colony stimulating factor 2 (granulocyte-macrophage)
PA26938	1438	CSF2RA	chrY	1327693	1381828	54135	colony stimulating factor 2 receptor, alpha, low-affinity (granulocyte-macrophage)
PA26939	1439	CSF2RB	chr22	37299639	37339491	39852	colony stimulating factor 2 receptor, beta, low-affinity (granulocyte-macrophage)
PA26941	1440	CSF3	chr17	38161614	38177066	15452	colony stimulating factor 3 (granulocyte)
PA26942	1441	CSF3R	chr1	36928644	36958915	30271	colony stimulating factor 3 receptor (granulocyte)
PA162382829	55790	CSGALNACT1	chr8	19258672	19550261	291589	chondroitin sulfate N-acetylgalactosaminyltransferase 1
PA162382854	55454	CSGALNACT2	chr10	43623893	43683756	59863	chondroitin sulfate N-acetylgalactosaminyltransferase 2
PA26943	1442	CSH1	chr17	61969268	61984027	14759	chorionic somatomammotropin hormone 1 (placental lactogen)
PA26944	1443	CSH2	chr17	61946372	61961089	14717	chorionic somatomammotropin hormone 2
PA26945	1444	CSHL1	chr17	61983965	61998688	14723	chorionic somatomammotropin hormone-like 1
PA26946	1445	CSK	chr15	75064425	75098539	34114	c-src tyrosine kinase
PA26947	64478	CSMD1	chr8	2789875	4862328	2072453	CUB and Sushi multiple domains 1
PA134884681	114784	CSMD2	chr1	33976609	34641443	664834	CUB and Sushi multiple domains 2
PA134926063	114788	CSMD3	chr8	113232157	114459242	1227085	CUB and Sushi multiple domains 3
PA26948	1446	CSN1S1	chr4	70786799	70815288	28489	casein alpha s1
PA26950	1447	CSN2	chr4	70817974	70836726	18752	casein beta
PA26949	1448	CSN3	chr4	71098333	71120149	21816	casein kappa
PA26951	1452	CSNK1A1	chr5	148870896	148941115	70219	casein kinase 1, alpha 1
PA134917108	122011	CSNK1A1L	chr13	37674397	37689801	15404	casein kinase 1, alpha 1-like
PA26952	1453	CSNK1D	chr17	80194523	80241594	47071	casein kinase 1, delta
PA26953	1454	CSNK1E	chr22	38683697	38724089	40392	casein kinase 1, epsilon
PA26954	53944	CSNK1G1	chr15	64454716	64675968	221252	casein kinase 1, gamma 1
PA26955	1455	CSNK1G2	chr19	1931148	1984337	53189	casein kinase 1, gamma 2
PA26956	1456	CSNK1G3	chr5	122837793	122955739	117946	casein kinase 1, gamma 3
PA26957	1457	CSNK2A1	chr20	460338	534482	74144	casein kinase 2, alpha 1 polypeptide
PA26959	1459	CSNK2A2	chr16	58188811	58241782	52971	casein kinase 2, alpha prime polypeptide
PA26960	1460	CSNK2B	chr6	31622995	31640844	17849	casein kinase 2, beta polypeptide
PA26963	1464	CSPG4	chr15	75963663	76015189	51526	chondroitin sulfate proteoglycan 4
PA26964	114758	CSPG4P1Y	chrY	27619055	27635852	16797	chondroitin sulfate proteoglycan 4 pseudogene 1, Y-linked
PA142672065	84664	CSPG4P2Y	chrY	26326580	26343377	16797	chondroitin sulfate proteoglycan 4 pseudogene 2, Y-linked
PA26965	10675	CSPG5	chr3	47600728	47631730	31002	chondroitin sulfate proteoglycan 5 (neuroglycan C)
PA142672066	79848	CSPP1	chr8	67966588	68111849	145261	centrosome and spindle pole associated protein 1
PA25200	64651	CSRNP1	chr3	39180342	39206093	25751	cysteine-serine-rich nuclear protein 1
PA25503	81566	CSRNP2	chr12	51451988	51487454	35466	cysteine-serine-rich nuclear protein 2
PA164718184	80034	CSRNP3	chr2	166316157	166548917	232760	cysteine-serine-rich nuclear protein 3
PA26967	1465	CSRP1	chr1	201449658	201486387	36729	cysteine and glycine-rich protein 1
PA26968	1466	CSRP2	chr12	77249495	77282814	33319	cysteine and glycine-rich protein 2
PA26969	57325	CSRP2BP	chr20	18112868	18172031	59163	CSRP2 binding protein
PA26971	8048	CSRP3	chr11	19200577	19242118	41541	cysteine and glycine-rich protein 3 (cardiac LIM protein)
PA26972	1469	CST1	chr20	23725190	23741574	16384	cystatin SN
PA26974	140880	CST11	chr20	23428041	23443482	15441	cystatin 11
PA26975	1470	CST2	chr20	23801404	23817312	15908	cystatin SA
PA26976	1471	CST3	chr20	23605534	23628685	23151	cystatin C
PA26977	1472	CST4	chr20	23663277	23679662	16385	cystatin S
PA26978	1473	CST5	chr20	23853572	23870380	16808	cystatin D
PA26979	1474	CST6	chr11	65769462	65783976	14514	cystatin E/M
PA26980	8530	CST7	chr20	24919866	24943564	23698	cystatin F (leukocystatin)
PA26981	10047	CST8	chr20	23461766	23479655	17889	cystatin 8 (cystatin-related epididymal specific)
PA134898267	128822	CST9	chr20	23580047	23596610	16563	cystatin 9 (testatin)
PA26982	128821	CST9L	chr20	23542369	23559386	17017	cystatin 9-like
PA26983	1475	CSTA	chr3	122034011	122063816	29805	cystatin A (stefin A)
PA26984	1476	CSTB	chr21	45190546	45206256	15710	cystatin B (stefin B)
PA26985	1477	CSTF1	chr20	54957427	54982582	25155	cleavage stimulation factor, 3' pre-RNA, subunit 1, 50kDa
PA26986	1478	CSTF2	chrX	100065348	100098924	33576	cleavage stimulation factor, 3' pre-RNA, subunit 2, 64kDa
PA134933809	23283	CSTF2T	chr10	53452246	53469355	17109	cleavage stimulation factor, 3' pre-RNA, subunit 2, 64kDa, tau variant
PA26987	1479	CSTF3	chr11	33103130	33193037	89907	cleavage stimulation factor, 3' pre-RNA, subunit 3, 77kDa
PA26988	128817	CSTL1	chr20	23410322	23428567	18245	cystatin-like 1
PA164718185	541466	CT45A1	chrX	134837185	134859988	22803	cancer/testis antigen family 45, member A1
PA164718186	728911	CT45A2	chrX	134846887	134877268	30381	cancer/testis antigen family 45, member A2
PA164718201	441519	CT45A3	chrX	134864147	134894521	30374	cancer/testis antigen family 45, member A3
PA164718202	441520	CT45A4	chrX	134925587	134946735	21148	cancer/testis antigen family 45, member A4
PA164718203	441521	CT45A5	chrX	134942651	134973316	30665	cancer/testis antigen family 45, member A5
PA164718204	541465	CT45A6	chrX	134960213	134981244	21031	cancer/testis antigen family 45, member A6
PA164718206	728096	CT47A1	chrX	120113320	120129638	16318	cancer/testis antigen family 47, member A1
PA164718217	728036	CT47A10	chrX	120069555	120085873	16318	cancer/testis antigen family 47, member A10
PA164718228	255313	CT47A11	chrX	120064694	120081012	16318	cancer/testis antigen family 47, member A11
PA164718239	728090	CT47A2	chrX	120108460	120124778	16318	cancer/testis antigen family 47, member A2
PA164718250	728082	CT47A3	chrX	120103600	120119918	16318	cancer/testis antigen family 47, member A3
PA164718261	728075	CT47A4	chrX	120098740	120115058	16318	cancer/testis antigen family 47, member A4
PA164718272	728072	CT47A5	chrX	120093880	120110198	16318	cancer/testis antigen family 47, member A5
PA164718283	728062	CT47A6	chrX	120089019	120105337	16318	cancer/testis antigen family 47, member A6
PA164718294	653282	CT47A7	chrX	120084136	120100454	16318	cancer/testis antigen family 47, member A7
PA164718305	728049	CT47A8	chrX	120079276	120095594	16318	cancer/testis antigen family 47, member A8
PA164718316	728042	CT47A9	chrX	120074415	120090733	16318	cancer/testis antigen family 47, member A9
PA164718327	643311	CT47B1	chrX	120003451	120019779	16328	cancer/testis antigen family 47, member B1
PA134977669	54967	CT55	chrX	134287461	134315751	28290	cancer/testis antigen 55
PA165478559	196993	CT62	chr15	71399583	71417929	18346	cancer/testis antigen 62
PA162383081	203413	CT83	chrX	115589852	115604137	14285	cancer/testis antigen 83
PA134979749	246100	CTAG1A	chrX	153803418	153818075	14657	cancer/testis antigen 1A
PA26993	1485	CTAG1B	chrX	153842865	153857522	14657	cancer/testis antigen 1B
PA26994	30848	CTAG2	chrX	153877246	153891853	14607	cancer/testis antigen 2
PA134933936	64693	CTAGE1	chr18	19990564	20007878	17314	cutaneous T-cell lymphoma-associated antigen 1
PA134918814	220112	CTAGE3P	chr13	52478956	52494695	15739	CTAGE family, member 3, pseudogene
PA134946406	100128553	CTAGE4	chr7	143870548	143886173	15625	CTAGE family, member 4
PA30788	4253	CTAGE5	chr14	39724476	39823397	98921	CTAGE family, member 5
PA165617921	340307	CTAGE6	chr7	143449182	143464843	15661	CTAGE family, member 6
PA165617886	643854	CTAGE9	chr6	132026581	132042157	15576	CTAGE family, member 9
PA26995	1487	CTBP1	chr4	1202228	1252908	50680	C-terminal binding protein 1
PA26996	1488	CTBP2	chr10	126673418	126859624	186206	C-terminal binding protein 2
PA26997	1486	CTBS	chr1	85015804	85058039	42235	chitobiase, di-N-acetyl-
PA142672251	80169	CTC1	chr17	8125139	8161413	36274	CTS telomere maintenance complex component 1
PA26998	10664	CTCF	chr16	67586310	67676088	89778	CCCTC-binding factor (zinc finger protein)
PA26999	140690	CTCFL	chr20	56068021	56110708	42687	CCCTC-binding factor (zinc finger protein)-like
PA134937999	23399	CTDNEP1	chr17	7143906	7165259	21353	CTD nuclear envelope phosphatase 1
PA27001	9150	CTDP1	chr18	77429801	77517510	87709	CTD (carboxy-terminal domain, RNA polymerase II, polypeptide A) phosphatase, subunit 1
PA134938848	58190	CTDSP1	chr2	219253061	219273664	20603	CTD (carboxy-terminal domain, RNA polymerase II, polypeptide A) small phosphatase 1
PA128394568	10106	CTDSP2	chr12	58210710	58250747	40037	CTD (carboxy-terminal domain, RNA polymerase II, polypeptide A) small phosphatase 2
PA128394571	10217	CTDSPL	chr3	37893669	38028960	135291	CTD (carboxy-terminal domain, RNA polymerase II, polypeptide A) small phosphatase-like
PA142672063	51496	CTDSPL2	chr15	44709579	44822455	112876	CTD (carboxy-terminal domain, RNA polymerase II, polypeptide A) small phosphatase like 2
PA27002	1489	CTF1	chr16	30897928	30917881	19953	cardiotrophin 1
PA27003	1490	CTGF	chr6	132266316	132282518	16202	connective tissue growth factor
PA27004	1491	CTH	chr1	70866901	70908534	41633	cystathionine gamma-lyase
PA38701	115908	CTHRC1	chr8	104373743	104398233	24490	collagen triple helix repeat containing 1
PA134974369	9811	CTIF	chr18	46055427	46392588	337161	CBP80/20-dependent translation initiation factor
PA27006	1493	CTLA4	chr2	204722511	204741683	19172	cytotoxic T-lymphocyte-associated protein 4
PA27008	1495	CTNNA1	chr5	138079075	138273723	194648	catenin (cadherin-associated protein), alpha 1, 102kDa
PA27009	1496	CTNNA2	chr2	79730060	80878993	1148933	catenin (cadherin-associated protein), alpha 2
PA27010	29119	CTNNA3	chr10	67669276	69465949	1796673	catenin (cadherin-associated protein), alpha 3
PA27011	8727	CTNNAL1	chr9	111701849	111785829	83980	catenin (cadherin-associated protein), alpha-like 1
PA27013	1499	CTNNB1	chr3	41226401	41284939	58538	catenin (cadherin-associated protein), beta 1, 88kDa
PA27014	56998	CTNNBIP1	chr1	9905334	9980316	74982	catenin, beta interacting protein 1
PA27015	56259	CTNNBL1	chr20	36312357	36503531	191174	catenin, beta like 1
PA27016	1500	CTNND1	chr11	57510756	57589652	78896	catenin (cadherin-associated protein), delta 1
PA27017	1501	CTNND2	chr5	10968952	11914155	945203	catenin (cadherin-associated protein), delta 2
PA27019	1497	CTNS	chr17	3529762	3569397	39635	cystinosin, lysosomal cystine transporter
PA27020	1503	CTPS1	chr1	41435007	41481237	46230	CTP synthase 1
PA27021	56474	CTPS2	chrX	16603122	16741059	137937	CTP synthase 2
PA134896774	9646	CTR9	chr11	10762749	10804295	41546	CTR9, Paf1/RNA polymerase II complex component
PA27022	1504	CTRB1	chr16	75242884	75261822	18938	chymotrypsinogen B1
PA27023	440387	CTRB2	chr16	75234994	75251072	16078	chymotrypsinogen B2
PA27024	11330	CTRC	chr1	15754938	15776153	21215	chymotrypsin C (caldecrin)
PA27025	1506	CTRL	chr16	67960473	67975778	15305	chymotrypsin-like
PA33572	5476	CTSA	chr20	44509591	44530459	20868	cathepsin A
PA27027	1508	CTSB	chr8	11697033	11735646	38613	cathepsin B
PA27028	1075	CTSC	chr11	88023760	88080941	57181	cathepsin C
PA27029	1509	CTSD	chr11	1770982	1795222	24240	cathepsin D
PA27030	1510	CTSE	chr1	206307459	206335104	27645	cathepsin E
PA27031	8722	CTSF	chr11	66327935	66346047	18112	cathepsin F
PA27032	1511	CTSG	chr14	25039724	25055466	15742	cathepsin G
PA27033	1512	CTSH	chr15	79211092	79247436	36344	cathepsin H
PA27034	1513	CTSK	chr1	150765684	150790917	25233	cathepsin K
PA162382890	1514	CTSL	chr9	90330974	90349384	18410	cathepsin L
PA27040	1519	CTSO	chr4	156842270	156885048	42778	cathepsin O
PA27041	1520	CTSS	chr1	150699672	150748433	48761	cathepsin S
PA27036	1515	CTSV	chr9	99788959	99811925	22966	cathepsin V
PA27042	1521	CTSW	chr11	65637284	65654212	16928	cathepsin W
PA27043	1522	CTSZ	chr20	57567242	57592309	25067	cathepsin Z
PA27775	2017	CTTN	chr11	70234612	70285690	51078	cortactin
PA26774	83992	CTTNBP2	chr7	117347702	117523561	175859	cortactin binding protein 2
PA142672062	55917	CTTNBP2NL	chr1	112928800	113006786	77986	CTTNBP2 N-terminal like
PA165393368	90353	CTU1	chr19	51597863	51621647	23784	cytosolic thiouridylase subunit 1
PA165449882	348180	CTU2	chr16	88762891	88784794	21903	cytosolic thiouridylase subunit 2 homolog (S. pombe)
PA134944051	404217	CTXN1	chr19	7986381	8001051	14670	cortexin 1
PA134951739	399697	CTXN2	chr15	48460546	48498951	38405	cortexin 2
PA134959223	613212	CTXN3	chr5	126974713	126997322	22609	cortexin 3
PA27044	8029	CUBN	chr10	16862965	17181816	318851	cubilin (intrinsic factor-cobalamin receptor)
PA134913154	404093	CUEDC1	chr17	55935604	56042684	107080	CUE domain containing 1
PA134871975	79004	CUEDC2	chr10	104180002	104202423	22421	CUE domain containing 2
PA27047	8454	CUL1	chr7	148385631	148501202	115571	cullin 1
PA27048	8453	CUL2	chr10	35294479	35389570	95091	cullin 2
PA27049	8452	CUL3	chr2	225331867	225460114	128247	cullin 3
PA27050	8451	CUL4A	chr13	113852507	113922392	69885	cullin 4A
PA27051	8450	CUL4B	chrX	119655444	119719684	64240	cullin 4B
PA27052	8065	CUL5	chr11	107869408	107981495	112087	cullin 5
PA134897835	9820	CUL7	chr6	43002355	43031683	29328	cullin 7
PA164718328	23113	CUL9	chr6	43139913	43195325	55412	cullin 9
PA134928220	51596	CUTA	chr6	33381319	33396111	14792	cutA divalent cation tolerance homolog (E. coli)
PA134901980	51076	CUTC	chr10	101481958	101518894	36936	cutC copper transporter
PA162382924	1523	CUX1	chr7	101449184	101930250	481066	cut-like homeobox 1
PA162382977	23316	CUX2	chr12	111461828	111791358	329530	cut-like homeobox 2
PA134903546	50624	CUZD1	chr10	124588671	124615691	27020	CUB and zona pellucida-like domains 1
PA162383026	51503	CWC15	chr11	94692787	94716776	23989	CWC15 spliceosome-associated protein
PA164718415	57703	CWC22	chr2	180806603	180882024	75421	CWC22 spliceosome-associated protein
PA165431769	54883	CWC25	chr17	36953687	36991603	37916	CWC25 spliceosome-associated protein homolog (S. cerevisiae)
PA35594	10283	CWC27	chr5	64054755	64317590	262835	CWC27 spliceosome-associated protein homolog (S. cerevisiae)
PA134864340	55280	CWF19L1	chr10	101989055	102037437	48382	CWF19-like 1, cell cycle control (S. pombe)
PA134914164	143884	CWF19L2	chr11	107194071	107338572	144501	CWF19-like 2, cell cycle control (S. pombe)
PA165663488	80157	CWH43	chr4	48978264	49067096	88832	cell wall biogenesis 43 C-terminal homolog (S. cerevisiae)
PA35577	6376	CX3CL1	chr16	57396414	57421956	25542	chemokine (C-X3-C motif) ligand 1
PA27054	1524	CX3CR1	chr3	39301985	39333226	31241	chemokine (C-X3-C motif) receptor 1
PA27055	1525	CXADR	chr21	18875224	18968897	93673	coxsackie virus and adenovirus receptor
PA35050	2919	CXCL1	chr4	74725109	74740019	14910	chemokine (C-X-C motif) ligand 1 (melanoma growth stimulating activity, alpha)
PA35568	3627	CXCL10	chr4	76939269	76954689	15420	chemokine (C-X-C motif) ligand 10
PA35569	6373	CXCL11	chr4	76951835	76967350	15515	chemokine (C-X-C motif) ligand 11
PA35602	6387	CXCL12	chr10	44862601	44890545	27944	chemokine (C-X-C motif) ligand 12
PA35570	10563	CXCL13	chr4	78422907	78535988	113081	chemokine (C-X-C motif) ligand 13
PA35571	9547	CXCL14	chr5	134903369	134924969	21600	chemokine (C-X-C motif) ligand 14
PA27057	58191	CXCL16	chr17	4633828	4653223	19395	chemokine (C-X-C motif) ligand 16
PA162383045	284340	CXCL17	chr19	42929695	42957136	27441	chemokine (C-X-C motif) ligand 17
PA35051	2920	CXCL2	chr4	74959752	74974997	15245	chemokine (C-X-C motif) ligand 2
PA35052	2921	CXCL3	chr4	74899306	74914490	15184	chemokine (C-X-C motif) ligand 3
PA35573	6374	CXCL5	chr4	74858359	74874446	16087	chemokine (C-X-C motif) ligand 5
PA35574	6372	CXCL6	chr4	74692273	74707477	15204	chemokine (C-X-C motif) ligand 6
PA29841	3576	CXCL8	chr4	74596223	74612433	16210	chemokine (C-X-C motif) ligand 8
PA35495	4283	CXCL9	chr4	76919623	76938641	19018	chemokine (C-X-C motif) ligand 9
PA29842	3577	CXCR1	chr2	219024568	219041716	17148	chemokine (C-X-C motif) receptor 1
PA29843	3579	CXCR2	chr2	218980013	219004976	24963	chemokine (C-X-C motif) receptor 2
PA35049	2833	CXCR3	chrX	70832766	70848367	15601	chemokine (C-X-C motif) receptor 3
PA27058	7852	CXCR4	chr2	136868919	136885725	16806	chemokine (C-X-C motif) receptor 4
PA162383046	643	CXCR5	chr11	118744475	118769980	25505	chemokine (C-X-C motif) receptor 5
PA38409	10663	CXCR6	chr3	45974973	45992845	17872	chemokine (C-X-C motif) receptor 6
PA134908762	30827	CXXC1	chr18	47805713	47824692	18979	CXXC finger protein 1
PA134958275	392459	CXXC1P1	chrX	47556590	47599027	42437	CXXC finger protein 1 pseudogene 1
PA134992016	80319	CXXC4	chr4	105386463	105426058	39595	CXXC finger protein 4
PA128394661	51523	CXXC5	chr5	139018301	139066467	48166	CXXC finger protein 5
PA134932482	80231	CXorf21	chrX	30573941	30606033	32092	chromosome X open reading frame 21
PA134928182	170063	CXorf22	chrX	35927851	36011269	83418	chromosome X open reading frame 22
PA134885371	256643	CXorf23	chrX	19927978	19998427	70449	chromosome X open reading frame 23
PA145149070	645090	CXorf30	chrX	36236896	36406434	169538	chromosome X open reading frame 30
PA134972038	79742	CXorf36	chrX	45004618	45070146	65528	chromosome X open reading frame 36
PA134955144	159013	CXorf38	chrX	40483173	40516929	33756	chromosome X open reading frame 38
PA134915038	91966	CXorf40A	chrX	148612204	148635086	22882	chromosome X open reading frame 40A
PA142672057	541578	CXorf40B	chrX	149097415	149117068	19653	chromosome X open reading frame 40B
PA143485444	63932	CXorf56	chrX	118669112	118709397	40285	chromosome X open reading frame 56
PA145149058	55086	CXorf57	chrX	105845160	105925673	80513	chromosome X open reading frame 57
PA145149060	254158	CXorf58	chrX	23916123	23960624	44501	chromosome X open reading frame 58
PA164718500	158830	CXorf65	chrX	70320739	70336784	16045	chromosome X open reading frame 65
PA164718516	347487	CXorf66	chrX	139034884	139057677	22793	chromosome X open reading frame 66
PA27069	1534	CYB561	chr17	61506665	61533724	27059	cytochrome b561
PA134880796	220002	CYB561A3	chr11	61113220	61139755	26535	cytochrome b561 family, member A3
PA134872038	284613	CYB561D1	chr1	110026658	110046063	19405	cytochrome b561 family, member D1
PA134977950	11068	CYB561D2	chr3	50378265	50394500	16235	cytochrome b561 family, member D2
PA27068	1528	CYB5A	chr18	71917527	71969251	51724	cytochrome b5 type A (microsomal)
PA143485445	80777	CYB5B	chr16	69448498	69503167	54669	cytochrome b5 type B (outer mitochondrial membrane)
PA142672058	124637	CYB5D1	chr17	7751064	7768691	17627	cytochrome b5 domain containing 1
PA142672059	124936	CYB5D2	chr17	4036441	4063995	27554	cytochrome b5 domain containing 2
PA134979668	51706	CYB5R1	chr1	202928001	202946404	18403	cytochrome b5 reductase 1
PA142672060	51700	CYB5R2	chr11	7683326	7705807	22481	cytochrome b5 reductase 2
PA27331	1727	CYB5R3	chr22	43010846	43055405	44559	cytochrome b5 reductase 3
PA134904907	51167	CYB5R4	chr6	84559370	84673146	113776	cytochrome b5 reductase 4
PA164718527	606495	CYB5RL	chr1	54635009	54675746	40737	cytochrome b5 reductase-like
PA27075	1535	CYBA	chr16	88706697	88727492	20795	cytochrome b-245, alpha polypeptide
PA27076	1536	CYBB	chrX	37629266	37675718	46452	cytochrome b-245, beta polypeptide
PA134970061	79901	CYBRD1	chr2	172368757	172417643	48886	cytochrome b reductase 1
PA27077	1537	CYC1	chr8	145139960	145155428	15468	cytochrome c-1
PA134981636	54205	CYCS	chr7	25155270	25174980	19710	cytochrome c, somatic
PA38367	23191	CYFIP1	chr15	22882667	23006603	123936	cytoplasmic FMR1 interacting protein 1
PA38368	26999	CYFIP2	chr5	156683091	156825606	142515	cytoplasmic FMR1 interacting protein 2
PA27080	114757	CYGB	chr17	74520430	74543987	23557	cytoglobin
PA27081	50626	CYHR1	chr8	145672315	145701031	28716	cysteine/histidine-rich 1
PA27082	1538	CYLC1	chrX	83106134	83144708	38574	cylicin, basic protein of sperm head cytoskeleton 1
PA27083	1539	CYLC2	chr9	105747593	105783770	36177	cylicin, basic protein of sperm head cytoskeleton 2
PA27084	1540	CYLD	chr16	50765961	50838847	72886	cylindromatosis (turban tumor syndrome)
PA27089	1583	CYP11A1	chr15	74627103	74670081	42978	cytochrome P450, family 11, subfamily A, polypeptide 1
PA133	1584	CYP11B1	chr8	143950773	143971236	20463	cytochrome P450, family 11, subfamily B, polypeptide 1
PA134	1585	CYP11B2	chr8	143988975	144009259	20284	cytochrome P450, family 11, subfamily B, polypeptide 2
PA27090	1586	CYP17A1	chr10	104587288	104607290	20002	cytochrome P450, family 17, subfamily A, polypeptide 1
PA27091	1588	CYP19A1	chr15	51497254	51640795	143541	cytochrome P450, family 19, subfamily A, polypeptide 1
PA27092	1543	CYP1A1	chr15	75008883	75027951	19068	cytochrome P450, family 1, subfamily A, polypeptide 1
PA27093	1544	CYP1A2	chr15	75031184	75051941	20757	cytochrome P450, family 1, subfamily A, polypeptide 2
PA27094	1545	CYP1B1	chr2	38291746	38313323	21577	cytochrome P450, family 1, subfamily B, polypeptide 1
PA134911420	57404	CYP20A1	chr2	204093164	204173563	80399	cytochrome P450, family 20, subfamily A, polypeptide 1
PA27096	1589	CYP21A2	chr6	31996093	32012447	16354	cytochrome P450, family 21, subfamily A, polypeptide 2
PA27097	1591	CYP24A1	chr20	52766985	52800516	33531	cytochrome P450, family 24, subfamily A, polypeptide 1
PA27098	1592	CYP26A1	chr10	94823232	94840641	17409	cytochrome P450, family 26, subfamily A, polypeptide 1
PA134879191	56603	CYP26B1	chr2	72353367	72384991	31624	cytochrome P450, family 26, subfamily B, polypeptide 1
PA134913464	340665	CYP26C1	chr10	94810565	94832304	21739	cytochrome P450, family 26, subfamily C, polypeptide 1
PA135	1593	CYP27A1	chr2	219636472	219683016	46544	cytochrome P450, family 27, subfamily A, polypeptide 1
PA27099	1594	CYP27B1	chr12	58153117	58170976	17859	cytochrome P450, family 27, subfamily B, polypeptide 1
PA162383091	339761	CYP27C1	chr2	127938412	127987654	49242	cytochrome P450, family 27, subfamily C, polypeptide 1
PA27101	1553	CYP2A13	chr19	41584356	41605100	20744	cytochrome P450, family 2, subfamily A, polypeptide 13
PA121	1548	CYP2A6	chr19	41346441	41366360	19919	cytochrome P450, family 2, subfamily A, polypeptide 6
PA27102	1549	CYP2A7	chr19	41378344	41398657	20313	cytochrome P450, family 2, subfamily A, polypeptide 7
PA123	1555	CYP2B6	chr19	41487138	41527308	40170	cytochrome P450, family 2, subfamily B, polypeptide 6
PA127	1562	CYP2C18	chr10	96433251	96498947	65696	cytochrome P450, family 2, subfamily C, polypeptide 18
PA124	1557	CYP2C19	chr10	96512463	96615671	103208	cytochrome P450, family 2, subfamily C, polypeptide 19
PA125	1558	CYP2C8	chr10	96793529	96839255	45726	cytochrome P450, family 2, subfamily C, polypeptide 8
PA126	1559	CYP2C9	chr10	96688350	96752486	64136	cytochrome P450, family 2, subfamily C, polypeptide 9
PA128	1565	CYP2D6	chr22	42519501	42536883	17382	cytochrome P450, family 2, subfamily D, polypeptide 6
PA129	1571	CYP2E1	chr10	135330300	135355627	25327	cytochrome P450, family 2, subfamily E, polypeptide 1
PA27109	1572	CYP2F1	chr19	41610312	41637286	26974	cytochrome P450, family 2, subfamily F, polypeptide 1
PA27112	1573	CYP2J2	chr1	60355980	60402445	46465	cytochrome P450, family 2, subfamily J, polypeptide 2
PA134986407	120227	CYP2R1	chr11	14896551	14923874	27323	cytochrome P450, family 2, subfamily R, polypeptide 1
PA27113	29785	CYP2S1	chr19	41689115	41716444	27329	cytochrome P450, family 2, subfamily S, polypeptide 1
PA134924269	113612	CYP2U1	chr4	108842716	108877617	34901	cytochrome P450, family 2, subfamily U, polypeptide 1
PA134992665	54905	CYP2W1	chr7	1010100	1032276	22176	cytochrome P450, family 2, subfamily W, polypeptide 1
PA38452	51302	CYP39A1	chr6	46514317	46630567	116250	cytochrome P450, family 39, subfamily A, polypeptide 1
PA130	1576	CYP3A4	chr7	99351583	99391811	40228	cytochrome P450, family 3, subfamily A, polypeptide 4
PA427	64816	CYP3A43	chr7	99415636	99466727	51091	cytochrome P450, family 3, subfamily A, polypeptide 43
PA131	1577	CYP3A5	chr7	99242813	99287636	44823	cytochrome P450, family 3, subfamily A, polypeptide 5
PA122	1551	CYP3A7	chr7	99299660	99342853	43193	cytochrome P450, family 3, subfamily A, polypeptide 7
PA27117	10858	CYP46A1	chr14	100140755	100196638	55883	cytochrome P450, family 46, subfamily A, polypeptide 1
PA27118	1579	CYP4A11	chr1	47391846	47417156	25310	cytochrome P450, family 4, subfamily A, polypeptide 11
PA134979692	284541	CYP4A22	chr1	47593107	47617528	24421	cytochrome P450, family 4, subfamily A, polypeptide 22
PA27119	1580	CYP4B1	chr1	47254670	47288021	33351	cytochrome P450, family 4, subfamily B, polypeptide 1
PA27120	57834	CYP4F11	chr19	16020180	16055676	35496	cytochrome P450, family 4, subfamily F, polypeptide 11
PA38717	66002	CYP4F12	chr19	15773567	15810984	37417	cytochrome P450, family 4, subfamily F, polypeptide 12
PA27121	8529	CYP4F2	chr19	15985834	16018884	33050	cytochrome P450, family 4, subfamily F, polypeptide 2
PA162383112	126410	CYP4F22	chr19	15609336	15666128	56792	cytochrome P450, family 4, subfamily F, polypeptide 22
PA234	4051	CYP4F3	chr19	15741701	15774570	32869	cytochrome P450, family 4, subfamily F, polypeptide 3
PA405	11283	CYP4F8	chr19	15716029	15743448	27419	cytochrome P450, family 4, subfamily F, polypeptide 8
PA134912942	285440	CYP4V2	chr4	187102565	187137617	35052	cytochrome P450, family 4, subfamily V, polypeptide 2
PA134933184	260293	CYP4X1	chr1	47417036	47519423	102387	cytochrome P450, family 4, subfamily X, polypeptide 1
PA134941057	199974	CYP4Z1	chr1	47523160	47586992	63832	cytochrome P450, family 4, subfamily Z, polypeptide 1
PA27123	1595	CYP51A1	chr7	91738463	91774059	35596	cytochrome P450, family 51, subfamily A, polypeptide 1
PA132	1581	CYP7A1	chr8	59399737	59422720	22983	cytochrome P450, family 7, subfamily A, polypeptide 1
PA27124	9420	CYP7B1	chr8	65505529	65721348	215819	cytochrome P450, family 7, subfamily B, polypeptide 1
PA27125	1582	CYP8B1	chr3	42910684	42927633	16949	cytochrome P450, family 8, subfamily B, polypeptide 1
PA27126	3491	CYR61	chr1	86036444	86052650	16206	cysteine-rich, angiogenic inducer, 61
PA38343	192668	CYS1	chr2	10193926	10230538	36612	cystin 1
PA38453	10800	CYSLTR1	chrX	77523965	77593193	69228	cysteinyl leukotriene receptor 1
PA38518	57105	CYSLTR2	chr13	49217847	49286498	68651	cysteinyl leukotriene receptor 2
PA162380848	375791	CYSRT1	chr9	140109644	140123763	14119	cysteine-rich tail protein 1
PA162380028	84418	CYSTM1	chr5	139544653	139626374	81721	cysteine-rich transmembrane module containing 1
PA164718528	9267	CYTH1	chr17	76667130	76788376	121246	cytohesin 1
PA33849	9266	CYTH2	chr19	48962465	48988571	26106	cytohesin 2
PA164718590	9265	CYTH3	chr7	6198407	6322242	123835	cytohesin 3
PA164718621	27128	CYTH4	chr22	37668495	37714389	45894	cytohesin 4
PA164718652	9595	CYTIP	chr2	158268131	158310604	42473	cytohesin 1 interacting protein
PA134978681	54360	CYTL1	chr4	5013313	5031197	17884	cytokine-like 1
PA27127	116159	CYYR1	chr21	27835528	27955603	120075	cysteine/tyrosine-rich 1
PA38587	84663	CYorf15B	chrY	21719244	21772056	52812	chromosome Y open reading frame 15B
PA143485446	728294	D2HGDH	chr2	242664030	242711231	47201	D-2-hydroxyglutarate dehydrogenase
PA27129	23002	DAAM1	chr14	59645329	59841123	195794	dishevelled associated activator of morphogenesis 1
PA27130	23500	DAAM2	chr6	39750159	39875653	125494	dishevelled associated activator of morphogenesis 2
PA27131	1600	DAB1	chr1	57457453	58726211	1268758	Dab, reelin signal transducer, homolog 1 (Drosophila)
PA27132	1601	DAB2	chr5	39368776	39435335	66559	Dab, mitogen-responsive phosphoprotein, homolog 2 (Drosophila)
PA27133	153090	DAB2IP	chr9	124319162	124550809	231647	DAB2 interacting protein
PA27134	1602	DACH1	chr13	72009098	72451330	442232	dachshund family transcription factor 1
PA27135	117154	DACH2	chrX	85393455	86090605	697150	dachshund family transcription factor 2
PA134957283	51339	DACT1	chr14	59090786	59118039	27253	dishevelled-binding antagonist of beta-catenin 1
PA134934623	168002	DACT2	chr6	168690510	168730459	39949	dishevelled-binding antagonist of beta-catenin 2
PA162383145	147906	DACT3	chr19	47147869	47174395	26526	dishevelled-binding antagonist of beta-catenin 3
PA27136	1603	DAD1	chr14	23030807	23068143	37336	defender against cell death 1
PA27138	1605	DAG1	chr3	49496136	49576051	79915	dystroglycan 1 (dystrophin-associated glycoprotein 1)
PA162383158	747	DAGLA	chr11	61437905	61517474	79569	diacylglycerol lipase, alpha
PA162383203	221955	DAGLB	chr7	6445747	6497837	52090	diacylglycerol lipase, beta
PA142672014	26007	DAK	chr11	61090654	61123898	33244	dihydroxyacetone kinase 2 homolog (S. cerevisiae)
PA134921814	55152	DALRD3	chr3	49049832	49068504	18672	DALR anticodon binding domain containing 3
PA134875268	199699	DAND5	chr19	13070432	13088567	18135	DAN domain family member 5, BMP antagonist
PA27139	1610	DAO	chr12	109263806	109297710	33904	D-amino-acid oxidase
PA134924986	267012	DAOA	chr13	106108216	106146383	38167	D-amino acid oxidase activator
PA27140	1611	DAP	chr5	10676342	10771387	95045	death-associated protein
PA27141	7818	DAP3	chr1	155647693	155711801	64108	death associated protein 3
PA27142	1612	DAPK1	chr9	90102601	90326566	223965	death-associated protein kinase 1
PA27143	23604	DAPK2	chr15	64196235	64373614	177379	death-associated protein kinase 2
PA27144	1613	DAPK3	chr19	3955451	3981097	25646	death-associated protein kinase 3
PA134982815	92196	DAPL1	chr2	159641829	159675506	33677	death associated protein-like 1
PA27145	27071	DAPP1	chr4	100727957	100794347	66390	dual adaptor of phosphotyrosine and 3-phosphoinositides
PA27146	1615	DARS	chr2	136661252	136753254	92002	aspartyl-tRNA synthetase
PA142672015	55157	DARS2	chr1	173783719	173830682	46963	aspartyl-tRNA synthetase 2, mitochondrial
PA142670602	164781	DAW1	chr2	228726325	228792131	65806	dynein assembly factor with WDR repeat domains 1
PA27148	1616	DAXX	chr6	33283335	33300793	17458	death-domain associated protein
PA27149	1617	DAZ1	chrY	25272502	25355239	82737	deleted in azoospermia 1
PA27150	57055	DAZ2	chrY	25355604	25440503	84899	deleted in azoospermia 2
PA27151	57054	DAZ3	chrY	26906216	26969639	63423	deleted in azoospermia 3
PA27152	57135	DAZ4	chrY	26969967	27056187	86220	deleted in azoospermia 4
PA27153	26528	DAZAP1	chr19	1397584	1438683	41099	DAZ associated protein 1
PA27154	9802	DAZAP2	chr12	51622508	51643501	20993	DAZ associated protein 2
PA27155	1618	DAZL	chr3	16625299	16657006	31707	deleted in azoospermia-like
PA142672016	10926	DBF4	chr7	87495544	87541856	46312	DBF4 zinc finger
PA143485447	80174	DBF4B	chr17	42775976	42832637	56661	DBF4 zinc finger B
PA136	1621	DBH	chr9	136491485	136527466	35981	dopamine beta-hydroxylase (dopamine beta-monooxygenase)
PA27158	1622	DBI	chr2	120114504	120133122	18618	diazepam binding inhibitor (GABA receptor modulator, acyl-CoA binding protein)
PA27163	1627	DBN1	chr5	176880613	176910694	30081	drebrin 1
PA144596443	79007	DBNDD1	chr16	90068279	90095937	27658	dysbindin (dystrobrevin binding protein 1) domain containing 1
PA25749	55861	DBNDD2	chr20	44024633	44042250	17617	dysbindin (dystrobrevin binding protein 1) domain containing 2
PA27164	28988	DBNL	chr7	44074239	44104315	30076	drebrin-like
PA27165	1628	DBP	chr19	49130817	49150639	19822	D site of albumin promoter (albumin D-box) binding protein
PA27166	51163	DBR1	chr3	137876830	137903791	26961	debranching RNA lariats 1
PA27167	1629	DBT	chr1	100649478	100725409	75931	dihydrolipoamide branched chain transacylase E2
PA162383238	120237	DBX1	chr11	20174760	20191870	17110	developing brain homeobox 1
PA162383249	440097	DBX2	chr12	45405539	45454882	49343	developing brain homeobox 2
PA165585713	79269	DCAF10	chr9	37790551	37870666	80115	DDB1 and CUL4 associated factor 10
PA165478701	80344	DCAF11	chr14	24573906	24597451	23545	DDB1 and CUL4 associated factor 11
PA165585735	25853	DCAF12	chr9	34083381	34136771	53390	DDB1 and CUL4 associated factor 12
PA165756488	139170	DCAF12L1	chrX	125680366	125696842	16476	DDB1 and CUL4 associated factor 12-like 1
PA165756531	340578	DCAF12L2	chrX	125294482	125310080	15598	DDB1 and CUL4 associated factor 12-like 2
PA165585440	25879	DCAF13	chr8	104416942	104458681	41739	DDB1 and CUL4 associated factor 13
PA165393390	90379	DCAF15	chr19	14053319	14075256	21937	DDB1 and CUL4 associated factor 15
PA165663579	54876	DCAF16	chr4	17799278	17822386	23108	DDB1 and CUL4 associated factor 16
PA165696520	80067	DCAF17	chr2	172280761	172344562	63801	DDB1 and CUL4 associated factor 17
PA165478762	26094	DCAF4	chr14	73383040	73431825	48785	DDB1 and CUL4 associated factor 4
PA165663611	285429	DCAF4L1	chr4	41973713	41991484	17771	DDB1 and CUL4 associated factor 4-like 1
PA165585467	138009	DCAF4L2	chr8	88879971	88896296	16325	DDB1 and CUL4 associated factor 4-like 2
PA165478844	8816	DCAF5	chr14	69514637	69629914	115277	DDB1 and CUL4 associated factor 5
PA165751150	55827	DCAF6	chr1	167895797	168048081	152284	DDB1 and CUL4 associated factor 6
PA165431770	10238	DCAF7	chr17	61617796	61674641	56845	DDB1 and CUL4 associated factor 7
PA165751195	50717	DCAF8	chr1	160182505	160242350	59845	DDB1 and CUL4 associated factor 8
PA165756552	139425	DCAF8L1	chrX	27993110	28009566	16456	DDB1 and CUL4 associated factor 8-like 1
PA142672013	79877	DCAKD	chr17	43097706	43148473	50767	dephospho-CoA kinase domain containing
PA142672373	140947	DCANP1	chr5	134776904	134793038	16134	dendritic cell-associated nuclear protein
PA134903108	285761	DCBLD1	chr6	117793803	117894021	100218	discoidin, CUB and LCCL domain containing 1
PA134869307	131566	DCBLD2	chr3	98511814	98630566	118752	discoidin, CUB and LCCL domain containing 2
PA27170	1630	DCC	chr18	49856542	51065273	1208731	DCC netrin 1 receptor
PA27171	117159	DCD	chr12	55035375	55052277	16902	dermcidin
PA134970075	341019	DCDC1	chr11	31281171	31401357	120186	doublecortin domain containing 1
PA134978716	51473	DCDC2	chr6	24168983	24393520	224537	doublecortin domain containing 2
PA145008541	149069	DCDC2B	chr1	32664695	32684797	20102	doublecortin domain containing 2B
PA145008542	728597	DCDC2C	chr2	-1	-1	0	doublecortin domain containing 2C
PA162383262	100506627	DCDC5	chr11	30882150	31024233	142083	doublecortin domain containing 5
PA33000	8642	DCHS1	chr11	6639556	6695320	55764	dachsous cadherin-related 1
PA134953793	54798	DCHS2	chr4	155152527	155422930	270403	dachsous cadherin-related 2
PA137	1633	DCK	chr4	71849265	71899631	50366	deoxycytidine kinase
PA162383325	9201	DCLK1	chr13	36339789	36715514	375725	doublecortin-like kinase 1
PA162383366	166614	DCLK2	chr4	150989426	151181609	192183	doublecortin-like kinase 2
PA162383403	85443	DCLK3	chr3	36750913	36791352	40439	doublecortin-like kinase 3
PA27174	9937	DCLRE1A	chr10	115591483	115624163	32680	DNA cross-link repair 1A
PA27175	64858	DCLRE1B	chr1	114437915	114459708	21793	DNA cross-link repair 1B
PA27176	64421	DCLRE1C	chr10	14945870	15006106	60236	DNA cross-link repair 1C
PA27177	1634	DCN	chr12	91536035	91586806	50771	decorin
PA134931379	55802	DCP1A	chr3	53314443	53391654	77211	decapping mRNA 1A
PA134889143	196513	DCP1B	chr12	2052214	2123677	71463	decapping mRNA 1B
PA134898646	167227	DCP2	chr5	112302399	112360892	58493	decapping mRNA 2
PA134863866	28960	DCPS	chr11	126163647	126218644	54997	decapping enzyme, scavenger
PA142672005	149095	DCST1	chr1	154996256	155026406	30150	DC-STAMP domain containing 1
PA142672006	127579	DCST2	chr1	154988003	155016257	28254	DC-STAMP domain containing 2
PA134938623	81501	DCSTAMP	chr8	105342024	105371917	29893	dendrocyte expressed seven transmembrane protein
PA27179	1638	DCT	chr13	95088835	95141936	53101	dopachrome tautomerase
PA138	1635	DCTD	chr4	183808244	183848630	40386	dCMP deaminase
PA27180	1639	DCTN1	chr2	74585281	74629214	43933	dynactin 1
PA27181	10540	DCTN2	chr12	57920833	57951114	30281	dynactin 2 (p50)
PA27182	11258	DCTN3	chr9	34610542	34630520	19978	dynactin 3 (p22)
PA27183	51164	DCTN4	chr5	150085309	150148657	63348	dynactin 4 (p62)
PA142672007	84516	DCTN5	chr16	23642687	23688068	45381	dynactin 5 (p25)
PA134927975	10671	DCTN6	chr8	30003813	30044155	40342	dynactin 6
PA164718733	79077	DCTPP1	chr16	30432019	30451373	19354	dCTP pyrophosphatase 1
PA142672008	54165	DCUN1D1	chr3	182657153	182713731	56578	DCN1, defective in cullin neddylation 1, domain containing 1
PA134941036	55208	DCUN1D2	chr13	114107134	114155024	47890	DCN1, defective in cullin neddylation 1, domain containing 2
PA142672009	123879	DCUN1D3	chr16	20863219	20921561	58342	DCN1, defective in cullin neddylation 1, domain containing 3
PA142672010	23142	DCUN1D4	chr4	52690010	52786003	95993	DCN1, defective in cullin neddylation 1, domain containing 4
PA142672011	84259	DCUN1D5	chr11	102918413	102972944	54531	DCN1, defective in cullin neddylation 1, domain containing 5
PA27184	1641	DCX	chrX	110534007	110665460	131453	doublecortin
PA38772	51181	DCXR	chr17	79990757	80005573	14816	dicarbonyl/L-xylulose reductase
PA162383418	79016	DDA1	chr19	17410337	17437107	26770	DET1 and DDB1 associated 1
PA27185	23576	DDAH1	chr1	85781168	86054046	272878	dimethylarginine dimethylaminohydrolase 1
PA27186	23564	DDAH2	chr6	31691817	31708039	16222	dimethylarginine dimethylaminohydrolase 2
PA27187	1642	DDB1	chr11	61063919	61110691	46772	damage-specific DNA binding protein 1, 127kDa
PA27188	1643	DDB2	chr11	47226493	47263769	37276	damage-specific DNA binding protein 2, 48kDa
PA140	1644	DDC	chr7	50523134	50643154	120020	dopa decarboxylase (aromatic L-amino acid decarboxylase)
PA134861440	80821	DDHD1	chr14	53500458	53630046	129588	DDHD domain containing 1
PA128394618	23259	DDHD2	chr8	38078861	38123351	44490	DDHD domain containing 2
PA142672003	414301	DDI1	chr11	103897308	103912922	15614	DNA-damage inducible 1 homolog 1 (S. cerevisiae)
PA142672004	84301	DDI2	chr1	15933953	15998539	64586	DNA-damage inducible 1 homolog 2 (S. cerevisiae)
PA162377743	220042	DDIAS	chr11	82602737	82648701	45964	DNA damage-induced apoptosis suppressor
PA27193	1649	DDIT3	chr12	57907371	57924300	16929	DNA-damage-inducible transcript 3
PA134977994	54541	DDIT4	chr10	74023677	74038797	15120	DNA-damage-inducible transcript 4
PA128394749	115265	DDIT4L	chr4	101103267	101121939	18672	DNA-damage-inducible transcript 4-like
PA134906790	23109	DDN	chr12	49385933	49403088	17155	dendrin
PA27194	8528	DDO	chr6	110706545	110746839	40294	D-aspartate oxidase
PA27195	1650	DDOST	chr1	20975260	20998037	22777	dolichyl-diphosphooligosaccharide--protein glycosyltransferase subunit (non-catalytic)
PA24348	780	DDR1	chr6	30840694	30870933	30239	discoidin domain receptor tyrosine kinase 1
PA27196	4921	DDR2	chr1	162592228	162759409	167181	discoidin domain receptor tyrosine kinase 2
PA164718734	65992	DDRGK1	chr20	3168012	3195295	27283	DDRGK domain containing 1
PA27197	1652	DDT	chr22	24310554	24332019	21465	D-dopachrome tautomerase
PA162383433	100037417	DDTL	chr22	24298652	24317748	19096	D-dopachrome tautomerase-like
PA27199	1653	DDX1	chr2	15721745	15774235	52490	DEAD (Asp-Glu-Ala-Asp) box helicase 1
PA27200	1662	DDX10	chr11	108525816	108814650	288834	DEAD (Asp-Glu-Ala-Asp) box polypeptide 10
PA27201	1663	DDX11	chr12	31216779	31260733	43954	DEAD/H (Asp-Glu-Ala-Asp/His) box helicase 11
PA27206	10521	DDX17	chr22	38876443	38913622	37179	DEAD (Asp-Glu-Ala-Asp) box helicase 17
PA27207	8886	DDX18	chr2	118562255	118592953	30698	DEAD (Asp-Glu-Ala-Asp) box polypeptide 18
PA134894996	55308	DDX19A	chr16	70370764	70410286	39522	DEAD (Asp-Glu-Ala-Asp) box polypeptide 19A
PA27208	11269	DDX19B	chr16	70313670	70370735	57065	DEAD (Asp-Glu-Ala-Asp) box polypeptide 19B
PA27209	11218	DDX20	chr1	112288190	112313199	25009	DEAD (Asp-Glu-Ala-Asp) box polypeptide 20
PA27210	9188	DDX21	chr10	70705879	70747825	41946	DEAD (Asp-Glu-Ala-Asp) box helicase 21
PA134934941	9416	DDX23	chr12	49220539	49255957	35418	DEAD (Asp-Glu-Ala-Asp) box polypeptide 23
PA27211	57062	DDX24	chr14	94514268	94557558	43290	DEAD (Asp-Glu-Ala-Asp) box helicase 24
PA38644	29118	DDX25	chr11	125764261	125796005	31744	DEAD (Asp-Glu-Ala-Asp) box helicase 25
PA134921149	203522	DDX26B	chrX	134644555	134719460	74905	DEAD/H (Asp-Glu-Ala-Asp/His) box polypeptide 26B
PA27213	55661	DDX27	chr20	47825832	47863614	37782	DEAD (Asp-Glu-Ala-Asp) box polypeptide 27
PA27214	55794	DDX28	chr16	68052177	68067770	15593	DEAD (Asp-Glu-Ala-Asp) box polypeptide 28
PA27218	64794	DDX31	chr9	135465384	135555788	90404	DEAD (Asp-Glu-Ala-Asp) box polypeptide 31
PA27226	10212	DDX39A	chr19	14516610	14540195	23585	DEAD (Asp-Glu-Ala-Asp) box polypeptide 39A
PA25262	7919	DDX39B	chr6	31494996	31520252	25256	DEAD (Asp-Glu-Ala-Asp) box polypeptide 39B
PA27216	1654	DDX3X	chrX	41182561	41212527	29966	DEAD (Asp-Glu-Ala-Asp) box helicase 3, X-linked
PA27168	8653	DDX3Y	chrY	15006019	15035390	29371	DEAD (Asp-Glu-Ala-Asp) box helicase 3, Y-linked
PA38646	54514	DDX4	chr5	55023845	55115975	92130	DEAD (Asp-Glu-Ala-Asp) box polypeptide 4
PA134908862	51428	DDX41	chr5	176935578	176953967	18389	DEAD (Asp-Glu-Ala-Asp) box polypeptide 41
PA134875761	11325	DDX42	chr17	61841549	61899677	58128	DEAD (Asp-Glu-Ala-Asp) box helicase 42
PA134988734	55510	DDX43	chr6	74094285	74130289	36004	DEAD (Asp-Glu-Ala-Asp) box polypeptide 43
PA134894452	9879	DDX46	chr5	134084461	134169811	85350	DEAD (Asp-Glu-Ala-Asp) box polypeptide 46
PA134918403	51202	DDX47	chr12	12956280	12985915	29635	DEAD (Asp-Glu-Ala-Asp) box polypeptide 47
PA134956171	54555	DDX49	chr19	19020484	19042442	21958	DEAD (Asp-Glu-Ala-Asp) box polypeptide 49
PA27228	1655	DDX5	chr17	62491374	62513042	21668	DEAD (Asp-Glu-Ala-Asp) box helicase 5
PA134948525	79009	DDX50	chr10	70651034	70709603	58569	DEAD (Asp-Glu-Ala-Asp) box polypeptide 50
PA134974036	317781	DDX51	chr12	132618139	132638880	20741	DEAD (Asp-Glu-Ala-Asp) box polypeptide 51
PA134904836	11056	DDX52	chr17	35969363	36013493	44130	DEAD (Asp-Glu-Ala-Asp) box polypeptide 52
PA134863598	168400	DDX53	chrX	23008078	23023206	15128	DEAD (Asp-Glu-Ala-Asp) box polypeptide 53
PA134992026	79039	DDX54	chr12	113591978	113633284	41306	DEAD (Asp-Glu-Ala-Asp) box polypeptide 54
PA134984021	57696	DDX55	chr12	124076650	124108482	31832	DEAD (Asp-Glu-Ala-Asp) box polypeptide 55
PA134916346	54606	DDX56	chr7	44602016	44624542	22526	DEAD (Asp-Glu-Ala-Asp) box helicase 56
PA134994272	23586	DDX58	chr9	32452300	32536322	84022	DEAD (Asp-Glu-Ala-Asp) box polypeptide 58
PA142672000	83479	DDX59	chr1	200606935	200649126	42191	DEAD (Asp-Glu-Ala-Asp) box polypeptide 59
PA27229	1656	DDX6	chr11	118615472	118671972	56500	DEAD (Asp-Glu-Ala-Asp) box helicase 6
PA162383444	55601	DDX60	chr4	169134442	169249958	115516	DEAD (Asp-Glu-Ala-Asp) box polypeptide 60
PA162383445	91351	DDX60L	chr4	169274886	169411665	136779	DEAD (Asp-Glu-Ala-Asp) box polypeptide 60-like
PA27234	10522	DEAF1	chr11	641225	705740	64515	DEAF1 transcription factor
PA134898625	50514	DEC1	chr9	117894097	118167923	273826	deleted in esophageal cancer 1
PA141	1666	DECR1	chr8	91003580	91067232	63652	2,4-dienoyl CoA reductase 1, mitochondrial
PA27235	26063	DECR2	chr16	441858	465487	23629	2,4-dienoyl CoA reductase 2, peroxisomal
PA27236	9191	DEDD	chr1	161087767	161113192	25425	death effector domain containing
PA134912744	162989	DEDD2	chr19	42699745	42734304	34559	death effector domain containing 2
PA27237	50619	DEF6	chr6	35255595	35292548	36953	differentially expressed in FDCP 6 homolog (mouse)
PA162383526	54849	DEF8	chr16	90004560	90037468	32908	differentially expressed in FDCP 8 homolog (mouse)
PA27238	1667	DEFA1	chr8	6832171	6847614	15443	defensin, alpha 1
PA165585475	728358	DEFA1B	chr8	6851288	6866724	15436	defensin, alpha 1B
PA27239	1668	DEFA3	chr8	6870391	6885816	15425	defensin, alpha 3, neutrophil-specific
PA27240	1669	DEFA4	chr8	6790345	6805786	15441	defensin, alpha 4, corticostatin
PA27241	1670	DEFA5	chr8	6909829	6924259	14430	defensin, alpha 5, Paneth cell-specific
PA27242	1671	DEFA6	chr8	6779216	6793598	14382	defensin, alpha 6, Paneth cell-specific
PA27243	1672	DEFB1	chr8	6725097	6745529	20432	defensin, beta 1
PA27244	414325	DEFB103A	chr8	7728726	7743105	14379	defensin, beta 103A
PA134933952	55894	DEFB103B	chr8	7283410	7297682	14272	defensin, beta 103B
PA38506	140596	DEFB104A	chr8	7683993	7701764	17771	defensin, beta 104A
PA142671990	503618	DEFB104B	chr8	7324830	7342604	17774	defensin, beta 104B
PA38483	245908	DEFB105A	chr8	7676530	7691360	14830	defensin, beta 105A
PA142671991	504180	DEFB105B	chr8	7335243	7350073	14830	defensin, beta 105B
PA38484	245909	DEFB106A	chr8	7672694	7689575	16881	defensin, beta 106A
PA142671992	503841	DEFB106B	chr8	7337026	7353909	16883	defensin, beta 106B
PA38482	245910	DEFB107A	chr8	7666242	7683238	16996	defensin, beta 107A
PA142671993	503614	DEFB107B	chr8	7343368	7369833	26465	defensin, beta 107B
PA142671994	245911	DEFB108B	chr11	71534246	71551608	17362	defensin, beta 108B
PA38487	245913	DEFB110	chr6	49973851	49999694	25843	defensin, beta 110 locus
PA38489	245915	DEFB112	chr6	50008288	50026364	18076	defensin, beta 112
PA38490	245927	DEFB113	chr6	49933390	49947338	13948	defensin, beta 113
PA38491	245928	DEFB114	chr6	49925005	49941818	16813	defensin, beta 114
PA38492	245929	DEFB115	chr20	29835467	29850435	14968	defensin, beta 115
PA38493	245930	DEFB116	chr20	29888015	29906388	18373	defensin, beta 116
PA38494	245931	DEFB117	chr20	29929175	29951707	22532	defensin, beta 117
PA27245	117285	DEFB118	chr20	29946421	29964726	18305	defensin, beta 118
PA38495	245932	DEFB119	chr20	29961966	29988452	26486	defensin, beta 119
PA38497	245934	DEFB121	chr20	29989648	30016314	26666	defensin, beta 121
PA38499	245936	DEFB123	chr20	30018411	30041060	22649	defensin, beta 123
PA38500	245937	DEFB124	chr20	30050309	30070816	20507	defensin, beta 124
PA38501	245938	DEFB125	chr20	58351	80296	21945	defensin, beta 125
PA27246	81623	DEFB126	chr20	113194	129392	16198	defensin, beta 126
PA27247	140850	DEFB127	chr20	128111	142804	14693	defensin, beta 127
PA38502	245939	DEFB128	chr20	165527	180264	14737	defensin, beta 128
PA27248	140881	DEFB129	chr20	197899	213527	15628	defensin, beta 129
PA38503	245940	DEFB130	chr8	12165471	12185825	20354	defensin, beta 130
PA38504	644414	DEFB131	chr4	9436260	9455240	18980	defensin, beta 131
PA162383557	400830	DEFB132	chr20	228377	244737	16360	defensin, beta 132
PA134862169	403339	DEFB133	chr6	49910814	49927157	16343	defensin, beta 133
PA164718735	613211	DEFB134	chr8	11848489	11863760	15271	defensin, beta 134
PA165585476	613209	DEFB135	chr8	11829830	11845099	15269	defensin, beta 135
PA165585543	613210	DEFB136	chr8	11828446	11842108	13662	defensin, beta 136
PA27249	1673	DEFB4A	chr8	7742199	7757237	15038	defensin, beta 4A
PA165585559	100289462	DEFB4B	chr8	7269385	7284354	14969	defensin, beta 4B
PA27250	8560	DEGS1	chr1	224360910	224384143	23233	delta(4)-desaturase, sphingolipid 1
PA134973300	123099	DEGS2	chr14	100609753	100636012	26259	delta(4)-desaturase, sphingolipid 2
PA27251	7913	DEK	chr6	18221400	18274799	53399	DEK proto-oncogene
PA134876117	57706	DENND1A	chr9	126138933	126702423	563490	DENN/MADD domain containing 1A
PA134951951	163486	DENND1B	chr1	197470878	197754623	283745	DENN/MADD domain containing 1B
PA134893022	79958	DENND1C	chr19	6464218	6491798	27580	DENN/MADD domain containing 1C
PA134931054	27147	DENND2A	chr7	140215220	140351285	136065	DENN/MADD domain containing 2A
PA142671985	163259	DENND2C	chr1	115124155	115222732	98577	DENN/MADD domain containing 2C
PA142671986	79961	DENND2D	chr1	111725591	111757160	31569	DENN/MADD domain containing 2D
PA142671987	22898	DENND3	chr8	142128720	142208903	80183	DENN/MADD domain containing 3
PA134887513	10260	DENND4A	chr15	65949954	66094631	144677	DENN/MADD domain containing 4A
PA142671629	9909	DENND4B	chr1	153898977	153929162	30185	DENN/MADD domain containing 4B
PA134939495	55667	DENND4C	chr9	19220763	19377137	156374	DENN/MADD domain containing 4C
PA164718737	23258	DENND5A	chr11	9157372	9296882	139510	DENN/MADD domain containing 5A
PA164718788	160518	DENND5B	chr12	31532157	31753952	221795	DENN/MADD domain containing 5B
PA144596431	201627	DENND6A	chr3	57608181	57688816	80635	DENN/MADD domain containing 6A
PA144596432	414918	DENND6B	chr22	50747392	50775517	28125	DENN/MADD domain containing 6B
PA27252	8562	DENR	chr12	123227371	123258953	31582	density-regulated protein
PA134974825	55635	DEPDC1	chr1	68936835	68972799	35964	DEP domain containing 1
PA134941087	55789	DEPDC1B	chr5	59889739	60005993	116254	DEP domain containing 1B
PA134981607	120863	DEPDC4	chr12	100594447	100670857	76410	DEP domain containing 4
PA134864958	9681	DEPDC5	chr22	32139937	32306020	166083	DEP domain containing 5
PA144596441	91614	DEPDC7	chr11	33027410	33058128	30718	DEP domain containing 7
PA134897957	64798	DEPTOR	chr8	120875900	121066157	190257	DEP domain containing MTOR-interacting protein
PA134943367	51071	DERA	chr12	16054186	16193315	139129	deoxyribose-phosphate aldolase (putative)
PA134926638	79139	DERL1	chr8	124022404	124064663	42259	derlin 1
PA134896343	51009	DERL2	chr17	5374582	5399520	24938	derlin 2
PA25883	91319	DERL3	chr22	24173690	24191430	17740	derlin 3
PA27253	1674	DES	chr2	220273099	220294461	21362	desmin
PA164725008	27351	DESI1	chr22	41991032	42027079	36047	desumoylating isopeptidase 1
PA164724993	51029	DESI2	chr1	244806352	244875335	68983	desumoylating isopeptidase 2
PA134943899	55070	DET1	chr15	89033449	89099934	66485	de-etiolated homolog 1 (Arabidopsis)
PA165449964	28955	DEXI	chr16	11019748	11046257	26509	Dexi homolog (mouse)
PA27254	1676	DFFA	chr1	10517588	10542613	25025	DNA fragmentation factor, 45kDa, alpha polypeptide
PA27255	1677	DFFB	chr1	3763845	3804993	41148	DNA fragmentation factor, 40kDa, beta polypeptide (caspase-activated DNase)
PA27281	1687	DFNA5	chr7	24734974	24807639	72665	deafness, autosomal dominant 5
PA27297	25861	DFNB31	chr9	117161360	117277789	116429	deafness, autosomal recessive 31
PA134927047	494513	DFNB59	chr2	179306163	179329149	22986	deafness, autosomal recessive 59
PA27303	8694	DGAT1	chr8	145535246	145560582	25336	diacylglycerol O-acyltransferase 1
PA27304	84649	DGAT2	chr11	75469778	75515581	45803	diacylglycerol O-acyltransferase 2
PA143485448	347516	DGAT2L6	chrX	69387336	69428553	41217	diacylglycerol O-acyltransferase 2-like 6
PA134913100	8220	DGCR14	chr22	19114792	19142190	27398	DiGeorge syndrome critical region gene 14
PA27307	9993	DGCR2	chr22	19020795	19119967	99172	DiGeorge syndrome critical region gene 2
PA27308	8214	DGCR6	chr22	18883736	18902601	18865	DiGeorge syndrome critical region gene 6
PA38570	85359	DGCR6L	chr22	20298761	20317628	18867	DiGeorge syndrome critical region gene 6-like
PA27309	54487	DGCR8	chr22	20057755	20102400	44645	DGCR8 microprocessor complex subunit
PA27310	1606	DGKA	chr12	56314946	56350811	35865	diacylglycerol kinase, alpha 80kDa
PA27311	1607	DGKB	chr7	14181674	14953281	771607	diacylglycerol kinase, beta 90kDa
PA27312	8527	DGKD	chr2	234253149	234383744	130595	diacylglycerol kinase, delta 130kDa
PA27313	8526	DGKE	chr17	54901460	54949036	47576	diacylglycerol kinase, epsilon 64kDa
PA27314	1608	DGKG	chr3	185849896	186090023	240127	diacylglycerol kinase, gamma 90kDa
PA27315	160851	DGKH	chr13	42604172	42807352	203180	diacylglycerol kinase, eta
PA27316	9162	DGKI	chr7	137071385	137541609	470224	diacylglycerol kinase, iota
PA27317	1609	DGKQ	chr4	949672	977348	27676	diacylglycerol kinase, theta 110kDa
PA27318	8525	DGKZ	chr11	46344455	46405104	60649	diacylglycerol kinase, zeta
PA27319	1716	DGUOK	chr2	74143953	74189088	45135	deoxyguanosine kinase
PA27320	1718	DHCR24	chr1	55312300	55362921	50621	24-dehydrocholesterol reductase
PA27321	1717	DHCR7	chr11	71142457	71169477	27020	7-dehydrocholesterol reductase
PA134867119	79947	DHDDS	chr1	26748773	26800797	52024	dehydrodolichyl diphosphate synthase
PA27322	27294	DHDH	chr19	49426939	49451226	24287	dihydrodiol dehydrogenase (dimeric)
PA143	1719	DHFR	chr5	79919045	79960800	41755	dihydrofolate reductase
PA134889916	200895	DHFRL1	chr3	93773766	93792233	18467	dihydrofolate reductase-like 1
PA27326	50846	DHH	chr12	49480204	49498602	18398	desert hedgehog
PA27327	1723	DHODH	chr16	72032643	72062316	29673	dihydroorotate dehydrogenase (quinone)
PA27329	1725	DHPS	chr19	12783531	12802701	19170	deoxyhypusine synthase
PA134914102	115817	DHRS1	chr14	24756804	24779039	22235	dehydrogenase/reductase (SDR family) member 1
PA164718841	79154	DHRS11	chr17	34938226	34960233	22007	dehydrogenase/reductase (SDR family) member 11
PA147358124	79758	DHRS12	chr13	52327614	52389667	62053	dehydrogenase/reductase (SDR family) member 12
PA147358144	147015	DHRS13	chr17	27221799	27240089	18290	dehydrogenase/reductase (SDR family) member 13
PA38318	10202	DHRS2	chr14	24089324	24117848	28524	dehydrogenase/reductase (SDR family) member 2
PA134952810	9249	DHRS3	chr1	12624939	12687820	62881	dehydrogenase/reductase (SDR family) member 3
PA128395792	10901	DHRS4	chr14	24412944	24441488	28544	dehydrogenase/reductase (SDR family) member 4
PA134930167	317749	DHRS4L2	chr14	24429083	24478617	49534	dehydrogenase/reductase (SDR family) member 4 like 2
PA134974539	51635	DHRS7	chr14	60608496	60643034	34538	dehydrogenase/reductase (SDR family) member 7
PA142671976	25979	DHRS7B	chr17	21020241	21098285	78044	dehydrogenase/reductase (SDR family) member 7B
PA142671977	201140	DHRS7C	chr17	9671751	9704894	33143	dehydrogenase/reductase (SDR family) member 7C
PA134913654	10170	DHRS9	chr2	169911299	169955677	44378	dehydrogenase/reductase (SDR family) member 9
PA27330	207063	DHRSX	chrY	2084547	2380836	296289	dehydrogenase/reductase (SDR family) X-linked
PA134962952	55526	DHTKD1	chr10	12100916	12168227	67311	dehydrogenase E1 and transketolase domain containing 1
PA27204	1665	DHX15	chr4	24526087	24596184	70097	DEAH (Asp-Glu-Ala-His) box helicase 15
PA27205	8449	DHX16	chr6	30617896	30650830	32934	DEAH (Asp-Glu-Ala-His) box polypeptide 16
PA27215	54505	DHX29	chr5	54549073	54613521	64448	DEAH (Asp-Glu-Ala-His) box polypeptide 29
PA27217	22907	DHX30	chr3	47834399	47894686	60287	DEAH (Asp-Glu-Ala-His) box helicase 30
PA27219	55760	DHX32	chr10	127521909	127579884	57975	DEAH (Asp-Glu-Ala-His) box polypeptide 32
PA27220	56919	DHX33	chr17	5341232	5382380	41148	DEAH (Asp-Glu-Ala-His) box polypeptide 33
PA27221	9704	DHX34	chr19	47842538	47888961	46423	DEAH (Asp-Glu-Ala-His) box polypeptide 34
PA27222	60625	DHX35	chr20	37580981	37671366	90385	DEAH (Asp-Glu-Ala-His) box polypeptide 35
PA27223	170506	DHX36	chr3	153990452	154052286	61834	DEAH (Asp-Glu-Ala-His) box polypeptide 36
PA27224	57647	DHX37	chr12	125428370	125483667	55297	DEAH (Asp-Glu-Ala-His) box polypeptide 37
PA27225	9785	DHX38	chr16	72117615	72149811	32196	DEAH (Asp-Glu-Ala-His) box polypeptide 38
PA27227	79665	DHX40	chr17	57632886	57688713	55827	DEAH (Asp-Glu-Ala-His) box polypeptide 40
PA134919698	90957	DHX57	chr2	39021871	39113021	91150	DEAH (Asp-Glu-Ala-Asp/His) box polypeptide 57
PA162383566	79132	DHX58	chr17	40250422	40274751	24329	DEXH (Asp-Glu-X-His) box polypeptide 58
PA27231	1659	DHX8	chr17	41551330	41607185	55855	DEAH (Asp-Glu-Ala-His) box polypeptide 8
PA27232	1660	DHX9	chr1	182798439	182860117	61678	DEAH (Asp-Glu-Ala-His) box helicase 9
PA134945044	56616	DIABLO	chr12	122689209	122722081	32872	diablo, IAP-binding mitochondrial protein
PA27333	1729	DIAPH1	chr5	140891588	141008622	117034	diaphanous-related formin 1
PA27334	1730	DIAPH2	chrX	95929650	96858597	928947	diaphanous-related formin 2
PA27335	81624	DIAPH3	chr13	60236717	60748119	511402	diaphanous-related formin 3
PA38437	23405	DICER1	chr14	95549565	95633759	84194	dicer 1, ribonuclease type III
PA27147	11083	DIDO1	chr20	61506090	61579304	73214	death inducer-obliterator 1
PA142672491	27042	DIEXF	chr1	209991312	210033910	42598	digestive organ expansion factor homolog (zebrafish)
PA162383599	27292	DIMT1	chr5	61681351	61709728	28377	DIM1 dimethyladenosine transferase 1 homolog (S. cerevisiae)
PA27337	1733	DIO1	chr1	54349860	54379763	29903	deiodinase, iodothyronine, type I
PA27338	1734	DIO2	chr14	80660868	80707397	46529	deiodinase, iodothyronine, type II
PA27339	1735	DIO3	chr14	102017688	102032789	15101	deiodinase, iodothyronine, type III
PA134888233	23181	DIP2A	chr21	47868862	47992926	124064	DIP2 disco-interacting protein 2 homolog A (Drosophila)
PA143485449	57609	DIP2B	chr12	50888768	51145450	256682	DIP2 disco-interacting protein 2 homolog B (Drosophila)
PA134961070	22982	DIP2C	chr10	317130	745621	428491	DIP2 disco-interacting protein 2 homolog C (Drosophila)
PA134951835	148252	DIRAS1	chr19	2711565	2731390	19825	DIRAS family, GTP-binding RAS-like 1
PA134958969	54769	DIRAS2	chr9	93369114	93415108	45994	DIRAS family, GTP-binding RAS-like 2
PA24980	9077	DIRAS3	chr1	68508645	68527314	18669	DIRAS family, GTP-binding RAS-like 3
PA27340	116093	DIRC1	chr2	189595465	189664831	69366	disrupted in renal carcinoma 1
PA27341	84925	DIRC2	chr3	122503901	122602986	99085	disrupted in renal carcinoma 2
PA162383628	22894	DIS3	chr13	73326540	73366344	39804	DIS3 exosome endoribonuclease and 3'-5' exoribonuclease
PA162383675	115752	DIS3L	chr15	66575633	66629236	53603	DIS3 like exosome 3'-5' exoribonuclease
PA162383714	129563	DIS3L2	chr2	232816293	233211678	395385	DIS3 like 3'-5' exoribonuclease 2
PA27342	27185	DISC1	chr1	231752561	232180018	427457	disrupted in schizophrenia 1
PA134938043	84976	DISP1	chr1	222978342	223182337	203995	dispatched homolog 1 (Drosophila)
PA134876083	85455	DISP2	chr15	40640434	40666256	25822	dispatched homolog 2 (Drosophila)
PA134988674	85458	DIXDC1	chr11	111787868	111896374	108506	DIX domain containing 1
PA27344	1736	DKC1	chrX	153981031	154008964	27933	dyskeratosis congenita 1, dyskerin
PA27345	22943	DKK1	chr10	54064041	54080417	16376	dickkopf WNT signaling pathway inhibitor 1
PA27346	27123	DKK2	chr4	107839959	107967453	127494	dickkopf WNT signaling pathway inhibitor 2
PA27347	27122	DKK3	chr11	11981543	12041373	59830	dickkopf WNT signaling pathway inhibitor 3
PA27348	27121	DKK4	chr8	42228586	42244674	16088	dickkopf WNT signaling pathway inhibitor 4
PA134974559	27120	DKKL1	chr19	49856466	49881373	24907	dickkopf-like 1
PA27350	1737	DLAT	chr11	111885538	111938002	52464	dihydrolipoamide S-acetyltransferase
PA27351	10395	DLC1	chr8	12937870	13383167	445297	DLC1 Rho GTPase activating protein
PA27352	1738	DLD	chr7	107521586	107564643	43057	dihydrolipoamide dehydrogenase
PA27353	9940	DLEC1	chr3	38070497	38167228	96731	deleted in lung and esophageal cancer 1
PA142671974	220107	DLEU7	chr13	51283759	51427885	144126	deleted in lymphocytic leukemia, 7
PA27356	1739	DLG1	chr3	196766431	197036171	269740	discs, large homolog 1 (Drosophila)
PA164741388	1740	DLG2	chr11	83163055	85348314	2185259	discs, large homolog 2 (Drosophila)
PA164741439	1741	DLG3	chrX	69654705	69728343	73638	discs, large homolog 3 (Drosophila)
PA27359	1742	DLG4	chr17	7090209	7133369	43160	discs, large homolog 4 (Drosophila)
PA27360	9231	DLG5	chr10	79547549	79696348	148799	discs, large homolog 5 (Drosophila)
PA27361	9229	DLGAP1	chr18	3493030	4465310	972280	discs, large (Drosophila) homolog-associated protein 1
PA27362	9228	DLGAP2	chr8	867021	1659642	792621	discs, large (Drosophila) homolog-associated protein 2
PA134923893	58512	DLGAP3	chr1	35328037	35401083	73046	discs, large (Drosophila) homolog-associated protein 3
PA134891458	22839	DLGAP4	chr20	34985444	35160040	174596	discs, large (Drosophila) homolog-associated protein 4
PA162383761	9787	DLGAP5	chr14	55611834	55668396	56562	discs, large (Drosophila) homolog-associated protein 5
PA27363	8788	DLK1	chr14	101183202	101204467	21265	delta-like 1 homolog (Drosophila)
PA162383762	65989	DLK2	chr6	43415090	43433786	18696	delta-like 2 homolog (Drosophila)
PA27364	28514	DLL1	chr6	170588288	170609815	21527	delta-like 1 (Drosophila)
PA27365	10683	DLL3	chr19	39979557	40002121	22564	delta-like 3 (Drosophila)
PA27366	54567	DLL4	chr15	41211531	41234258	22727	delta-like 4 (Drosophila)
PA27367	1743	DLST	chr14	75338594	75373450	34856	dihydrolipoamide S-succinyltransferase (E2 component of 2-oxo-glutarate complex)
PA27368	1744	DLSTP1	chr1	76204708	76220467	15759	dihydrolipoamide S-succinyltransferase pseudogene 1
PA27369	1745	DLX1	chr2	172940208	172957402	17194	distal-less homeobox 1
PA27370	1746	DLX2	chr2	172961166	172977478	16312	distal-less homeobox 2
PA27371	1747	DLX3	chr17	48064369	48082588	18219	distal-less homeobox 3
PA27372	1748	DLX4	chr17	48036562	48055323	18761	distal-less homeobox 4
PA27373	1749	DLX5	chr7	96646702	96664143	17441	distal-less homeobox 5
PA27374	1750	DLX6	chr7	96625290	96643352	18062	distal-less homeobox 6
PA134927315	55929	DMAP1	chr1	44669104	44689351	20247	DNA methyltransferase 1 associated protein 1
PA27376	1755	DMBT1	chr10	124310181	124406252	96071	deleted in malignant brain tumors 1
PA38780	127343	DMBX1	chr1	46962668	46982898	20230	diencephalon/mesencephalon homeobox 1
PA27377	11144	DMC1	chr22	38911954	38976201	64247	DNA meiotic recombinase 1
PA27378	1756	DMD	chrX	31134345	33367726	2233381	dystrophin
PA134947212	29958	DMGDH	chr5	78290387	78375497	85110	dimethylglycine dehydrogenase
PA145149020	93099	DMKN	chr19	35985119	36014560	29441	dermokine
PA27379	1758	DMP1	chr4	88561454	88588513	27059	dentin matrix acidic phosphoprotein 1
PA27380	1760	DMPK	chr19	46269975	46295815	25840	dystrophia myotonica-protein kinase
PA27381	1761	DMRT1	chr9	831690	972090	140400	doublesex and mab-3 related transcription factor 1
PA27382	10655	DMRT2	chr9	1039858	1060554	20696	doublesex and mab-3 related transcription factor 2
PA27383	58524	DMRT3	chr9	966968	994732	27764	doublesex and mab-3 related transcription factor 3
PA27384	63951	DMRTA1	chr9	22436840	22455472	18632	DMRT-like family A1
PA27385	63950	DMRTA2	chr1	50880223	50899119	18896	DMRT-like family A2
PA27386	63948	DMRTB1	chr1	53915072	53936158	21086	DMRT-like family B with proline-rich C-terminal, 1
PA27387	63947	DMRTC1	chrX	72088859	72173625	84766	DMRT-like family C1
PA162383779	728656	DMRTC1B	chrX	72054876	72071636	16760	DMRT-like family C1B
PA27388	63946	DMRTC2	chr19	42338806	42359398	20592	DMRT-like family C2
PA27389	9988	DMTF1	chr7	86771677	86828648	56971	cyclin D binding myb-like transcription factor 1
PA27815	2039	DMTN	chr8	21896660	21943036	46376	dematin actin binding protein
PA27390	1762	DMWD	chr19	46283205	46306060	22855	dystrophia myotonica, WD repeat containing
PA27391	1657	DMXL1	chr5	118396839	118587822	190983	Dmx-like 1
PA27392	23312	DMXL2	chr15	51736921	51925030	188109	Dmx-like 2
PA162383798	1763	DNA2	chr10	70170821	70241878	71057	DNA replication helicase/nuclease 2
PA142671510	123872	DNAAF1	chr16	84168865	84214524	45659	dynein, axonemal, assembly factor 1
PA134910310	55172	DNAAF2	chr14	50088892	50111948	23056	dynein, axonemal, assembly factor 2
PA147358371	352909	DNAAF3	chr19	55667029	55688090	21061	dynein, axonemal, assembly factor 3
PA27394	25981	DNAH1	chr3	52340335	52437513	97178	dynein, axonemal, heavy chain 1
PA27395	196385	DNAH10	chr12	124236786	124423267	186481	dynein, axonemal, heavy chain 10
PA27396	8701	DNAH11	chr7	21572833	21944451	371618	dynein, axonemal, heavy chain 11
PA27397	201625	DNAH12	chr3	57324727	57540071	215344	dynein, axonemal, heavy chain 12
PA27399	127602	DNAH14	chr1	225107356	225589996	482640	dynein, axonemal, heavy chain 14
PA27400	8632	DNAH17	chr17	76416778	76583476	166698	dynein, axonemal, heavy chain 17
PA27401	146754	DNAH2	chr17	7610631	7740058	129427	dynein, axonemal, heavy chain 2
PA27402	55567	DNAH3	chr16	20941476	21180762	239286	dynein, axonemal, heavy chain 3
PA27403	1767	DNAH5	chr5	13687437	14021841	334404	dynein, axonemal, heavy chain 5
PA27404	1768	DNAH6	chr2	84733579	85049713	316134	dynein, axonemal, heavy chain 6
PA38625	56171	DNAH7	chr2	196599427	196943536	344109	dynein, axonemal, heavy chain 7
PA27405	1769	DNAH8	chr6	38673117	39001574	328457	dynein, axonemal, heavy chain 8
PA27406	1770	DNAH9	chr17	11491748	11876065	384317	dynein, axonemal, heavy chain 9
PA27407	27019	DNAI1	chr9	34448750	34523987	75237	dynein, axonemal, intermediate chain 1
PA38669	64446	DNAI2	chr17	72260386	72314023	53637	dynein, axonemal, intermediate chain 2
PA31536	3301	DNAJA1	chr9	33015209	33042905	27696	DnaJ (Hsp40) homolog, subfamily A, member 1
PA27409	10294	DNAJA2	chr16	46986274	47017625	31351	DnaJ (Hsp40) homolog, subfamily A, member 2
PA27410	9093	DNAJA3	chr16	4465806	4509776	43970	DnaJ (Hsp40) homolog, subfamily A, member 3
PA27411	55466	DNAJA4	chr15	78546487	78577538	31051	DnaJ (Hsp40) homolog, subfamily A, member 4
PA27412	3337	DNAJB1	chr19	14622581	14650087	27506	DnaJ (Hsp40) homolog, subfamily B, member 1
PA27413	51726	DNAJB11	chr3	186278467	186306589	28122	DnaJ (Hsp40) homolog, subfamily B, member 11
PA27414	54788	DNAJB12	chr10	74089588	74124907	35319	DnaJ (Hsp40) homolog, subfamily B, member 12
PA142671972	374407	DNAJB13	chr11	73651364	73684713	33349	DnaJ (Hsp40) homolog, subfamily B, member 13
PA142671973	79982	DNAJB14	chr4	100814405	100877883	63478	DnaJ (Hsp40) homolog, subfamily B, member 14
PA27415	3300	DNAJB2	chr2	220134040	220154622	20582	DnaJ (Hsp40) homolog, subfamily B, member 2
PA27416	11080	DNAJB4	chr1	78434847	78486648	51801	DnaJ (Hsp40) homolog, subfamily B, member 4
PA27417	25822	DNAJB5	chr9	34979638	35001430	21792	DnaJ (Hsp40) homolog, subfamily B, member 5
PA27418	10049	DNAJB6	chr7	157119692	157213133	93441	DnaJ (Hsp40) homolog, subfamily B, member 6
PA134961522	150353	DNAJB7	chr22	41252553	41268130	15577	DnaJ (Hsp40) homolog, subfamily B, member 7
PA134881798	165721	DNAJB8	chr3	128178275	128196091	17816	DnaJ (Hsp40) homolog, subfamily B, member 8
PA27419	4189	DNAJB9	chr7	108200189	108218294	18105	DnaJ (Hsp40) homolog, subfamily B, member 9
PA128394706	64215	DNAJC1	chr10	22042477	22302679	260202	DnaJ (Hsp40) homolog, subfamily C, member 1
PA134917195	54431	DNAJC10	chr2	183570768	183647752	76984	DnaJ (Hsp40) homolog, subfamily C, member 10
PA134893823	55735	DNAJC11	chr1	6691228	6771966	80738	DnaJ (Hsp40) homolog, subfamily C, member 11
PA134931354	56521	DNAJC12	chr10	69553427	69607937	54510	DnaJ (Hsp40) homolog, subfamily C, member 12
PA134947358	23317	DNAJC13	chr3	132126361	132260876	134515	DnaJ (Hsp40) homolog, subfamily C, member 13
PA134940402	85406	DNAJC14	chr12	56211744	56234337	22593	DnaJ (Hsp40) homolog, subfamily C, member 14
PA134932264	29103	DNAJC15	chr13	43587362	43686306	98944	DnaJ (Hsp40) homolog, subfamily C, member 15
PA142671964	23341	DNAJC16	chr1	15843343	15901228	57885	DnaJ (Hsp40) homolog, subfamily C, member 16
PA142671965	55192	DNAJC17	chr15	41057067	41109676	52609	DnaJ (Hsp40) homolog, subfamily C, member 17
PA142671966	202052	DNAJC18	chr5	138742892	138790171	47279	DnaJ (Hsp40) homolog, subfamily C, member 18
PA142671967	131118	DNAJC19	chr3	180698497	180717562	19065	DnaJ (Hsp40) homolog, subfamily C, member 19
PA162383835	27000	DNAJC2	chr7	102949921	102995320	45399	DnaJ (Hsp40) homolog, subfamily C, member 2
PA162383874	134218	DNAJC21	chr5	34919698	34962069	42371	DnaJ (Hsp40) homolog, subfamily C, member 21
PA162383905	79962	DNAJC22	chr12	49730721	49750467	19746	DnaJ (Hsp40) homolog, subfamily C, member 22
PA162383906	120526	DNAJC24	chr11	31381377	31457382	76005	DnaJ (Hsp40) homolog, subfamily C, member 24
PA162383921	548645	DNAJC25	chr9	114383632	114419631	35999	DnaJ (Hsp40) homolog, subfamily C , member 25
PA165585764	552891	DNAJC25-GNG10	chr9	114383632	114435526	51894	DNAJC25-GNG10 readthrough
PA164718860	51277	DNAJC27	chr2	25163505	25204963	41458	DnaJ (Hsp40) homolog, subfamily C, member 27
PA162383922	54943	DNAJC28	chr21	34857238	34874023	16785	DnaJ (Hsp40) homolog, subfamily C, member 28
PA27420	5611	DNAJC3	chr13	96319393	96450243	130850	DnaJ (Hsp40) homolog, subfamily C, member 3
PA162383931	84277	DNAJC30	chr7	73092248	73107781	15533	DnaJ (Hsp40) homolog, subfamily C, member 30
PA27421	3338	DNAJC4	chr11	63987594	64004753	17159	DnaJ (Hsp40) homolog, subfamily C, member 4
PA27422	80331	DNAJC5	chr20	62516455	62570384	53929	DnaJ (Hsp40) homolog, subfamily C, member 5
PA134962894	85479	DNAJC5B	chr8	66923791	67015755	91964	DnaJ (Hsp40) homolog, subfamily C, member 5 beta
PA134880296	285126	DNAJC5G	chr2	27488289	27508214	19925	DnaJ (Hsp40) homolog, subfamily C, member 5 gamma
PA27423	9829	DNAJC6	chr1	65710133	65884552	174419	DnaJ (Hsp40) homolog, subfamily C, member 6
PA27424	7266	DNAJC7	chr17	40125439	40179715	54276	DnaJ (Hsp40) homolog, subfamily C, member 7
PA27425	22826	DNAJC8	chr1	28523789	28569542	45753	DnaJ (Hsp40) homolog, subfamily C, member 8
PA38797	23234	DNAJC9	chr10	74999582	75017025	17443	DnaJ (Hsp40) homolog, subfamily C, member 9
PA162383938	83544	DNAL1	chr14	74101578	74173431	71853	dynein, axonemal, light chain 1
PA27426	10126	DNAL4	chr22	39171513	39200161	28648	dynein, axonemal, light chain 4
PA38381	7802	DNALI1	chr1	38012520	38035458	22938	dynein, axonemal, light intermediate chain 1
PA27427	1773	DNASE1	chr16	3651772	3715689	63917	deoxyribonuclease I
PA27428	1774	DNASE1L1	chrX	153626579	153650428	23849	deoxyribonuclease I-like 1
PA27429	1775	DNASE1L2	chr16	2276253	2291712	15459	deoxyribonuclease I-like 2
PA27430	1776	DNASE1L3	chr3	58175353	58206730	31377	deoxyribonuclease I-like 3
PA27431	1777	DNASE2	chr19	12983025	13002409	19384	deoxyribonuclease II, lysosomal
PA134993904	58511	DNASE2B	chr1	84854215	84883691	29476	deoxyribonuclease II beta
PA134931157	373863	DND1	chr5	140047381	140063171	15790	DND microRNA-mediated repression inhibitor 1
PA162383959	92737	DNER	chr2	230219345	230589286	369941	delta/notch-like EGF repeat containing
PA142671968	144132	DNHD1	chr11	6507994	6596255	88261	dynein heavy chain domain 1
PA162384018	728489	DNLZ	chr9	139253352	139278111	24759	DNL-type zinc finger
PA27440	1759	DNM1	chr9	130955634	131020528	64894	dynamin 1
PA27441	10059	DNM1L	chr12	32822134	32901584	79450	dynamin 1-like
PA27442	1785	DNM2	chr19	10818729	10947169	128440	dynamin 2
PA134954683	26052	DNM3	chr1	171800618	172390606	589988	dynamin 3
PA134950706	23268	DNMBP	chr10	101632334	101779676	147342	dynamin binding protein
PA27443	1786	DNMT1	chr19	10241021	10315783	74762	DNA (cytosine-5-)-methyltransferase 1
PA27445	1788	DNMT3A	chr2	25448421	25575459	127038	DNA (cytosine-5-)-methyltransferase 3 alpha
PA27446	1789	DNMT3B	chr20	31340191	31400162	59971	DNA (cytosine-5-)-methyltransferase 3 beta
PA27447	29947	DNMT3L	chr21	45663222	45692099	28877	DNA (cytosine-5-)-methyltransferase 3-like
PA27448	23549	DNPEP	chr2	220235180	220274730	39550	aspartyl aminopeptidase
PA134918815	10591	DNPH1	chr6	43190367	43207211	16844	2'-deoxynucleoside 5'-phosphate N-hydrolase 1
PA27449	1791	DNTT	chr10	98054085	98101321	47236	DNA nucleotidylexotransferase
PA25709	116092	DNTTIP1	chr20	44410576	44443066	32490	deoxynucleotidyltransferase, terminal, interacting protein 1
PA142671963	30836	DNTTIP2	chr1	94332014	94355474	23460	deoxynucleotidyltransferase, terminal, interacting protein 2
PA27451	8448	DOC2A	chr16	30013835	30033424	19589	double C2-like domains, alpha
PA27452	8447	DOC2B	chr17	3009	41421	38412	double C2-like domains, beta
PA27453	1793	DOCK1	chr10	128758965	129253780	494815	dedicator of cytokinesis 1
PA134983197	55619	DOCK10	chr2	225626807	225917330	290523	dedicator of cytokinesis 10
PA128394757	139818	DOCK11	chrX	117619872	117823126	203254	dedicator of cytokinesis 11
PA27454	1794	DOCK2	chr5	169054251	169513386	459135	dedicator of cytokinesis 2
PA27455	1795	DOCK3	chr3	50702672	51424629	721957	dedicator of cytokinesis 3
PA134939318	9732	DOCK4	chr7	111363164	111856462	493298	dedicator of cytokinesis 4
PA134932307	80005	DOCK5	chr8	25032287	25276227	243940	dedicator of cytokinesis 5
PA134913824	57572	DOCK6	chr19	11306969	11383168	76199	dedicator of cytokinesis 6
PA134872825	85440	DOCK7	chr1	62917397	63164039	246642	dedicator of cytokinesis 7
PA134918866	81704	DOCK8	chr9	204865	468259	263394	dedicator of cytokinesis 8
PA134877754	23348	DOCK9	chr13	99442741	99748660	305919	dedicator of cytokinesis 9
PA142671678	83475	DOHH	chr19	3487819	3510938	23119	deoxyhypusine hydroxylase/monooxygenase
PA27456	1796	DOK1	chr2	74766147	74787678	21531	docking protein 1, 62kDa (downstream of tyrosine kinase 1)
PA27457	9046	DOK2	chr8	21763384	21781290	17906	docking protein 2, 56kDa
PA128394725	79930	DOK3	chr5	176925905	176947490	21585	docking protein 3
PA134892921	55715	DOK4	chr16	57502870	57530385	27515	docking protein 4
PA25724	55816	DOK5	chr20	53082266	53270710	188444	docking protein 5
PA134866995	220164	DOK6	chr18	67058284	67519323	461039	docking protein 6
PA162384035	285489	DOK7	chr4	3455033	3506203	51170	docking protein 7
PA162384054	22845	DOLK	chr9	131704809	131720012	15203	dolichol kinase
PA134937229	57171	DOLPP1	chr9	131833383	131855717	22334	dolichyldiphosphatase 1
PA27459	29980	DONSON	chr21	34934165	34971019	36854	downstream neighbor of SON
PA134924787	23033	DOPEY1	chr6	83767385	83884069	116684	dopey family member 1
PA25845	9980	DOPEY2	chr21	37519080	37669572	150492	dopey family member 2
PA134993717	84444	DOT1L	chr19	2154148	2235577	81429	DOT1-like histone H3K79 methyltransferase
PA27460	1798	DPAGT1	chr11	118964213	118983124	18911	dolichyl-phosphate (UDP-N-acetylglucosamine) N-acetylglucosaminephosphotransferase 1 (GlcNAc-1-P transferase)
PA165548502	25911	DPCD	chr10	103320399	103372410	52011	deleted in primary ciliary dyskinesia homolog (mouse)
PA134926573	135656	DPCR1	chr6	30898777	30924998	26221	diffuse panbronchiolitis critical region 1
PA144	1800	DPEP1	chr16	89669716	89710216	40500	dipeptidase 1 (renal)
PA134985997	64174	DPEP2	chr16	68018293	68044493	26200	dipeptidase 2
PA134978786	64180	DPEP3	chr16	68006566	68024452	17886	dipeptidase 3
PA134879894	8193	DPF1	chr19	38698649	38730317	31668	D4, zinc and double PHD fingers family 1
PA34331	5977	DPF2	chr11	65091225	65123451	32226	D4, zinc and double PHD fingers family 2
PA134888535	8110	DPF3	chr14	73082561	73370824	288263	D4, zinc and double PHD fingers, family 3
PA27461	1801	DPH1	chr17	1923431	1950183	26752	diphthamide biosynthesis 1
PA27462	1802	DPH2	chr1	44425653	44442043	16390	DPH2 homolog (S. cerevisiae)
PA162384061	285381	DPH3	chr3	16295568	16316496	20928	diphthamide biosynthesis 3
PA25686	100132911	DPH3P1	chr20	61466476	61480543	14067	DPH3, KTI11 homolog (S. cerevisiae) pseudogene 1
PA142671956	51611	DPH5	chr1	101452179	101501365	49186	diphthamide biosynthesis 5
PA142672572	89978	DPH6	chr15	35654670	35848597	193927	diphthamine biosynthesis 6
PA134942088	92715	DPH7	chr9	140446354	140483387	37033	diphthamide biosynthesis 7
PA27463	8813	DPM1	chr20	49548404	49585081	36677	dolichyl-phosphate mannosyltransferase polypeptide 1, catalytic subunit
PA27464	8818	DPM2	chr9	130694374	130710763	16389	dolichyl-phosphate mannosyltransferase polypeptide 2, regulatory subunit
PA27465	54344	DPM3	chr1	155109367	155122996	13629	dolichyl-phosphate mannosyltransferase polypeptide 3
PA134991647	57628	DPP10	chr2	115189899	116606328	1416429	dipeptidyl-peptidase 10 (non-functional)
PA27466	10072	DPP3	chr11	66237484	66280130	42646	dipeptidyl-peptidase 3
PA27467	1803	DPP4	chr2	162845751	162941052	95301	dipeptidyl-peptidase 4
PA27468	1804	DPP6	chr7	154390205	154688995	298790	dipeptidyl-peptidase 6
PA27469	29952	DPP7	chr9	140001992	140019204	17212	dipeptidyl-peptidase 7
PA27470	54878	DPP8	chr15	65731805	65820040	88235	dipeptidyl-peptidase 8
PA38620	91039	DPP9	chr19	4672239	4733855	61616	dipeptidyl-peptidase 9
PA134944028	151871	DPPA2	chr3	109009635	109045364	35729	developmental pluripotency associated 2
PA134951641	359787	DPPA3	chr12	7854089	7873155	19066	developmental pluripotency associated 3
PA134958838	55211	DPPA4	chr3	109041988	109066419	24431	developmental pluripotency associated 4
PA134964500	340168	DPPA5	chr6	74059785	74073999	14214	developmental pluripotency associated 5
PA142671957	503834	DPRX	chr19	54125310	54143263	17953	divergent-paired related homeobox
PA27471	1805	DPT	chr1	168661695	168708442	46747	dermatopontin
PA142671946	23333	DPY19L1	chr7	34965491	35087653	122162	dpy-19-like 1 (C. elegans)
PA142671949	283417	DPY19L2	chr12	63949693	64072354	122661	dpy-19-like 2 (C. elegans)
PA142671954	147991	DPY19L3	chr19	32886655	32979799	93144	dpy-19-like 3 (C. elegans)
PA142671955	286148	DPY19L4	chr8	95722103	95809076	86973	dpy-19-like 4 (C. elegans)
PA162384063	84661	DPY30	chr2	32242856	32274890	32034	dpy-30 homolog (C. elegans)
PA145	1806	DPYD	chr1	97540299	98396615	856316	dihydropyrimidine dehydrogenase
PA146	1807	DPYS	chr8	105388652	105489281	100629	dihydropyrimidinase
PA27472	1808	DPYSL2	chr8	26361709	26518693	156984	dihydropyrimidinase-like 2
PA27473	1809	DPYSL3	chr5	146767371	146899619	132248	dihydropyrimidinase-like 3
PA27474	10570	DPYSL4	chr10	133988564	134022280	33716	dihydropyrimidinase-like 4
PA134927413	56896	DPYSL5	chr2	27060969	27176219	115250	dihydropyrimidinase-like 5
PA134916600	165545	DQX1	chr2	74742258	74763408	21150	DEAQ box RNA-dependent ATPase 1
PA27475	1810	DR1	chr1	93801478	93831149	29671	down-regulator of transcription 1, TBP-binding (negative cofactor 2)
PA165512564	55332	DRAM1	chr12	102261105	102320401	59296	DNA-damage regulated autophagy modulator 1
PA165751270	128338	DRAM2	chr1	111656954	111692838	35884	DNA-damage regulated autophagy modulator 2
PA27476	10589	DRAP1	chr11	65676728	65692048	15320	DR1-associated protein 1 (negative cofactor 2 alpha)
PA142672435	374946	DRAXIN	chr1	11741781	11783336	41555	dorsal inhibitory axon guidance protein
PA145149775	92749	DRC1	chr2	26614784	26682579	67795	dynein regulatory complex subunit 1
PA162381380	84229	DRC7	chr16	57718713	57768367	49654	dynein regulatory complex subunit 7
PA147	1812	DRD1	chr5	174864675	174881163	16488	dopamine receptor D1
PA27478	1813	DRD2	chr11	113277317	113356413	79096	dopamine receptor D2
PA27479	1814	DRD3	chr3	113844499	113928254	83755	dopamine receptor D3
PA27480	1815	DRD4	chr11	627305	643706	16401	dopamine receptor D4
PA148	1816	DRD5	chr4	9773258	9788633	15375	dopamine receptor D5
PA27483	4733	DRG1	chr22	31785539	31833172	47633	developmentally regulated GTP binding protein 1
PA27484	1819	DRG2	chr17	17981181	18014299	33118	developmentally regulated GTP binding protein 2
PA162384078	644168	DRGX	chr10	50571161	50614062	42901	dorsal root ganglia homeobox
PA164717092	51233	DRICH1	chr22	23947639	23984508	36869	aspartate-rich 1
PA142671060	29102	DROSHA	chr5	31397601	31542282	144681	drosha, ribonuclease type III
PA27486	1821	DRP2	chrX	100464933	100522485	57552	dystrophin related protein 2
PA27488	1823	DSC1	chr18	28706199	28752819	46620	desmocollin 1
PA27489	1824	DSC2	chr18	28642938	28692388	49450	desmocollin 2
PA164741482	1825	DSC3	chr18	28567052	28632781	65729	desmocollin 3
PA27491	1826	DSCAM	chr21	41381343	42229039	847696	Down syndrome cell adhesion molecule
PA38384	57453	DSCAML1	chr11	117295489	117677976	382487	Down syndrome cell adhesion molecule like 1
PA162384079	79075	DSCC1	chr8	120843181	120878170	34989	DNA replication and sister chromatid cohesion 1
PA27496	10311	DSCR3	chr21	38592721	38650425	57704	Down syndrome critical region 3
PA27497	10281	DSCR4	chr21	39423313	39503454	80141	Down syndrome critical region 4
PA162384080	29940	DSE	chr6	116591231	116765422	174191	dermatan sulfate epimerase
PA162384097	92126	DSEL	chr18	65170819	65193967	23148	dermatan sulfate epimerase-like
PA27501	1828	DSG1	chr18	28888052	28940394	52342	desmoglein 1
PA27502	1829	DSG2	chr18	29068027	29131814	63787	desmoglein 2
PA27503	1830	DSG3	chr18	29017732	29061665	43933	desmoglein 3
PA134925919	147409	DSG4	chr18	28946740	28996880	50140	desmoglein 4
PA162384106	79980	DSN1	chr20	35377194	35412578	35384	DSN1, MIS12 kinetochore complex component
PA27505	1832	DSP	chr6	7531808	7589946	58138	desmoplakin
PA27507	1834	DSPP	chr4	88519681	88541025	21344	dentin sialophosphoprotein
PA25399	667	DST	chr6	56319785	56829426	509641	dystonin
PA27509	11034	DSTN	chr20	17539818	17591887	52069	destrin (actin depolymerizing factor)
PA164718861	25778	DSTYK	chr1	205108631	205190727	82096	dual serine/threonine and tyrosine protein kinase
PA162384107	92675	DTD1	chr20	18558556	18747561	189005	D-tyrosyl-tRNA deacylase 1
PA134963117	112487	DTD2	chr14	31912242	31936680	24438	D-tyrosyl-tRNA deacylase 2 (putative)
PA165663634	401124	DTHD1	chr4	36273237	36349407	76170	death domain containing 1
PA142671941	51514	DTL	chr1	212198919	212281187	82268	denticleless E3 ubiquitin protein ligase homolog (Drosophila)
PA27510	1837	DTNA	chr18	32063254	32474808	411554	dystrobrevin, alpha
PA27511	1838	DTNB	chr2	25597067	25906516	309449	dystrobrevin, beta
PA27512	84062	DTNBP1	chr6	15520032	15673289	153257	dystrobrevin binding protein 1
PA142671942	56986	DTWD1	chr15	49903226	49940333	37107	DTW domain containing 1
PA142671943	285605	DTWD2	chr5	118169569	118334240	164671	DTW domain containing 2
PA27514	1840	DTX1	chr12	113484514	113538833	54319	deltex 1, E3 ubiquitin ligase
PA27515	113878	DTX2	chr7	76080972	76138312	57340	deltex 2, E3 ubiquitin ligase
PA134887936	196403	DTX3	chr12	57988110	58006585	18475	deltex 3, E3 ubiquitin ligase
PA134864792	151636	DTX3L	chr3	122273085	122297050	23965	deltex 3 like, E3 ubiquitin ligase
PA134930720	23220	DTX4	chr11	58929812	58979060	49248	deltex 4, E3 ubiquitin ligase
PA150	1841	DTYMK	chr2	242612157	242636383	24226	deoxythymidylate kinase (thymidylate kinase)
PA27516	53905	DUOX1	chr15	45412192	45460776	48584	dual oxidase 1
PA27517	50506	DUOX2	chr15	45381851	45416537	34686	dual oxidase 2
PA145008497	90527	DUOXA1	chr15	45406564	45432075	25511	dual oxidase maturation factor 1
PA145008523	405753	DUOXA2	chr15	45396523	45413304	16781	dual oxidase maturation factor 2
PA134959776	338599	DUPD1	chr10	76794230	76843383	49153	dual specificity phosphatase and pro isomerase domain containing 1
PA142671936	64118	DUS1L	chr17	80012748	80033697	20949	dihydrouridine synthase 1-like (S. cerevisiae)
PA142671937	54920	DUS2	chr16	68046847	68116226	69379	dihydrouridine synthase 2
PA142671938	56931	DUS3L	chr19	5782151	5801249	19098	dihydrouridine synthase 3-like (S. cerevisiae)
PA142671939	11062	DUS4L	chr7	107194402	107221968	27566	dihydrouridine synthase 4-like (S. cerevisiae)
PA27519	1843	DUSP1	chr5	172192093	172208203	16110	dual specificity phosphatase 1
PA27520	11221	DUSP10	chr1	221871764	221926204	54440	dual specificity phosphatase 10
PA27521	8446	DUSP11	chr2	73986325	74017284	30959	dual specificity phosphatase 11 (RNA/RNP complex 1-interacting)
PA27522	11266	DUSP12	chr1	161709558	161729952	20394	dual specificity phosphatase 12
PA134939640	51207	DUSP13	chr10	76851190	76878976	27786	dual specificity phosphatase 13
PA27523	11072	DUSP14	chr17	35839951	35876603	36652	dual specificity phosphatase 14
PA27524	128853	DUSP15	chr20	30432441	30468479	36038	dual specificity phosphatase 15
PA38475	80824	DUSP16	chr12	12623216	12725773	102557	dual specificity phosphatase 16
PA134928498	150290	DUSP18	chr22	31055039	31073874	18835	dual specificity phosphatase 18
PA134895660	142679	DUSP19	chr2	183933287	183967736	34449	dual specificity phosphatase 19
PA27525	1844	DUSP2	chr2	96805908	96821206	15298	dual specificity phosphatase 2
PA134967875	63904	DUSP21	chrX	44693249	44707134	13885	dual specificity phosphatase 21
PA134991025	56940	DUSP22	chr6	282101	354355	72254	dual specificity phosphatase 22
PA134983082	54935	DUSP23	chr1	159740730	159755333	14603	dual specificity phosphatase 23
PA142671921	78986	DUSP26	chr8	33445848	33467546	21698	dual specificity phosphatase 26 (putative)
PA142671922	92235	DUSP27	chr1	167053314	167101402	48088	dual specificity phosphatase 27 (putative)
PA162384124	285193	DUSP28	chr2	241489471	241506431	16960	dual specificity phosphatase 28
PA27526	1845	DUSP3	chr17	41840489	41866368	25879	dual specificity phosphatase 3
PA27527	1846	DUSP4	chr8	29187579	29218267	30688	dual specificity phosphatase 4
PA27528	1847	DUSP5	chr10	112247625	112274302	26677	dual specificity phosphatase 5
PA27529	1848	DUSP6	chr12	89738837	89756296	17459	dual specificity phosphatase 6
PA27530	1849	DUSP7	chr3	52079935	52100461	20526	dual specificity phosphatase 7
PA27531	1850	DUSP8	chr11	1572281	1603150	30869	dual specificity phosphatase 8
PA27533	1852	DUSP9	chrX	152897897	152919781	21884	dual specificity phosphatase 9
PA151	1854	DUT	chr15	48613215	48638570	25355	deoxyuridine triphosphatase
PA27536	26583	DUX2	chr4	190978993	190993372	14379	double homeobox 2
PA27538	22947	DUX4	chr4	190995470	191009849	14379	double homeobox 4
PA165663706	728410	DUX4L2	chr4	191002063	191016442	14379	double homeobox 4 like 2
PA165663763	653548	DUX4L3	chr4	190998763	191013142	14379	double homeobox 4 like 3
PA165663770	441056	DUX4L4	chr4	190992176	191006549	14373	double homeobox 4 like 4
PA165663829	653545	DUX4L5	chr4	190988876	191003255	14379	double homeobox 4 like 5
PA165663878	653544	DUX4L6	chr4	190985583	190999962	14379	double homeobox 4 like 6
PA165663899	653543	DUX4L7	chr4	190982290	190996669	14379	double homeobox 4 like 7
PA142671924	503835	DUXA	chr19	57660094	57688856	28762	double homeobox A
PA27540	1855	DVL1	chr1	1267658	1294509	26851	dishevelled segment polarity protein 1
PA27542	1856	DVL2	chr17	7125661	7147867	22206	dishevelled segment polarity protein 2
PA27543	1857	DVL3	chr3	183863099	183894314	31215	dishevelled segment polarity protein 3
PA27458	1797	DXO	chr6	31934588	31950032	15444	decapping exoribonuclease
PA134972260	143241	DYDC1	chr10	82092858	82126523	33665	DPY30 domain containing 1
PA134988160	84332	DYDC2	chr10	82094501	82130829	36328	DPY30 domain containing 2
PA134879547	54808	DYM	chr18	46564846	46997172	432326	dymeclin
PA134946407	284254	DYNAP	chr18	52248390	52269724	21334	dynactin associated protein
PA27432	1778	DYNC1H1	chr14	102420865	102520135	99270	dynein, cytoplasmic 1, heavy chain 1
PA27434	1780	DYNC1I1	chr7	95391818	95742634	350816	dynein, cytoplasmic 1, intermediate chain 1
PA27435	1781	DYNC1I2	chr2	172533919	172609668	75749	dynein, cytoplasmic 1, intermediate chain 2
PA38670	51143	DYNC1LI1	chr3	32564463	32622373	57910	dynein, cytoplasmic 1, light intermediate chain 1
PA27438	1783	DYNC1LI2	chr16	66751796	66795526	43730	dynein, cytoplasmic 1, light intermediate chain 2
PA27433	79659	DYNC2H1	chr11	102970160	103353591	383431	dynein, cytoplasmic 2, heavy chain 1
PA142671919	51626	DYNC2LI1	chr2	43991178	44058095	66917	dynein, cytoplasmic 2, light intermediate chain 1
PA134972261	8655	DYNLL1	chr12	120897660	120939298	41638	dynein, light chain, LC8-type 1
PA142671920	140735	DYNLL2	chr17	56150780	56170618	19838	dynein, light chain, LC8-type 2
PA27436	83658	DYNLRB1	chr20	33094193	33131762	37569	dynein, light chain, roadblock-type 1
PA27437	83657	DYNLRB2	chr16	80564854	80587713	22859	dynein, light chain, roadblock-type 2
PA36416	6993	DYNLT1	chr6	159054506	159075804	21298	dynein, light chain, Tctex-type 1
PA36414	6990	DYNLT3	chrX	37695089	37716889	21800	dynein, light chain, Tctex-type 3
PA27545	1859	DYRK1A	chr21	38729859	38890679	160820	dual-specificity tyrosine-(Y)-phosphorylation regulated kinase 1A
PA27549	9149	DYRK1B	chr19	40312990	40334841	21851	dual-specificity tyrosine-(Y)-phosphorylation regulated kinase 1B
PA27550	8445	DYRK2	chr12	68032512	68059444	26932	dual-specificity tyrosine-(Y)-phosphorylation regulated kinase 2
PA27551	8444	DYRK3	chr1	206798881	206826229	27348	dual-specificity tyrosine-(Y)-phosphorylation regulated kinase 3
PA27552	8798	DYRK4	chr12	4661375	4726041	64666	dual-specificity tyrosine-(Y)-phosphorylation regulated kinase 4
PA27554	8291	DYSF	chr2	71670347	71916895	246548	dysferlin
PA162384136	391475	DYTN	chr2	207513345	207593120	79775	dystrotelin
PA134870600	161582	DYX1C1	chr15	55706953	55810432	103479	dyslexia susceptibility 1 candidate 1
PA25660	55184	DZANK1	chr20	18361011	18457995	96984	double zinc ribbon and ankyrin repeat domains 1
PA134960194	22873	DZIP1	chr13	96227456	96306960	79504	DAZ interacting zinc finger protein 1
PA134951988	199221	DZIP1L	chr3	137777827	137844451	66624	DAZ interacting zinc finger protein 1-like
PA162384137	9666	DZIP3	chr3	108298337	108416693	118356	DAZ interacting zinc finger protein 3
PA152	1869	E2F1	chr20	32260292	32284210	23918	E2F transcription factor 1
PA27572	1870	E2F2	chr1	23829920	23867712	37792	E2F transcription factor 2
PA27573	1871	E2F3	chr6	20392137	20496945	104808	E2F transcription factor 3
PA27576	1874	E2F4	chr16	67216068	67235821	19753	E2F transcription factor 4, p107/p130-binding
PA27577	1875	E2F5	chr8	86079619	86129753	50134	E2F transcription factor 5, p130-binding
PA27578	1876	E2F6	chr2	11581501	11616303	34802	E2F transcription factor 6
PA134894421	144455	E2F7	chr12	77412026	77469360	57334	E2F transcription factor 7
PA142671918	79733	E2F8	chr11	19242610	19273202	30592	E2F transcription factor 8
PA27579	1877	E4F1	chr16	2263490	2288743	25253	E4F transcription factor 1
PA134897202	85403	EAF1	chr3	15459064	15487120	28056	ELL associated factor 1
PA128394690	55840	EAF2	chr3	121544030	121608373	64343	ELL associated factor 2
PA162384208	55837	EAPP	chr14	34982135	35018943	36808	E2F-associated phosphoprotein
PA144596439	124454	EARS2	chr16	23530334	23578696	48362	glutamyl-tRNA synthetase 2, mitochondrial
PA27581	9166	EBAG9	chr8	110541929	110581225	39296	estrogen receptor binding site associated, antigen, 9
PA162384225	1879	EBF1	chr5	158119916	158536788	416872	early B-cell factor 1
PA38794	64641	EBF2	chr8	25696246	25912640	216394	early B-cell factor 2
PA134972607	253738	EBF3	chr10	131630496	131772546	142050	early B-cell factor 3
PA162384262	57593	EBF4	chr20	2663524	2743754	80230	early B-cell factor 4
PA27584	10148	EBI3	chr19	4219540	4240525	20985	Epstein-Barr virus induced 3
PA27586	10969	EBNA1BP2	chr1	43626845	43648241	21396	EBNA1 binding protein 2
PA27587	10682	EBP	chrX	48369306	48390104	20798	emopamil binding protein (sterol isomerase)
PA134875632	84650	EBPL	chr13	50231812	50275627	43815	emopamil binding protein-like
PA143485450	11319	ECD	chr10	74891282	74937853	46571	ecdysoneless homolog (Drosophila)
PA27594	1889	ECE1	chr1	21540740	21682034	141294	endothelin converting enzyme 1
PA134886910	9718	ECE2	chr3	183957445	184013819	56374	endothelin converting enzyme 2
PA27595	9427	ECEL1	chr2	233341537	233362532	20995	endothelin converting enzyme-like 1
PA27596	1891	ECH1	chr19	39303062	39332497	29435	enoyl CoA hydratase 1, peroxisomal
PA134871524	55862	ECHDC1	chr6	127606857	127675214	68357	ethylmalonyl-CoA decarboxylase 1
PA134913726	55268	ECHDC2	chr1	53358582	53402846	44264	enoyl CoA hydratase domain containing 2
PA134881215	79746	ECHDC3	chr10	11774356	11809065	34709	enoyl CoA hydratase domain containing 3
PA27597	1892	ECHS1	chr10	135172987	135196908	23921	enoyl CoA hydratase, short chain, 1, mitochondrial
PA27173	1632	ECI1	chr16	2286873	2312296	25423	enoyl-CoA delta isomerase 1
PA33168	10455	ECI2	chr6	4112927	4145831	32904	enoyl-CoA delta isomerase 2
PA27598	1893	ECM1	chr1	150470487	150489265	18778	extracellular matrix protein 1
PA27599	1842	ECM2	chr9	95252829	95308374	55545	extracellular matrix protein 2, female organ and adipocyte specific
PA164718891	641700	ECSCR	chr5	138834129	138852320	18191	endothelial cell surface expressed chemotaxis and apoptosis regulator
PA147358104	51295	ECSIT	chr19	11613731	11649987	36256	ECSIT signalling integrator
PA27600	1894	ECT2	chr3	172458425	172542264	83839	epithelial cell transforming 2
PA134893289	345930	ECT2L	chr6	139107248	139228207	120959	epithelial cell transforming 2 like
PA27601	1896	EDA	chrX	68825911	69262322	436411	ectodysplasin A
PA134974675	60401	EDA2R	chrX	65812479	65869140	56661	ectodysplasin A2 receptor
PA27602	10913	EDAR	chr2	109507927	109615828	107901	ectodysplasin A receptor
PA27603	128178	EDARADD	chr1	236547680	236651008	103328	EDAR-associated death domain
PA142670551	80153	EDC3	chr15	74919899	74998386	78487	enhancer of mRNA decapping 3
PA145148958	23644	EDC4	chr16	67896926	67921417	24491	enhancer of mRNA decapping 4
PA165478869	10876	EDDM3A	chr14	21204099	21219539	15440	epididymal protein 3A
PA165478900	64184	EDDM3B	chr14	21226586	21242107	15521	epididymal protein 3B
PA128394554	9695	EDEM1	chr3	5219359	5264650	45291	ER degradation enhancer, mannosidase alpha-like 1
PA25747	55741	EDEM2	chr20	33700160	33745161	45001	ER degradation enhancer, mannosidase alpha-like 2
PA38186	80267	EDEM3	chr1	184656625	184734041	77416	ER degradation enhancer, mannosidase alpha-like 3
PA27604	8721	EDF1	chr9	139753566	139770788	17222	endothelial differentiation-related factor 1
PA27613	10085	EDIL3	chr5	83233414	83690685	457271	EGF-like repeats and discoidin I-like domains 3
PA27614	1906	EDN1	chr6	12280529	12300427	19898	endothelin 1
PA27615	1907	EDN2	chr1	41941446	41960348	18902	endothelin 2
PA27616	1908	EDN3	chr20	57865499	57904047	38548	endothelin 3
PA27617	1909	EDNRA	chr4	148392069	148469106	77037	endothelin receptor type A
PA27618	1910	EDNRB	chr13	78466616	78559664	93048	endothelin receptor type B
PA134873666	26098	EDRF1	chr10	127398084	127455712	57628	erythroid differentiation regulatory factor 1
PA27621	8411	EEA1	chr12	93163285	93333107	169822	early endosome antigen 1
PA27624	8726	EED	chr11	85945586	85992785	47199	embryonic ectoderm development
PA27625	1915	EEF1A1	chr6	74222473	74240755	18282	eukaryotic translation elongation factor 1 alpha 1
PA27636	158078	EEF1A1P5	chr9	135884822	135899562	14740	eukaryotic translation elongation factor 1 alpha 1 pseudogene 5
PA36219	1917	EEF1A2	chr20	62116365	62140668	24303	eukaryotic translation elongation factor 1 alpha 2
PA27644	1933	EEF1B2	chr2	207014318	207030653	16335	eukaryotic translation elongation factor 1 beta 2
PA27647	1936	EEF1D	chr8	144658867	144689845	30978	eukaryotic translation elongation factor 1 delta (guanine nucleotide exchange protein)
PA27648	9521	EEF1E1	chr6	8070593	8112828	42235	eukaryotic translation elongation factor 1 epsilon 1
PA27649	1937	EEF1G	chr11	62324073	62351460	27387	eukaryotic translation elongation factor 1 gamma
PA27650	1938	EEF2	chr19	3973054	3995477	22423	eukaryotic translation elongation factor 2
PA134992891	29904	EEF2K	chr16	22207592	22303066	95474	eukaryotic elongation factor 2 kinase
PA142671858	196483	EEF2KMT	chr16	5131301	5157789	26488	eukaryotic elongation factor 2 lysine methyltransferase
PA142671916	60678	EEFSEC	chr3	127862302	128130489	268187	eukaryotic elongation factor, selenocysteine-tRNA-specific
PA162384303	80820	EEPD1	chr7	36182836	36344152	161316	endonuclease/exonuclease/phosphatase family domain containing 1
PA142671913	79645	EFCAB1	chr8	49624474	49657870	33396	EF-hand calcium binding domain 1
PA134875422	90141	EFCAB11	chr14	90258499	90431148	172649	EF-hand calcium binding domain 11
PA142672386	90288	EFCAB12	chr3	129117164	129157494	40330	EF-hand calcium binding domain 12
PA142672240	124989	EFCAB13	chr17	45391327	45521678	130351	EF-hand calcium binding domain 13
PA142671630	9813	EFCAB14	chr1	47137831	47194792	56961	EF-hand calcium binding domain 14
PA142671914	84288	EFCAB2	chr1	245123171	245291530	168359	EF-hand calcium binding domain 2
PA143485451	146779	EFCAB3	chr17	60437579	60496840	59261	EF-hand calcium binding domain 3
PA145008457	374786	EFCAB5	chr17	28246874	28438470	191596	EF-hand calcium binding domain 5
PA162384324	64800	EFCAB6	chr22	43921624	44218217	296593	EF-hand calcium binding domain 6
PA162384389	84455	EFCAB7	chr1	63979013	64054041	75028	EF-hand calcium binding domain 7
PA164718963	285588	EFCAB9	chr5	171611176	171633458	22282	EF-hand calcium binding domain 9
PA142672165	79825	EFCC1	chr3	128710131	128762585	52454	EF-hand and coiled-coil domain containing 1
PA27652	2202	EFEMP1	chr2	56090097	56161298	71201	EGF containing fibulin-like extracellular matrix protein 1
PA27653	30008	EFEMP2	chr11	65630912	65650405	19493	EGF containing fibulin-like extracellular matrix protein 2
PA134987079	151651	EFHB	chr3	19917964	19987820	69856	EF-hand domain family, member B
PA27654	114327	EFHC1	chr6	52274994	52363583	88589	EF-hand domain (C-terminal) containing 1
PA134938637	80258	EFHC2	chrX	44002549	44212923	210374	EF-hand domain (C-terminal) containing 2
PA134935372	80303	EFHD1	chr2	233460767	233550491	89724	EF-hand domain family, member D1
PA134942316	79180	EFHD2	chr1	15726391	15759839	33448	EF-hand domain family, member D2
PA27656	1942	EFNA1	chr1	155090349	155110386	20037	ephrin-A1
PA27657	1943	EFNA2	chr19	1276153	1304430	28277	ephrin-A2
PA27658	1944	EFNA3	chr1	155041348	155063014	21666	ephrin-A3
PA27659	1945	EFNA4	chr1	155026213	155045029	18816	ephrin-A4
PA27660	1946	EFNA5	chr5	106709590	107016596	307006	ephrin-A5
PA27661	1947	EFNB1	chrX	68038840	68065007	26167	ephrin-B1
PA27662	1948	EFNB2	chr13	107139079	107197388	58309	ephrin-B2
PA27663	1949	EFNB3	chr17	7598520	7617693	19173	ephrin-B3
PA162384422	23167	EFR3A	chr8	132906356	133028889	122533	EFR3 homolog A (S. cerevisiae)
PA162384473	22979	EFR3B	chr2	25254973	25385004	130031	EFR3 homolog B (S. cerevisiae)
PA134887136	10278	EFS	chr14	23822609	23844842	22233	embryonal Fyn-associated substrate
PA134902221	79631	EFTUD1	chr15	82419561	82565104	145543	elongation factor Tu GTP binding domain containing 1
PA142671915	9343	EFTUD2	chr17	42924655	42986993	62338	elongation factor Tu GTP binding domain containing 2
PA27664	1950	EGF	chr4	110824040	110937118	113078	epidermal growth factor
PA165697922	93556	EGFEM1P	chr3	167957310	168551387	594077	EGF-like and EMI domain containing 1, pseudogene
PA27668	25975	EGFL6	chrX	13577694	13654694	77000	EGF-like-domain, multiple 6
PA134928613	51162	EGFL7	chr9	139543308	139570130	26822	EGF-like-domain, multiple 7
PA38372	80864	EGFL8	chr6	32122382	32139062	16680	EGF-like-domain, multiple 8
PA147358056	133584	EGFLAM	chr5	38248511	38468582	220071	EGF-like, fibronectin type III and laminin G domains
PA7360	1956	EGFR	chr7	55076678	55282262	205584	epidermal growth factor receptor
PA27670	54583	EGLN1	chr1	231496497	231570790	74293	egl-9 family hypoxia-inducible factor 1
PA27671	112398	EGLN2	chr19	41295048	41317346	22298	egl-9 family hypoxia-inducible factor 2
PA27672	112399	EGLN3	chr14	34390421	34430284	39863	egl-9 family hypoxia-inducible factor 3
PA27673	1958	EGR1	chr5	137791181	137808004	16823	early growth response 1
PA27674	1959	EGR2	chr10	64568756	64588927	20171	early growth response 2
PA27675	1960	EGR3	chr8	22542172	22560815	18643	early growth response 3
PA27676	1961	EGR4	chr2	73515057	73530829	15772	early growth response 4
PA128394620	23301	EHBP1	chr2	62890986	63276622	385636	EH domain binding protein 1
PA134871712	254102	EHBP1L1	chr11	65333509	65363121	29612	EH domain binding protein 1-like 1
PA27677	10938	EHD1	chr11	64617206	64657181	39975	EH-domain containing 1
PA27678	30846	EHD2	chr19	48206601	48249391	42790	EH-domain containing 2
PA27679	30845	EHD3	chr2	31446880	31494260	47380	EH-domain containing 3
PA27680	30844	EHD4	chr15	42188638	42274755	86117	EH-domain containing 4
PA27681	26298	EHF	chr11	34632588	34687835	55247	ets homologous factor
PA27682	1962	EHHADH	chr3	184905412	184981886	76474	enoyl-CoA, hydratase/3-hydroxyacyl CoA dehydrogenase
PA134941393	79813	EHMT1	chr9	140503444	140733579	230135	euchromatic histone-lysine N-methyltransferase 1
PA25267	10919	EHMT2	chr6	31844536	31875464	30928	euchromatic histone-lysine N-methyltransferase 2
PA134937367	9538	EI24	chr11	125429298	125457575	28277	etoposide induced 2.4
PA26876	23741	EID1	chr15	49160290	49175380	15090	EP300 interacting inhibitor of differentiation 1
PA162384544	163126	EID2	chr19	40026446	40040838	14392	EP300 interacting inhibitor of differentiation 2
PA162384551	126272	EID2B	chr19	40018630	40033494	14864	EP300 interacting inhibitor of differentiation 2B
PA162384552	493861	EID3	chr12	104687510	104701983	14473	EP300 interacting inhibitor of differentiation 3
PA27683	10209	EIF1	chr17	39835127	39850898	15771	eukaryotic translation initiation factor 1
PA162384553	84285	EIF1AD	chr11	65761016	65779637	18621	eukaryotic translation initiation factor 1A domain containing
PA27684	1964	EIF1AX	chrX	20139636	20169966	30330	eukaryotic translation initiation factor 1A, X-linked
PA27686	9086	EIF1AY	chrY	22727597	22758040	30443	eukaryotic translation initiation factor 1A, Y-linked
PA143485452	10289	EIF1B	chr3	40341173	40356915	15742	eukaryotic translation initiation factor 1B
PA143485453	83939	EIF2A	chr3	150254465	150306803	52338	eukaryotic translation initiation factor 2A, 65kDa
PA134919097	27102	EIF2AK1	chr7	6058878	6108860	49982	eukaryotic translation initiation factor 2-alpha kinase 1
PA33779	5610	EIF2AK2	chr2	37329281	37394190	64909	eukaryotic translation initiation factor 2-alpha kinase 2
PA27687	9451	EIF2AK3	chr2	88853259	88937094	83835	eukaryotic translation initiation factor 2-alpha kinase 3
PA134947616	440275	EIF2AK4	chr15	40216331	40330797	114466	eukaryotic translation initiation factor 2 alpha kinase 4
PA27688	1967	EIF2B1	chr12	124102570	124128323	25753	eukaryotic translation initiation factor 2B, subunit 1 alpha, 26kDa
PA27689	8892	EIF2B2	chr14	75459612	75479294	19682	eukaryotic translation initiation factor 2B, subunit 2 beta, 39kDa
PA27690	8891	EIF2B3	chr1	45313194	45462394	149200	eukaryotic translation initiation factor 2B, subunit 3 gamma, 58kDa
PA27691	8890	EIF2B4	chr2	27584219	27603324	19105	eukaryotic translation initiation factor 2B, subunit 4 delta, 67kDa
PA27692	8893	EIF2B5	chr3	183842810	183866099	23289	eukaryotic translation initiation factor 2B, subunit 5 epsilon, 82kDa
PA30355	1939	EIF2D	chr1	206761974	206795904	33930	eukaryotic translation initiation factor 2D
PA27695	1965	EIF2S1	chr14	67817034	67856233	39199	eukaryotic translation initiation factor 2, subunit 1 alpha, 35kDa
PA27696	8894	EIF2S2	chr20	32673115	32710085	36970	eukaryotic translation initiation factor 2, subunit 2 beta, 38kDa
PA27697	1968	EIF2S3	chrX	24063065	24099927	36862	eukaryotic translation initiation factor 2, subunit 3 gamma, 52kDa
PA27699	8661	EIF3A	chr10	120791541	120850959	59418	eukaryotic translation initiation factor 3, subunit A
PA162384603	8662	EIF3B	chr7	2384474	2423380	38906	eukaryotic translation initiation factor 3, subunit B
PA162384646	8663	EIF3C	chr16	28689879	28750051	60172	eukaryotic translation initiation factor 3, subunit C
PA162384693	728689	EIF3CL	chr16	28387900	28425162	37262	eukaryotic translation initiation factor 3, subunit C-like
PA162384740	8664	EIF3D	chr22	36903897	36935277	31380	eukaryotic translation initiation factor 3, subunit D
PA27705	3646	EIF3E	chr8	109210972	109270959	59987	eukaryotic translation initiation factor 3, subunit E
PA162384806	8665	EIF3F	chr11	7998867	8020718	21851	eukaryotic translation initiation factor 3, subunit F
PA162384827	8666	EIF3G	chr19	10222690	10240599	17909	eukaryotic translation initiation factor 3, subunit G
PA162384854	8667	EIF3H	chr8	117654055	117778258	124203	eukaryotic translation initiation factor 3, subunit H
PA162384875	8668	EIF3I	chr1	32677971	32700205	22234	eukaryotic translation initiation factor 3, subunit I
PA162384902	8669	EIF3J	chr15	44819266	44858001	38735	eukaryotic translation initiation factor 3, subunit J
PA162384923	27335	EIF3K	chr19	39099722	39130595	30873	eukaryotic translation initiation factor 3, subunit K
PA27706	51386	EIF3L	chr22	38235379	38287789	52410	eukaryotic translation initiation factor 3, subunit L
PA162384944	10480	EIF3M	chr11	32595313	32627037	31724	eukaryotic translation initiation factor 3, subunit M
PA27710	1973	EIF4A1	chr17	7466024	7485324	19300	eukaryotic translation initiation factor 4A1
PA27712	1974	EIF4A2	chr3	186491361	186510686	19325	eukaryotic translation initiation factor 4A2
PA162384945	9775	EIF4A3	chr17	78106013	78130982	24969	eukaryotic translation initiation factor 4A3
PA27713	1975	EIF4B	chr12	53389942	53438993	49051	eukaryotic translation initiation factor 4B
PA27714	1977	EIF4E	chr4	99796607	99861786	65179	eukaryotic translation initiation factor 4E
PA162384974	253314	EIF4E1B	chr5	176047683	176076642	28959	eukaryotic translation initiation factor 4E family member 1B
PA27720	9470	EIF4E2	chr2	233404762	233451354	46592	eukaryotic translation initiation factor 4E family member 2
PA134961880	317649	EIF4E3	chr3	71725440	71813924	88484	eukaryotic translation initiation factor 4E family member 3
PA27715	1978	EIF4EBP1	chr8	37878020	37920883	42863	eukaryotic translation initiation factor 4E binding protein 1
PA27716	1979	EIF4EBP2	chr10	72153861	72191374	37513	eukaryotic translation initiation factor 4E binding protein 2
PA27718	8637	EIF4EBP3	chr5	139917251	139932163	14912	eukaryotic translation initiation factor 4E binding protein 3
PA38410	56478	EIF4ENIF1	chr22	31832345	31895936	63591	eukaryotic translation initiation factor 4E nuclear import factor 1
PA27722	1981	EIF4G1	chr3	184022283	184056146	33863	eukaryotic translation initiation factor 4 gamma, 1
PA27723	1982	EIF4G2	chr11	10815593	10840582	24989	eukaryotic translation initiation factor 4 gamma, 2
PA27724	8672	EIF4G3	chr1	21129785	21513381	383596	eukaryotic translation initiation factor 4 gamma, 3
PA162384997	7458	EIF4H	chr7	73578706	73614429	35723	eukaryotic translation initiation factor 4H
PA27725	1983	EIF5	chr14	103790339	103814362	24023	eukaryotic translation initiation factor 5
PA27726	1984	EIF5A	chr17	7200318	7218782	18464	eukaryotic translation initiation factor 5A
PA27727	56648	EIF5A2	chr3	170603204	170636426	33222	eukaryotic translation initiation factor 5A2
PA134920977	143244	EIF5AL1	chr10	81262357	81279196	16839	eukaryotic translation initiation factor 5A-like 1
PA134864457	9669	EIF5B	chr2	99943821	100019728	75907	eukaryotic translation initiation factor 5B
PA29958	3692	EIF6	chr20	33863709	33882619	18910	eukaryotic translation initiation factor 6
PA27738	55520	ELAC1	chr18	48484387	48517491	33104	elaC ribonuclease Z 1
PA27739	60528	ELAC2	chr17	12891929	12931381	39452	elaC ribonuclease Z 2
PA27735	1991	ELANE	chr19	840989	859246	18257	elastase, neutrophil expressed
PA27740	1994	ELAVL1	chr19	8020457	8080529	60072	ELAV like RNA binding protein 1
PA27741	1993	ELAVL2	chr9	23687097	23836342	149245	ELAV like neuron-specific RNA binding protein 2
PA27742	1995	ELAVL3	chr19	11559143	11601806	42663	ELAV like neuron-specific RNA binding protein 3
PA27743	1996	ELAVL4	chr1	50503686	50672442	168756	ELAV like neuron-specific RNA binding protein 4
PA27744	1997	ELF1	chr13	41503055	41645544	142489	E74-like factor 1 (ets domain transcription factor)
PA27745	1998	ELF2	chr4	139975871	140108372	132501	E74-like factor 2 (ets domain transcription factor)
PA27746	1999	ELF3	chr1	201969647	201989316	19669	E74-like factor 3 (ets domain transcription factor, epithelial-specific )
PA27747	2000	ELF4	chrX	129195895	129254688	58793	E74-like factor 4 (ets domain transcription factor)
PA27748	2001	ELF5	chr11	34497342	34545347	48005	E74-like factor 5 (ets domain transcription factor)
PA162385031	392617	ELFN1	chr7	1738798	1790590	51792	extracellular leucine-rich repeat and fibronectin type III domain containing 1
PA162385040	114794	ELFN2	chr22	37761000	37833505	72505	extracellular leucine-rich repeat and fibronectin type III domain containing 2
PA27749	2002	ELK1	chrX	47490744	47520003	29259	ELK1, member of ETS oncogene family
PA27752	2004	ELK3	chr12	96578207	96664606	86399	ELK3, ETS-domain protein (SRF accessory protein 2)
PA27753	2005	ELK4	chr1	205574071	205612971	38900	ELK4, ETS-domain protein (SRF accessory protein 1)
PA134939610	8178	ELL	chr19	18550473	18642937	92464	elongation factor RNA polymerase II
PA134935340	22936	ELL2	chr5	95217802	95307775	89973	elongation factor, RNA polymerase II, 2
PA128394728	80237	ELL3	chr15	44061798	44079502	17704	elongation factor RNA polymerase II-like 3
PA27754	9844	ELMO1	chr7	36889511	37498895	609384	engulfment and cell motility 1
PA27755	63916	ELMO2	chr20	44991689	45045690	54001	engulfment and cell motility 2
PA27756	79767	ELMO3	chr16	67223014	67240932	17918	engulfment and cell motility 3
PA134903991	55531	ELMOD1	chr11	107451817	107540505	88688	ELMO/CED-12 domain containing 1
PA134984145	255520	ELMOD2	chr4	141435312	141477924	42612	ELMO/CED-12 domain containing 2
PA164719009	84173	ELMOD3	chr2	85571843	85621875	50032	ELMO/CED-12 domain containing 3
PA134877876	91748	ELMSAN1	chr14	74178825	74266988	88163	ELM2 and Myb/SANT-like domain containing 1
PA27757	2006	ELN	chr7	73432119	73487237	55118	elastin
PA142671911	84337	ELOF1	chr19	11660858	11680051	19193	elongation factor 1 homolog (S. cerevisiae)
PA27760	64834	ELOVL1	chr1	43826068	43843745	17677	ELOVL fatty acid elongase 1
PA27761	54898	ELOVL2	chr6	10977992	11054624	76632	ELOVL fatty acid elongase 2
PA27762	83401	ELOVL3	chr10	103976143	103992346	16203	ELOVL fatty acid elongase 3
PA27763	6785	ELOVL4	chr6	80621529	80667315	45786	ELOVL fatty acid elongase 4
PA128394703	60481	ELOVL5	chr6	53129196	53223977	94781	ELOVL fatty acid elongase 5
PA134939058	79071	ELOVL6	chr4	110967187	111130355	163168	ELOVL fatty acid elongase 6
PA134934034	79993	ELOVL7	chr5	60044616	60150101	105485	ELOVL fatty acid elongase 7
PA162385051	55250	ELP2	chr18	33699837	33757688	57851	elongator acetyltransferase complex subunit 2
PA134992603	55140	ELP3	chr8	27940584	28051670	111086	elongator acetyltransferase complex subunit 3
PA27764	26610	ELP4	chr11	31521297	31809073	287776	elongator acetyltransferase complex subunit 4
PA143485405	23587	ELP5	chr17	7145372	7166259	20887	elongator acetyltransferase complex subunit 5
PA164717260	54859	ELP6	chr3	47534130	47565199	31069	elongator acetyltransferase complex subunit 6
PA27765	64100	ELSPBP1	chr19	48487908	48531410	43502	epididymal sperm binding protein 1
PA134946418	64123	ELTD1	chr1	79352449	79482495	130046	EGF, latrophilin and seven transmembrane domain containing 1
PA134917460	133418	EMB	chr5	49689026	49747234	58208	embigin
PA142671634	23065	EMC1	chr1	19539158	19588053	48895	ER membrane protein complex subunit 1
PA162378790	284361	EMC10	chr19	50969736	50989608	19872	ER membrane protein complex subunit 10
PA162407224	9694	EMC2	chr8	109445853	109502136	56283	ER membrane protein complex subunit 2
PA142670762	55831	EMC3	chr3	10002636	10039146	36510	ER membrane protein complex subunit 3
PA143485634	51234	EMC4	chr15	34507214	34525357	18143	ER membrane protein complex subunit 4
PA142670745	83460	EMC6	chr17	3562090	3575962	13872	ER membrane protein complex subunit 6
PA134900493	56851	EMC7	chr15	34373223	34404053	30830	ER membrane protein complex subunit 7
PA31668	10328	EMC8	chr16	85809230	85843161	33931	ER membrane protein complex subunit 8
PA162386700	51016	EMC9	chr14	24605081	24620837	15756	ER membrane protein complex subunit 9
PA144596436	51705	EMCN	chr4	101313498	101449250	135752	endomucin
PA27766	2010	EMD	chrX	153597597	153612883	15286	emerin
PA134904115	146956	EME1	chr17	48440581	48461820	21239	essential meiotic structure-specific endonuclease 1
PA134863517	197342	EME2	chr16	1813223	1829628	16405	essential meiotic structure-specific endonuclease subunit 2
PA142671909	10436	EMG1	chr12	7069944	7088165	18221	EMG1 N1-specific pseudouridine methyltransferase
PA134921314	129080	EMID1	chr22	29591901	29658586	66685	EMI domain containing 1
PA134922135	11117	EMILIN1	chr2	27291435	27312271	20836	elastin microfibril interfacer 1
PA134880588	84034	EMILIN2	chr18	2836786	2917090	80304	elastin microfibril interfacer 2
PA164741521	90187	EMILIN3	chr20	39985606	40005498	19892	elastin microfibril interfacer 3
PA27767	2009	EML1	chr14	100194056	100411397	217341	echinoderm microtubule associated protein like 1
PA27768	24139	EML2	chr19	46109658	46158775	49117	echinoderm microtubule associated protein like 2
PA142671910	256364	EML3	chr11	62366690	62390492	23802	echinoderm microtubule associated protein like 3
PA27769	27436	EML4	chr2	42386490	42562688	176198	echinoderm microtubule associated protein like 4
PA134894613	161436	EML5	chr14	89076241	89269096	192855	echinoderm microtubule associated protein like 5
PA164719036	400954	EML6	chr2	54942149	55202157	260008	echinoderm microtubule associated protein like 6
PA27770	2012	EMP1	chr12	13339602	13372708	33106	epithelial membrane protein 1
PA27771	2013	EMP2	chr16	10619279	10684539	65260	epithelial membrane protein 2
PA27772	2014	EMP3	chr19	48818629	48836810	18181	epithelial membrane protein 3
PA27773	2015	EMR1	chr19	6877560	6943464	65904	egf-like module containing, mucin-like, hormone receptor-like 1
PA27774	30817	EMR2	chr19	14840509	14899353	58844	egf-like module containing, mucin-like, hormone receptor-like 2
PA134956879	84658	EMR3	chr19	14727051	14795730	68679	egf-like module containing, mucin-like, hormone receptor-like 3
PA134948805	326342	EMR4P	chr19	6949511	7000857	51346	egf-like module containing, mucin-like, hormone receptor-like 4 pseudogene
PA27777	2016	EMX1	chr2	73134604	73165020	30416	empty spiracles homeobox 1
PA27778	2018	EMX2	chr10	119291956	119312057	20101	empty spiracles homeobox 2
PA27779	2019	EN1	chr2	119596747	119615759	19012	engrailed homeobox 1
PA27780	2020	EN2	chr7	155240824	155260526	19702	engrailed homeobox 2
PA38517	55740	ENAH	chr1	225671534	225850845	179311	enabled homolog (Drosophila)
PA27781	10117	ENAM	chr4	71484461	71515536	31075	enamelin
PA27782	8507	ENC1	chr5	73920231	73947249	27018	ectodermal-neural cortex 1 (with BTB domain)
PA143485454	23052	ENDOD1	chr11	94812974	94868815	55841	endonuclease domain containing 1
PA27783	2021	ENDOG	chr9	131570779	131587955	17176	endonuclease G
PA165512645	8909	ENDOU	chr12	48100517	48129355	28838	endonuclease, polyU-specific
PA27785	2022	ENG	chr9	130574291	130627052	52761	endoglin
PA164719123	64772	ENGASE	chr17	77057565	77087685	30120	endo-beta-N-acetylglucosaminidase
PA164719156	375704	ENHO	chr9	34518040	34533037	14997	energy homeostasis associated
PA142672256	84080	ENKD1	chr16	67693850	67710628	16778	enkurin domain containing 1
PA165548526	219670	ENKUR	chr10	25267908	25361208	93300	enkurin, TRPC channel interacting protein
PA27786	2023	ENO1	chr1	8918059	8949151	31092	enolase 1, (alpha)
PA27788	2026	ENO2	chr12	7013614	7035860	22246	enolase 2 (gamma, neuronal)
PA27789	2027	ENO3	chr17	4843404	4863426	20022	enolase 3 (beta, muscle)
PA165548527	387712	ENO4	chr10	118598741	118645112	46371	enolase family member 4
PA162385052	58478	ENOPH1	chr4	83341726	83385245	43519	enolase-phosphatase 1
PA134897613	55556	ENOSF1	chr18	667324	722662	55338	enolase superfamily member 1
PA162385069	55068	ENOX1	chr13	43784335	44371116	586781	ecto-NOX disulfide-thiol exchanger 1
PA162385106	10495	ENOX2	chrX	129754355	130047219	292864	ecto-NOX disulfide-thiol exchanger 2
PA27790	2028	ENPEP	chr4	111387229	111487493	100264	glutamyl aminopeptidase (aminopeptidase A)
PA27791	5167	ENPP1	chr6	132119156	132219295	100139	ectonucleotide pyrophosphatase/phosphodiesterase 1
PA27792	5168	ENPP2	chr8	120566317	120695644	129327	ectonucleotide pyrophosphatase/phosphodiesterase 2
PA27793	5169	ENPP3	chr6	131948375	132071550	123175	ectonucleotide pyrophosphatase/phosphodiesterase 3
PA27794	22875	ENPP4	chr6	46087701	46117436	29735	ectonucleotide pyrophosphatase/phosphodiesterase 4 (putative)
PA27795	59084	ENPP5	chr6	46123922	46148737	24815	ectonucleotide pyrophosphatase/phosphodiesterase 5 (putative)
PA134945118	133121	ENPP6	chr4	185006859	185149114	142255	ectonucleotide pyrophosphatase/phosphodiesterase 6
PA134986550	339221	ENPP7	chr17	77694882	77719021	24139	ectonucleotide pyrophosphatase/phosphodiesterase 7
PA27796	2029	ENSA	chr1	150591599	150612098	20499	endosulfine alpha
PA145148940	150350	ENTHD1	chr22	40136049	40299794	163745	ENTH domain containing 1
PA142672239	146705	ENTHD2	chr17	79199072	79222891	23819	ENTH domain containing 2
PA27798	953	ENTPD1	chr10	97461536	97640023	178487	ectonucleoside triphosphate diphosphohydrolase 1
PA27799	954	ENTPD2	chr9	139939550	139958503	18953	ectonucleoside triphosphate diphosphohydrolase 2
PA27800	956	ENTPD3	chr3	40418647	40473110	54463	ectonucleoside triphosphate diphosphohydrolase 3
PA30502	9583	ENTPD4	chr8	23281687	23325244	43557	ectonucleoside triphosphate diphosphohydrolase 4
PA27802	957	ENTPD5	chr14	74423169	74496026	72857	ectonucleoside triphosphate diphosphohydrolase 5
PA27803	955	ENTPD6	chr20	25166327	25210365	44038	ectonucleoside triphosphate diphosphohydrolase 6 (putative)
PA134993462	57089	ENTPD7	chr10	101409263	101474002	64739	ectonucleoside triphosphate diphosphohydrolase 7
PA142671906	377841	ENTPD8	chr9	140325816	140345901	20085	ectonucleoside triphosphate diphosphohydrolase 8
PA142671907	56943	ENY2	chr8	110336552	110361189	24637	enhancer of yellow 2 homolog (Drosophila)
PA143485338	285203	EOGT	chr3	69021363	69073112	51749	EGF domain-specific O-linked N-acetylglucosamine (GlcNAc) transferase
PA27806	8320	EOMES	chr3	27754440	27774206	19766	eomesodermin
PA27807	2033	EP300	chr22	41478614	41579081	100467	E1A binding protein p300
PA27808	57634	EP400	chr12	132424465	132568011	143546	E1A binding protein p400
PA27809	2034	EPAS1	chr2	46514541	46616842	102301	endothelial PAS domain protein 1
PA27810	2035	EPB41	chr1	29203603	29449558	245955	erythrocyte membrane protein band 4.1
PA27811	2036	EPB41L1	chr20	34669426	34823721	154295	erythrocyte membrane protein band 4.1-like 1
PA27812	2037	EPB41L2	chr6	131157487	131394462	236975	erythrocyte membrane protein band 4.1-like 2
PA27813	23136	EPB41L3	chr18	5389380	5640662	251282	erythrocyte membrane protein band 4.1-like 3
PA134994123	64097	EPB41L4A	chr5	111475139	111765187	290048	erythrocyte membrane protein band 4.1 like 4A
PA134986250	54566	EPB41L4B	chr9	111931254	112093021	161767	erythrocyte membrane protein band 4.1 like 4B
PA134862834	57669	EPB41L5	chr2	120760604	120939697	179093	erythrocyte membrane protein band 4.1 like 5
PA27814	2038	EPB42	chr15	43486425	43523323	36898	erythrocyte membrane protein band 4.2
PA134981141	80314	EPC1	chr10	32553644	32677726	124082	enhancer of polycomb homolog 1 (Drosophila)
PA134875170	26122	EPC2	chr2	149392560	149548136	155576	enhancer of polycomb homolog 2 (Drosophila)
PA35493	4072	EPCAM	chr2	47586287	47617167	30880	epithelial cell adhesion molecule
PA142671908	54749	EPDR1	chr7	37950163	37994543	44380	ependymin related 1
PA134941500	57724	EPG5	chr18	43424574	43557305	132731	ectopic P-granules autophagy protein 5 homolog (C. elegans)
PA162385143	255324	EPGN	chr4	75164187	75185520	21333	epithelial mitogen
PA27817	2041	EPHA1	chr7	143085205	143115985	30780	EPH receptor A1
PA134938798	284656	EPHA10	chr1	38178646	38240824	62178	EPH receptor A10
PA27818	1969	EPHA2	chr1	16447832	16492582	44750	EPH receptor A2
PA27819	2042	EPHA3	chr3	89146674	89534284	387610	EPH receptor A3
PA27820	2043	EPHA4	chr2	222279747	222447010	167263	EPH receptor A4
PA27821	2044	EPHA5	chr4	66182281	66546529	364248	EPH receptor A5
PA134866684	285220	EPHA6	chr3	96523425	97470786	947361	EPH receptor A6
PA27822	2045	EPHA7	chr6	93946738	94139302	192564	EPH receptor A7
PA27823	2046	EPHA8	chr1	22880004	22933087	53083	EPH receptor A8
PA27824	2047	EPHB1	chr3	134504099	134982309	478210	EPH receptor B1
PA27825	2048	EPHB2	chr1	23027263	23244823	217560	EPH receptor B2
PA27826	2049	EPHB3	chr3	184269587	184303196	33609	EPH receptor B3
PA27827	2050	EPHB4	chr7	100397187	100435143	37956	EPH receptor B4
PA27828	2051	EPHB6	chr7	142542776	142571847	29071	EPH receptor B6
PA27829	2052	EPHX1	chr1	225987797	226036264	48467	epoxide hydrolase 1, microsomal (xenobiotic)
PA27830	2053	EPHX2	chr8	27338519	27405439	66920	epoxide hydrolase 2, cytoplasmic
PA164719188	79852	EPHX3	chr19	15334730	15353858	19128	epoxide hydrolase 3
PA164719207	253152	EPHX4	chr1	92485533	92532093	46560	epoxide hydrolase 4
PA27832	7957	EPM2A	chr6	145943440	146067128	123688	epilepsy, progressive myoclonus type 2A, Lafora disease (laforin)
PA134917440	9852	EPM2AIP1	chr3	37024357	37044795	20438	EPM2A (laforin) interacting protein 1
PA134860916	29924	EPN1	chr19	56176561	56210141	33580	epsin 1
PA38615	22905	EPN2	chr17	19130690	19243028	112338	epsin 2
PA38513	55040	EPN3	chr17	48600043	48624111	24068	epsin 3
PA27833	2056	EPO	chr7	100308423	100324323	15900	erythropoietin
PA27834	2057	EPOR	chr19	11484881	11505018	20137	erythropoietin receptor
PA38054	57119	EPPIN	chr20	44166265	44186516	20251	epididymal peptidase inhibitor
PA27837	2058	EPRS	chr1	220138940	220230000	91060	glutamyl-prolyl-tRNA synthetase
PA27838	2060	EPS15	chr1	51816935	51995026	178091	epidermal growth factor receptor pathway substrate 15
PA134906266	58513	EPS15L1	chr19	16463055	16592823	129768	epidermal growth factor receptor pathway substrate 15-like 1
PA27839	2059	EPS8	chr12	15770075	15952510	182435	epidermal growth factor receptor pathway substrate 8
PA134990326	54869	EPS8L1	chr19	55577221	55602291	25070	EPS8-like 1
PA134981048	64787	EPS8L2	chr11	696120	730727	34607	EPS8-like 2
PA134940846	79574	EPS8L3	chr1	110289702	110316644	26942	EPS8-like 3
PA27840	94240	EPSTI1	chr13	43457524	43576407	118883	epithelial stromal interaction 1 (breast)
PA165696581	85465	EPT1	chr2	26558954	26621759	62805	ethanolaminephosphotransferase 1 (CDP-ethanolamine-specific)
PA27841	8288	EPX	chr17	56260089	56285535	25446	eosinophil peroxidase
PA162385144	1833	EPYC	chr12	91354456	91408803	54347	epiphycan
PA25969	54586	EQTN	chr9	27281652	27307137	25485	equatorin, sperm acrosome associated
PA27843	26284	ERAL1	chr17	27172043	27191072	19029	Era-like 12S mitochondrial rRNA chaperone 1
PA162385163	51752	ERAP1	chr5	96093514	96159848	66334	endoplasmic reticulum aminopeptidase 1
PA162385208	64167	ERAP2	chr5	96201644	96258420	56776	endoplasmic reticulum aminopeptidase 2
PA29448	3266	ERAS	chrX	48674923	48691279	16356	ES cell expressed Ras
PA27844	2064	ERBB2	chr17	37834167	37887915	53748	v-erb-b2 avian erythroblastic leukemia viral oncogene homolog 2
PA27845	55914	ERBB2IP	chr5	65212382	65379851	167469	erbb2 interacting protein
PA27846	2065	ERBB3	chr12	56463809	56500291	36482	v-erb-b2 avian erythroblastic leukemia viral oncogene homolog 3
PA27847	2066	ERBB4	chr2	212237442	213413879	1176437	v-erb-b2 avian erythroblastic leukemia viral oncogene homolog 4
PA134970875	23085	ERC1	chr12	1090404	1608099	517695	ELKS/RAB6-interacting/CAST family member 1
PA162385249	26059	ERC2	chr3	55539336	56512391	973055	ELKS/RAB6-interacting/CAST family member 2
PA155	2067	ERCC1	chr19	45907591	45992241	84650	excision repair cross-complementation group 1
PA27848	2068	ERCC2	chr19	45851649	45883845	32196	excision repair cross-complementation group 2
PA27849	2071	ERCC3	chr2	128011866	128061752	49886	excision repair cross-complementation group 3
PA27850	2072	ERCC4	chr16	14004014	14049205	45191	excision repair cross-complementation group 4
PA27851	2073	ERCC5	chr13	103488191	103531351	43160	excision repair cross-complementation group 5
PA27852	2074	ERCC6	chr10	50659526	50757169	97643	excision repair cross-complementation group 6
PA162385290	54821	ERCC6L	chrX	71421507	71468877	47370	excision repair cross-complementation group 6-like
PA134961240	375748	ERCC6L2	chr9	98627900	98734122	106222	excision repair cross-complementation group 6-like 2
PA27853	1161	ERCC8	chr5	60166659	60250905	84246	excision repair cross-complementation group 8
PA27856	2069	EREG	chr4	75220860	75257477	36617	epiregulin
PA27857	2077	ERF	chr19	42748717	42769309	20592	Ets2 repressor factor
PA27858	2078	ERG	chr21	39736183	40043704	307521	v-ets avian erythroblastosis virus E26 oncogene homolog
PA143485456	57222	ERGIC1	chr5	172251223	172382688	131465	endoplasmic reticulum-golgi intermediate compartment (ERGIC) 1
PA143485457	51290	ERGIC2	chr12	29490579	29544143	53564	ERGIC and golgi 2
PA38050	51614	ERGIC3	chr20	34119778	34148405	28627	ERGIC and golgi 3
PA27859	2079	ERH	chr14	69843840	69875021	31181	enhancer of rudimentary homolog (Drosophila)
PA164719226	90459	ERI1	chr8	8850314	8893849	43535	exoribonuclease 1
PA164719245	112479	ERI2	chr16	20788515	20827798	39283	ERI1 exoribonuclease family member 2
PA164719272	79033	ERI3	chr1	44683742	44831315	147573	ERI1 exoribonuclease family member 3
PA142671903	157697	ERICH1	chr8	603733	691226	87493	glutamate-rich 1
PA142672422	127254	ERICH3	chr1	75030795	75149422	118627	glutamate-rich 3
PA162378862	100170765	ERICH4	chr19	41939063	41953670	14607	glutamate-rich 4
PA142672366	203111	ERICH5	chr8	99066750	99108838	42088	glutamate-rich 5
PA165697300	131831	ERICH6	chr3	150374675	150431742	57067	glutamate-rich 6
PA165505094	220081	ERICH6B	chr13	46112432	46199874	87442	glutamate-rich 6B
PA165696636	27248	ERLEC1	chr2	54004068	54048956	44888	endoplasmic reticulum lectin 1
PA162385299	10613	ERLIN1	chr10	101906847	101955814	48967	ER lipid raft associated 1
PA25961	11160	ERLIN2	chr8	37583743	37618319	34576	ER lipid raft associated 2
PA27860	114625	ERMAP	chr1	43272776	43313660	40884	erythroblast membrane-associated protein (Scianna blood group)
PA134884522	55780	ERMARD	chr6	170141721	170184617	42896	ER membrane-associated RNA degradation
PA162385355	57471	ERMN	chr2	158172125	158194146	22021	ermin, ERM-like protein
PA162385366	79956	ERMP1	chr9	5781572	5843081	61509	endoplasmic reticulum metallopeptidase 1
PA27861	2081	ERN1	chr17	62113502	62217502	104000	endoplasmic reticulum to nucleus signaling 1
PA134889542	10595	ERN2	chr16	23698625	23734821	36196	endoplasmic reticulum to nucleus signaling 2
PA27862	30001	ERO1L	chr14	53105605	53172419	66814	ERO1-like (S. cerevisiae)
PA134918597	56605	ERO1LB	chr1	236375422	236455339	79917	ERO1-like beta (S. cerevisiae)
PA162385401	121506	ERP27	chr12	15063961	15101463	37502	endoplasmic reticulum protein 27
PA25509	10961	ERP29	chr12	112441152	112464024	22872	endoplasmic reticulum protein 29
PA164719295	23071	ERP44	chr9	102738461	102871330	132869	endoplasmic reticulum protein 44
PA142671904	54206	ERRFI1	chr1	8068779	8096393	27614	ERBB receptor feedback inhibitor 1
PA27866	2086	ERV3-1	chr7	64447733	64477124	29391	endogenous retrovirus group 3, member 1
PA27878	30816	ERVW-1	chr7	92094694	92117229	22535	endogenous retrovirus group W, member 1
PA134954912	90952	ESAM	chr11	124620019	124642223	22204	endothelial cell adhesion molecule
PA134924215	114799	ESCO1	chr18	19106242	19190697	84455	establishment of sister chromatid cohesion N-acetyltransferase 1
PA134891970	157570	ESCO2	chr8	27622057	27673141	51084	establishment of sister chromatid cohesion N-acetyltransferase 2
PA27882	2098	ESD	chr13	47342391	47381423	39032	esterase D
PA162385420	51575	ESF1	chr20	13691969	13775579	83610	ESF1, nucleolar pre-rRNA processing protein, homolog (S. cerevisiae)
PA27883	11082	ESM1	chr5	54270695	54291414	20719	endothelial cell-specific molecule 1
PA27884	9700	ESPL1	chr12	53652083	53690427	38344	extra spindle pole bodies homolog 1 (S. cerevisiae)
PA27885	83715	ESPN	chr1	6474836	6524004	49168	espin
PA162385421	339768	ESPNL	chr2	238998951	239044928	45977	espin-like
PA156	2099	ESR1	chr6	152001631	152427409	425778	estrogen receptor 1
PA27886	2100	ESR2	chr14	64690751	64815268	124517	estrogen receptor 2 (ER beta)
PA164719324	54845	ESRP1	chr8	95643364	95722694	79330	epithelial splicing regulatory protein 1
PA164719361	80004	ESRP2	chr16	68259450	68280136	20686	epithelial splicing regulatory protein 2
PA27887	2101	ESRRA	chr11	64062990	64087215	24225	estrogen-related receptor alpha
PA27889	2103	ESRRB	chr14	76827690	76971182	143492	estrogen-related receptor beta
PA27891	2104	ESRRG	chr1	216673588	217321097	647509	estrogen-related receptor gamma
PA27892	80712	ESX1	chrX	103491719	103509599	17880	ESX homeobox 1
PA165512688	23344	ESYT1	chr12	56511985	56550259	38274	extended synaptotagmin-like protein 1
PA165617947	57488	ESYT2	chr7	158520688	158632729	112041	extended synaptotagmin-like protein 2
PA165697118	83850	ESYT3	chr3	138143415	138200910	57495	extended synaptotagmin-like protein 3
PA162385444	54465	ETAA1	chr2	67614442	67640540	26098	Ewing tumor-associated antigen 1
PA27893	2107	ETF1	chr5	137838782	137888989	50207	eukaryotic translation termination factor 1
PA27897	2108	ETFA	chr15	76505628	76613810	108182	electron-transfer-flavoprotein, alpha polypeptide
PA27898	2109	ETFB	chr19	51845409	51879672	34263	electron-transfer-flavoprotein, beta polypeptide
PA27899	2110	ETFDH	chr4	159583277	159632842	49565	electron-transferring-flavoprotein dehydrogenase
PA134879650	23474	ETHE1	chr19	44007871	44041408	33537	ethylmalonic encephalopathy 1
PA134921265	55500	ETNK1	chr12	22768076	22846608	78532	ethanolamine kinase 1
PA134888760	55224	ETNK2	chr1	204097190	204131307	34117	ethanolamine kinase 2
PA24635	64850	ETNPPL	chr4	109660196	109694235	34039	ethanolamine-phosphate phospho-lyase
PA27902	2113	ETS1	chr11	128325656	128467453	141797	v-ets avian erythroblastosis virus E26 oncogene homolog 1
PA27903	2114	ETS2	chr21	40167231	40199879	32648	v-ets avian erythroblastosis virus E26 oncogene homolog 2
PA27904	2115	ETV1	chr7	13927854	14041050	113196	ets variant 1
PA27905	2116	ETV2	chr19	36122647	36139007	16360	ets variant 2
PA27906	2117	ETV3	chr1	157091459	157118383	26924	ets variant 3
PA162385461	440695	ETV3L	chr1	157058835	157079600	20765	ets variant 3-like
PA27907	2118	ETV4	chr17	41602211	41633800	31589	ets variant 4
PA27908	2119	ETV5	chr3	185761106	185836901	75795	ets variant 5
PA27909	2120	ETV6	chr12	11792788	12051336	258548	ets variant 6
PA134980006	51513	ETV7	chr6	36318998	36365577	46579	ets variant 7
PA162387354	84141	EVA1A	chr2	75716444	75806848	90404	eva-1 homolog A (C. elegans)
PA162387367	55194	EVA1B	chr1	36784631	36800567	15936	eva-1 homolog B (C. elegans)
PA25858	59271	EVA1C	chr21	33774034	33890702	116668	eva-1 homolog C (C. elegans)
PA27911	2121	EVC	chr4	5702924	5819031	116107	Ellis van Creveld syndrome
PA134989044	132884	EVC2	chr4	5541531	5721275	179744	Ellis van Creveld syndrome 2
PA27913	2123	EVI2A	chr17	29640428	29658767	18339	ecotropic viral integration site 2A
PA27914	2124	EVI2B	chr17	29626888	29651130	24242	ecotropic viral integration site 2B
PA27915	7813	EVI5	chr1	92971253	93267961	296708	ecotropic viral integration site 5
PA134905968	115704	EVI5L	chr19	7885161	7932862	47701	ecotropic viral integration site 5-like
PA134890866	51466	EVL	chr14	100475719	100613573	137854	Enah/Vasp-like
PA27916	2125	EVPL	chr17	73999926	74033533	33607	envoplakin
PA164719396	645027	EVPLL	chr17	18271079	18295961	24882	envoplakin-like
PA27919	2128	EVX1	chr7	27272164	27290438	18274	even-skipped homeobox 1
PA27920	344191	EVX2	chr2	176941835	176958690	16855	even-skipped homeobox 2
PA27921	2130	EWSR1	chr22	29653998	29699515	45517	EWS RNA-binding protein 1
PA164719420	161829	EXD1	chr15	41471926	41532955	61029	exonuclease 3'-5' domain containing 1
PA164719421	55218	EXD2	chr14	69648194	69713737	65543	exonuclease 3'-5' domain containing 2
PA164719422	54932	EXD3	chr9	140198346	140327714	129368	exonuclease 3'-5' domain containing 3
PA27923	9156	EXO1	chr1	242001491	242056241	54750	exonuclease 1
PA164718736	64789	EXO5	chr1	40964391	40985228	20837	exonuclease 5
PA134891660	55763	EXOC1	chr4	56709802	56774244	64442	exocyst complex component 1
PA134862170	55770	EXOC2	chr6	482138	703141	221003	exocyst complex component 2
PA134869816	11336	EXOC3	chr5	433305	470414	37109	exocyst complex component 3
PA147031724	283849	EXOC3L1	chr16	67214652	67234112	19460	exocyst complex component 3-like 1
PA162385462	90332	EXOC3L2	chr19	45712879	45747469	34590	exocyst complex component 3-like 2
PA134980508	91828	EXOC3L4	chr14	103551044	103579896	28852	exocyst complex component 3-like 4
PA134944654	60412	EXOC4	chr7	132927823	133753514	825691	exocyst complex component 4
PA35619	10640	EXOC5	chr14	57666194	57745726	79532	exocyst complex component 5
PA134908462	54536	EXOC6	chr10	94580887	94822251	241364	exocyst complex component 6
PA162385463	23233	EXOC6B	chr2	72400113	73063177	663064	exocyst complex component 6B
PA134988420	23265	EXOC7	chr17	74074086	74109868	35782	exocyst complex component 7
PA134991382	149371	EXOC8	chr1	231465482	231483578	18096	exocyst complex component 8
PA27784	9941	EXOG	chr3	38527763	38586721	58958	endo/exonuclease (5'-3'), endonuclease G-like
PA134900737	51013	EXOSC1	chr10	99192666	99215808	23142	exosome component 1
PA33464	5394	EXOSC10	chr1	11123675	11169961	46286	exosome component 10
PA134876020	23404	EXOSC2	chr9	133559158	133583452	24294	exosome component 2
PA134926550	51010	EXOSC3	chr9	37776711	37795089	18378	exosome component 3
PA134867931	54512	EXOSC4	chr8	145123522	145138551	15029	exosome component 4
PA134890468	56915	EXOSC5	chr19	41889275	41913289	24014	exosome component 5
PA134932096	118460	EXOSC6	chr16	70281134	70295833	14699	exosome component 6
PA134880567	23016	EXOSC7	chr3	45007741	45057160	49419	exosome component 7
PA134922251	11340	EXOSC8	chr13	37564678	37586751	22073	exosome component 8
PA33463	5393	EXOSC9	chr4	122712445	122741176	28731	exosome component 9
PA142671900	23086	EXPH5	chr11	108373158	108474492	101334	exophilin 5
PA27924	2131	EXT1	chr8	118808602	119134058	325456	exostosin glycosyltransferase 1
PA27925	2132	EXT2	chr11	44107099	44269980	162881	exostosin glycosyltransferase 2
PA27927	2134	EXTL1	chr1	26338266	26365955	27689	exostosin-like glycosyltransferase 1
PA27928	2135	EXTL2	chr1	101334928	101371548	36620	exostosin-like glycosyltransferase 2
PA27930	2137	EXTL3	chr8	28548990	28614207	65217	exostosin-like glycosyltransferase 3
PA27931	2138	EYA1	chr8	72106668	72469888	363220	EYA transcriptional coactivator and phosphatase 1
PA27932	2139	EYA2	chr20	45513263	45820492	307229	EYA transcriptional coactivator and phosphatase 2
PA27933	2140	EYA3	chr1	28293855	28425173	131318	EYA transcriptional coactivator and phosphatase 3
PA27934	2070	EYA4	chr6	133551512	133856258	304746	EYA transcriptional coactivator and phosphatase 4
PA164719488	346007	EYS	chr6	64426876	66427118	2000242	eyes shut homolog (Drosophila)
PA27938	2145	EZH1	chr17	40849293	40907095	57802	enhancer of zeste 1 polycomb repressive complex 2 subunit
PA27939	2146	EZH2	chr7	148501464	148591441	89977	enhancer of zeste 2 polycomb repressive complex 2 subunit
PA162385512	7430	EZR	chr6	159183773	159250456	66683	ezrin
PA27940	2159	F10	chr13	113767113	113806843	39730	coagulation factor X
PA27941	2160	F11	chr4	187177099	187213835	36736	coagulation factor XI
PA29991	50848	F11R	chr1	160962001	161001133	39132	F11 receptor
PA161	2161	F12	chr5	176826139	176846577	20438	coagulation factor XII (Hageman factor)
PA162	2162	F13A1	chr6	6141311	6330924	189613	coagulation factor XIII, A1 polypeptide
PA27944	2165	F13B	chr1	197004877	197046568	41691	coagulation factor XIII, B polypeptide
PA157	2147	F2	chr11	46730743	46764056	33313	coagulation factor II (thrombin)
PA27946	2149	F2R	chr5	76001868	76034595	32727	coagulation factor II (thrombin) receptor
PA27947	2150	F2RL1	chr5	76104833	76134140	29307	coagulation factor II (thrombin) receptor-like 1
PA27948	2151	F2RL2	chr5	75908307	75929259	20952	coagulation factor II (thrombin) receptor-like 2
PA27949	9002	F2RL3	chr19	16989826	17005830	16004	coagulation factor II (thrombin) receptor-like 3
PA158	2152	F3	chr1	94991732	95017413	25681	coagulation factor III (thromboplastin, tissue factor)
PA159	2153	F5	chr1	169478192	169565769	87577	coagulation factor V (proaccelerin, labile factor)
PA160	2155	F7	chr13	113750102	113777995	27893	coagulation factor VII (serum prothrombin conversion accelerator)
PA27952	2157	F8	chrX	154061063	154265351	204288	coagulation factor VIII, procoagulant component
PA27953	8263	F8A1	chrX	154104635	154119336	14701	coagulation factor VIII-associated 1
PA134939784	474383	F8A2	chrX	154601764	154615879	14115	coagulation factor VIII-associated 2
PA134947289	474384	F8A3	chrX	154684146	154698261	14115	coagulation factor VIII-associated 3
PA27954	2158	F9	chrX	138602889	138648617	45728	coagulation factor IX
PA145148065	79152	FA2H	chr16	74743853	74818729	74876	fatty acid 2-hydroxylase
PA27955	2166	FAAH	chr1	46849939	46882520	32581	fatty acid amide hydrolase
PA162385543	158584	FAAH2	chrX	57303011	57518629	215618	fatty acid amide hydrolase 2
PA27956	2168	FABP1	chr2	88419501	88437650	18149	fatty acid binding protein 1, liver
PA164719513	646486	FABP12	chr8	82434216	82456056	21840	fatty acid binding protein 12
PA27957	2169	FABP2	chr4	120235405	120253316	17911	fatty acid binding protein 2, intestinal
PA27958	2170	FABP3	chr1	31835100	31855923	20823	fatty acid binding protein 3, muscle and heart (mammary-derived growth inhibitor)
PA27960	2167	FABP4	chr8	82387732	82405473	17741	fatty acid binding protein 4, adipocyte
PA27961	2171	FABP5	chr8	82182718	82200012	17294	fatty acid binding protein 5 (psoriasis-associated)
PA27962	2172	FABP6	chr5	159604374	159668729	64355	fatty acid binding protein 6, ileal
PA27963	2173	FABP7	chr6	123090646	123108219	17573	fatty acid binding protein 7, brain
PA27964	646480	FABP9	chr8	82367618	82383758	16140	fatty acid binding protein 9, testis
PA27972	8772	FADD	chr11	70039269	70056508	17239	Fas (TNFRSF6)-associated via death domain
PA27973	3992	FADS1	chr11	61564097	61594529	30432	fatty acid desaturase 1
PA27974	9415	FADS2	chr11	61573675	61637826	64151	fatty acid desaturase 2
PA27975	3995	FADS3	chr11	61637998	61669006	31008	fatty acid desaturase 3
PA134883572	283985	FADS6	chr17	72870451	72899737	29286	fatty acid desaturase 6
PA27976	11124	FAF1	chr1	50903935	51435936	532001	Fas (TNFRSF6) associated factor 1
PA162385570	23197	FAF2	chr5	175865356	175940075	74719	Fas associated factor family member 2
PA27977	2184	FAH	chr15	80435233	80481924	46691	fumarylacetoacetate hydrolase (fumarylacetoacetase)
PA25551	81889	FAHD1	chr16	1867225	1893208	25983	fumarylacetoacetate hydrolase domain containing 1
PA134860971	51011	FAHD2A	chr2	96058439	96085357	26918	fumarylacetoacetate hydrolase domain containing 2A
PA162385597	151313	FAHD2B	chr2	97746320	97770603	24283	fumarylacetoacetate hydrolase domain containing 2B
PA38647	55179	FAIM	chr3	138317542	138355218	37676	Fas apoptotic inhibitory molecule
PA134879081	23017	FAIM2	chr12	50257679	50307760	50081	Fas apoptotic inhibitory molecule 2
PA142671899	9214	FAIM3	chr1	207073630	207105378	31748	Fas apoptotic inhibitory molecule 3
PA143485462	144347	FAM101A	chr12	124763710	124803570	39860	family with sequence similarity 101, member A
PA143485463	359845	FAM101B	chr17	286769	305731	18962	family with sequence similarity 101, member B
PA142671784	399665	FAM102A	chr9	130699861	130752812	52951	family with sequence similarity 102, member A
PA142671785	284611	FAM102B	chr1	109092653	109184949	92296	family with sequence similarity 102, member B
PA142671786	83640	FAM103A1	chr15	83644955	83662809	17854	family with sequence similarity 103, member A1
PA142671787	84923	FAM104A	chr17	71200492	71238533	38041	family with sequence similarity 104, member A
PA134945008	90736	FAM104B	chrX	55166535	55197628	31093	family with sequence similarity 104, member B
PA142671788	54491	FAM105A	chr5	14571891	14619289	47398	family with sequence similarity 105, member A
PA143485464	11170	FAM107A	chr3	58546841	58623337	76496	family with sequence similarity 107, member A
PA134902915	83641	FAM107B	chr10	14557556	14826896	269340	family with sequence similarity 107, member B
PA143485466	144717	FAM109A	chr12	111795455	111816925	21470	family with sequence similarity 109, member A
PA143485467	150368	FAM109B	chr22	42460255	42478445	18190	family with sequence similarity 109, member B
PA162385650	83541	FAM110A	chr20	804354	829922	25568	family with sequence similarity 110, member A
PA162385659	90362	FAM110B	chr8	58897068	59065277	168209	family with sequence similarity 110, member B
PA162385674	642273	FAM110C	chr2	35814	57042	21228	family with sequence similarity 110, member C
PA142671706	79927	FAM110D	chr1	26475511	26492119	16608	family with sequence similarity 110, member D
PA143485468	63901	FAM111A	chr11	58900219	58925512	25293	family with sequence similarity 111, member A
PA143485469	374393	FAM111B	chr11	58864658	58897888	33230	family with sequence similarity 111, member B
PA162385681	92689	FAM114A1	chr4	38859354	38950365	91011	family with sequence similarity 114, member A1
PA162385716	10827	FAM114A2	chr5	153366723	153428497	61774	family with sequence similarity 114, member A2
PA162385749	9747	FAM115A	chr7	143545461	143609278	63817	family with sequence similarity 115, member A
PA162385772	285966	FAM115C	chr7	143308045	143430173	122128	family with sequence similarity 115, member C
PA145008393	81558	FAM117A	chr17	47784687	47851518	66831	family with sequence similarity 117, member A
PA164719514	150864	FAM117B	chr2	203489901	203637480	147579	family with sequence similarity 117, member B
PA25890	55007	FAM118A	chr22	45695081	45740836	45755	family with sequence similarity 118, member A
PA145008413	79607	FAM118B	chr11	126071619	126135879	64260	family with sequence similarity 118, member B
PA134954136	23196	FAM120A	chr9	96204173	96331397	127224	family with sequence similarity 120A
PA134893278	158293	FAM120AOS	chr9	96205776	96225874	20098	family with sequence similarity 120A opposite strand
PA134920525	84498	FAM120B	chr6	170605812	170719155	113343	family with sequence similarity 120B
PA134932227	54954	FAM120C	chrX	54091757	54219714	127957	family with sequence similarity 120C
PA134861471	116224	FAM122A	chr9	71384964	71401609	16645	family with sequence similarity 122A
PA128394763	159090	FAM122B	chrX	133900596	133941262	40666	family with sequence similarity 122B
PA145148896	159091	FAM122C	chrX	133920443	133992149	71706	family with sequence similarity 122C
PA162385800	220108	FAM124A	chr13	51786470	51861377	74907	family with sequence similarity 124A
PA162385815	79843	FAM124B	chr2	225240415	225276711	36296	family with sequence similarity 124B
PA162385852	84668	FAM126A	chr7	22977878	23063814	85936	family with sequence similarity 126, member A
PA162385879	285172	FAM126B	chr2	201835441	201946392	110951	family with sequence similarity 126, member B
PA162385908	8933	FAM127A	chrX	134156333	134170576	14243	family with sequence similarity 127, member A
PA162385915	26071	FAM127B	chrX	134181962	134196221	14259	family with sequence similarity 127, member B
PA162385922	441518	FAM127C	chrX	134151534	134166924	15390	family with sequence similarity 127, member C
PA162385951	116496	FAM129A	chr1	184757159	184953718	196559	family with sequence similarity 129, member A
PA162385984	64855	FAM129B	chr9	130264618	130351268	86650	family with sequence similarity 129, member B
PA162386017	199786	FAM129C	chr19	17624110	17667648	43538	family with sequence similarity 129, member C
PA162386054	131408	FAM131A	chr3	184043717	184067063	23346	family with sequence similarity 131, member A
PA162386065	9715	FAM131B	chr7	143047493	143089397	41904	family with sequence similarity 131, member B
PA162386082	348487	FAM131C	chr1	16381264	16410127	28863	family with sequence similarity 131, member C
PA162386101	388581	FAM132A	chr1	1174826	1192102	17276	family with sequence similarity 132, member A
PA162386125	286499	FAM133A	chrX	92919012	92970273	51261	family with sequence similarity 133, member A
PA162386138	257415	FAM133B	chr7	92187072	92229706	42634	family with sequence similarity 133, member B
PA162386165	79137	FAM134A	chr2	220032939	220053197	20258	family with sequence similarity 134, member A
PA162386188	54463	FAM134B	chr5	16469922	16627167	157245	family with sequence similarity 134, member B
PA162386207	162427	FAM134C	chr17	40728526	40771445	42919	family with sequence similarity 134, member C
PA162386230	57579	FAM135A	chr6	71113107	71273877	160770	family with sequence similarity 135, member A
PA162386277	51059	FAM135B	chr8	139139266	139519065	379799	family with sequence similarity 135, member B
PA162386322	84908	FAM136A	chr2	70520108	70539293	19185	family with sequence similarity 136, member A
PA164719541	10144	FAM13A	chr4	89644105	90042549	398444	family with sequence similarity 13, member A
PA25916	51306	FAM13B	chr5	137270638	137397650	127012	family with sequence similarity 13, member B
PA164719657	220965	FAM13C	chr10	61002889	61132661	129772	family with sequence similarity 13, member C
PA162386366	25854	FAM149A	chr4	187016054	187096817	80763	family with sequence similarity 149, member A
PA162386399	317662	FAM149B1	chr10	74917877	75005435	87558	family with sequence similarity 149, member B1
PA162386433	389658	FAM150A	chr8	53443597	53488021	44424	family with sequence similarity 150, member A
PA162386448	285016	FAM150B	chr2	276561	299002	22441	family with sequence similarity 150, member B
PA162386465	338094	FAM151A	chr1	55071850	55099200	27350	family with sequence similarity 151, member A
PA162386486	167555	FAM151B	chr5	79773800	79841382	67582	family with sequence similarity 151, member B
PA162386535	285596	FAM153A	chr5	177147365	177217505	70140	family with sequence similarity 153, member A
PA162386580	202134	FAM153B	chr5	175480712	175544801	64089	family with sequence similarity 153, member B
PA162386629	653316	FAM153C	chr5	177423967	177479088	55121	family with sequence similarity 153, member C
PA162386652	158297	FAM154A	chr9	18924891	19043256	118365	family with sequence similarity 154, member A
PA162386665	283726	FAM154B	chr15	82545152	82580271	35119	family with sequence similarity 154, member B
PA162386676	728215	FAM155A	chr13	107817879	108529460	711581	family with sequence similarity 155, member A
PA162386687	27112	FAM155B	chrX	68715078	68755351	40273	family with sequence similarity 155, member B
PA162386698	29057	FAM156A	chrX	52973462	53034651	61189	family with sequence similarity 156, member A
PA162386699	727866	FAM156B	chrX	52910629	52940587	29958	family with sequence similarity 156, member B
PA164719690	728262	FAM157A	chr3	197869039	197910728	41689	family with sequence similarity 157, member A
PA164719708	100132403	FAM157B	chr9	141096439	141155460	59021	family with sequence similarity 157, member B
PA164719726	100132055	FAM157C	chr16	90157798	90188220	30422	family with sequence similarity 157, member C
PA162386717	348378	FAM159A	chr1	53088961	53136252	47291	family with sequence similarity 159, member A
PA162386728	100132916	FAM159B	chr5	63976135	64017017	40882	family with sequence similarity 159, member B
PA162386739	729830	FAM160A1	chr4	152320398	152594655	274257	family with sequence similarity 160, member A1
PA162386769	84067	FAM160A2	chr11	6229564	6265941	36377	family with sequence similarity 160, member A2
PA162386798	57700	FAM160B1	chr10	116571503	116662586	91083	family with sequence similarity 160, member B1
PA162386837	64760	FAM160B2	chr8	21936695	21965405	28710	family with sequence similarity 160, member B2
PA162386876	84140	FAM161A	chr2	62048983	62091278	42295	family with sequence similarity 161, member A
PA162386893	145483	FAM161B	chr14	74396695	74427117	30422	family with sequence similarity 161, member B
PA162386916	26355	FAM162A	chr3	122093023	122131961	38938	family with sequence similarity 162, member A
PA162386931	221303	FAM162B	chr6	117070360	117096886	26526	family with sequence similarity 162, member B
PA162386944	148753	FAM163A	chr1	179686912	179788333	101421	family with sequence similarity 163, member A
PA162386945	642968	FAM163B	chr9	136439141	136484472	45331	family with sequence similarity 163, member B
PA162387021	401565	FAM166A	chr9	140135037	140152222	17185	family with sequence similarity 166, member A
PA162387040	730112	FAM166B	chr9	35558827	35573896	15069	family with sequence similarity 166, member B
PA162387057	83648	FAM167A	chr8	11275972	11334276	58304	family with sequence similarity 167, member A
PA162387068	84734	FAM167B	chr1	32702818	32717461	14643	family with sequence similarity 167, member B
PA162387077	23201	FAM168A	chr11	73108837	73319234	210397	family with sequence similarity 168, member A
PA162387098	130074	FAM168B	chr2	131802449	131861033	58584	family with sequence similarity 168, member B
PA162387117	26049	FAM169A	chr5	74070399	74173832	103433	family with sequence similarity 169, member A
PA162387148	283777	FAM169B	chr15	98977391	99067611	90220	family with sequence similarity 169, member B
PA162387167	340069	FAM170A	chr5	118955254	118974517	19263	family with sequence similarity 170, member A
PA162387168	170370	FAM170B	chr10	50336199	50352065	15866	family with sequence similarity 170, member B
PA162387176	221061	FAM171A1	chr10	15250642	15423058	172416	family with sequence similarity 171, member A1
PA162387197	284069	FAM171A2	chr17	42428101	42451235	23134	family with sequence similarity 171, member A2
PA162387220	165215	FAM171B	chr2	187548789	187633686	84897	family with sequence similarity 171, member B
PA162387241	83989	FAM172A	chr5	92950431	93457404	506973	family with sequence similarity 172, member A
PA162387266	65990	FAM173A	chr16	760581	775655	15074	family with sequence similarity 173, member A
PA162387281	134145	FAM173B	chr5	10222619	10260145	37526	family with sequence similarity 173, member B
PA162387296	345757	FAM174A	chr5	99861051	99925440	64389	family with sequence similarity 174, member A
PA162387297	400451	FAM174B	chr15	93157678	93209031	51353	family with sequence similarity 174, member B
PA162387308	84142	FAM175A	chr4	84379092	84416290	37198	family with sequence similarity 175, member A
PA162387331	23172	FAM175B	chr10	126480354	126528239	47885	family with sequence similarity 175, member B
PA162387378	283635	FAM177A1	chr14	35504113	35555589	51476	family with sequence similarity 177, member A1
PA162387394	400823	FAM177B	chr1	222900558	222929932	29374	family with sequence similarity 177, member B
PA162387411	55719	FAM178A	chr10	102662326	102727891	65565	family with sequence similarity 178, member A
PA162387456	51252	FAM178B	chr2	97538619	97662337	123718	family with sequence similarity 178, member B
PA162387471	165186	FAM179A	chr2	29194164	29278096	83932	family with sequence similarity 179, member A
PA162387516	23116	FAM179B	chr14	45421416	45546634	125218	family with sequence similarity 179, member B
PA162387559	389558	FAM180A	chr7	135410096	135443616	33520	family with sequence similarity 180, member A
PA162387572	399888	FAM180B	chr11	47598230	47613746	15516	family with sequence similarity 180, member B
PA162387582	90050	FAM181A	chr14	94375240	94398954	23714	family with sequence similarity 181, member A
PA162387593	220382	FAM181B	chr11	82440046	82454906	14860	family with sequence similarity 181, member B
PA164719746	440585	FAM183A	chr1	43600800	43625067	24267	family with sequence similarity 183, member A
PA164719768	79632	FAM184A	chr6	119277992	119480552	202560	family with sequence similarity 184, member A
PA164719809	27146	FAM184B	chr4	17630696	17793135	162439	family with sequence similarity 184, member B
PA164719851	222234	FAM185A	chr7	102379399	102452672	73273	family with sequence similarity 185, member A
PA164719869	121006	FAM186A	chr12	50718095	50800405	82310	family with sequence similarity 186, member A
PA164719890	84070	FAM186B	chr12	49973658	50009433	35775	family with sequence similarity 186, member B
PA164719909	100528020	FAM187A	chr17	-1	-1	0	family with sequence similarity 187, member A
PA164719910	148109	FAM187B	chr19	35712704	35729628	16924	family with sequence similarity 187, member B
PA165548562	80013	FAM188A	chr10	15817173	15912519	95346	family with sequence similarity 188, member A
PA165618038	84182	FAM188B	chr7	30801033	30935408	134375	family with sequence similarity 188, member B
PA165478574	23359	FAM189A1	chr15	29409455	29872927	463472	family with sequence similarity 189, member A1
PA165585777	9413	FAM189A2	chr9	71929287	72010372	81085	family with sequence similarity 189, member A2
PA25608	10712	FAM189B	chr1	155213996	155235274	21278	family with sequence similarity 189, member B
PA165450001	80011	FAM192A	chr16	57183378	57230387	47009	family with sequence similarity 192, member A
PA165663979	8603	FAM193A	chr4	2617159	2737302	120143	family with sequence similarity 193, member A
PA165660336	54540	FAM193B	chr5	176943790	176991548	47758	family with sequence similarity 193, member B
PA25527	84331	FAM195A	chr16	681849	701474	19625	family with sequence similarity 195, member A
PA165431912	348262	FAM195B	chr17	79777293	79801167	23874	family with sequence similarity 195, member B
PA165548646	642938	FAM196A	chr10	128930690	129004436	73746	family with sequence similarity 196, member A
PA165660363	100131897	FAM196B	chr5	169287719	169417744	130025	family with sequence similarity 196, member B
PA165697369	729085	FAM198A	chr3	43010759	43102207	91448	family with sequence similarity 198, member A
PA165664058	51313	FAM198B	chr4	159042732	159104202	61470	family with sequence similarity 198, member B
PA165756587	139231	FAM199X	chrX	103401156	103443583	42427	family with sequence similarity 199, X-linked
PA134907870	407738	FAM19A1	chr3	68030734	68597772	567038	family with sequence similarity 19 (chemokine (C-C motif)-like), member A1
PA134974674	338811	FAM19A2	chr12	62099029	62596620	497591	family with sequence similarity 19 (chemokine (C-C motif)-like), member A2
PA134899352	284467	FAM19A3	chr1	113251619	113272857	21238	family with sequence similarity 19 (chemokine (C-C motif)-like), member A3
PA134873006	151647	FAM19A4	chr3	68777915	68991761	213846	family with sequence similarity 19 (chemokine (C-C motif)-like), member A4
PA134887312	25817	FAM19A5	chr22	48875288	49150744	275456	family with sequence similarity 19 (chemokine (C-C motif)-like), member A5
PA165618089	221786	FAM200A	chr7	99140923	99166115	25192	family with sequence similarity 200, member A
PA165664101	285550	FAM200B	chr4	15673352	15695070	21718	family with sequence similarity 200, member B
PA165585805	158228	FAM201A	chr9	38611085	38626281	15196	family with sequence similarity 201, member A
PA142672349	728071	FAM203B	chr8	145427886	145443833	15947	family with sequence similarity 203, member B
PA134910767	63877	FAM204A	chr10	120062401	120111839	49438	family with sequence similarity 204, member A
PA25981	54942	FAM206A	chr9	111686673	111706238	19565	family with sequence similarity 206, member A
PA25865	85395	FAM207A	chr21	46349918	46399891	49973	family with sequence similarity 207, member A
PA134957890	54906	FAM208B	chr10	5716801	5810742	93941	family with sequence similarity 208, member B
PA134974173	200232	FAM209A	chr20	55089785	55104208	14423	family with sequence similarity 209, member A
PA25646	388799	FAM209B	chr20	55095960	55114576	18616	family with sequence similarity 209, member B
PA134888583	54757	FAM20A	chr17	66528257	66607095	78838	family with sequence similarity 20, member A
PA134930918	9917	FAM20B	chr1	178984939	179048702	63763	family with sequence similarity 20, member B
PA134898453	56975	FAM20C	chr7	182969	303740	120771	family with sequence similarity 20, member C
PA134993051	125228	FAM210A	chr18	13660346	13736591	76245	family with sequence similarity 210, member A
PA25647	116151	FAM210B	chr20	54923983	54946719	22736	family with sequence similarity 210, member B
PA143485330	389119	FAM212A	chr3	49830687	49845463	14776	family with sequence similarity 212, member A
PA142672431	55924	FAM212B	chr1	112261686	112308419	46733	family with sequence similarity 212, member B
PA134969403	84293	FAM213A	chr10	82157585	82195753	38168	family with sequence similarity 213, member A
PA142672477	127281	FAM213B	chr1	2507899	2525908	18009	family with sequence similarity 213, member B
PA142671609	56204	FAM214A	chr15	52870518	52981569	111051	family with sequence similarity 214, member A
PA134880815	80256	FAM214B	chr9	35101118	35126338	25220	family with sequence similarity 214, member B
PA128395781	29902	FAM216A	chr12	110896232	110931192	34960	family with sequence similarity 216, member A
PA147358510	144809	FAM216B	chr13	43345686	43368685	22999	family with sequence similarity 216, member B
PA134935759	222826	FAM217A	chr6	4065593	4089457	23864	family with sequence similarity 217, member A
PA25720	63939	FAM217B	chr20	58498819	58526735	27916	family with sequence similarity 217, member B
PA162379827	152756	FAM218A	chr4	165868100	165883273	15173	family with sequence similarity 218, member A
PA134916501	203259	FAM219A	chr9	34395182	34468568	73386	family with sequence similarity 219, member A
PA134953632	57184	FAM219B	chr15	75189328	75209462	20134	family with sequence similarity 219, member B
PA134902481	387680	FAM21A	chr10	51817610	51896269	78659	family with sequence similarity 21, member A
PA134877872	55747	FAM21B	chr10	47884023	47952417	68394	family with sequence similarity 21, member B
PA128394768	253725	FAM21C	chr10	46212648	46291412	78764	family with sequence similarity 21, member C
PA134905390	653450	FAM21D	chr10	51177942	51195032	17090	family with sequence similarity 21, member D
PA165617654	84792	FAM220A	chr7	6366040	6398590	32550	family with sequence similarity 220, member A
PA162380501	340277	FAM221A	chr7	23709231	23745269	36038	family with sequence similarity 221, member A
PA134925958	392307	FAM221B	chr9	35814014	35843372	29358	family with sequence similarity 221, member B
PA143485364	84915	FAM222A	chr12	110142187	110211312	69125	family with sequence similarity 222, member A
PA142672246	55731	FAM222B	chr17	27079996	27179857	99861	family with sequence similarity 222, member B
PA165757293	203429	FAM226A	chrX	72158568	72173589	15021	family with sequence similarity 226, member A (non-protein coding)
PA165757326	653687	FAM226B	chrX	71986897	72001919	15022	family with sequence similarity 226, member B (non-protein coding)
PA142672269	196951	FAM227B	chr15	49615822	49923128	307306	family with sequence similarity 227, member B
PA164717160	653140	FAM228A	chr2	24387471	24426718	39247	family with sequence similarity 228, member A
PA162380460	619208	FAM229B	chr6	112398674	112426993	28319	family with sequence similarity 229, member B
PA134873054	100289299	FAM23B	chr10	18031225	18092856	61631	family with sequence similarity 23, member B
PA134930660	118670	FAM24A	chr10	124660217	124675627	15410	family with sequence similarity 24, member A
PA134880209	196792	FAM24B	chr10	124605610	124649157	43547	family with sequence similarity 24, member B
PA134895337	643161	FAM25A	chr10	88770046	88787487	17441	family with sequence similarity 25, member A
PA134928795	100132929	FAM25B	chr10	47174207	47191688	17481	family with sequence similarity 25, member B
PA134868713	644054	FAM25C	chr10	49200372	49217825	17453	family with sequence similarity 25, member C
PA134878442	643479	FAM25E	chr10	46307877	46322767	14890	family with sequence similarity 25, member E
PA134883769	100133093	FAM25G	chr10	48237662	48255126	17464	family with sequence similarity 25, member G
PA162387625	221301	FAM26D	chr6	116840176	116883031	42855	family with sequence similarity 26, member D
PA162387635	254228	FAM26E	chr6	116822808	116842709	19901	family with sequence similarity 26, member E
PA162387644	441168	FAM26F	chr6	116772533	116787948	15415	family with sequence similarity 26, member F
PA145148939	100131997	FAM27E3	chr9	67781944	67796625	14681	family with sequence similarity 27, member E3
PA134956082	26017	FAM32A	chr19	16286235	16305857	19622	family with sequence similarity 32, member A
PA134926879	54537	FAM35A	chr10	88844953	88954225	109272	family with sequence similarity 35, member A
PA38366	60343	FAM3A	chrX	153730323	153754572	24249	family with sequence similarity 3, member A
PA27979	54097	FAM3B	chr21	42678661	42732654	53993	family with sequence similarity 3, member B
PA38627	10447	FAM3C	chr7	120985905	121046422	60517	family with sequence similarity 3, member C
PA38628	131177	FAM3D	chr3	58616670	58662575	45905	family with sequence similarity 3, member D
PA134950686	131583	FAM43A	chr3	194396622	194412766	16144	family with sequence similarity 43, member A
PA134976508	163933	FAM43B	chr1	20868932	20884513	15581	family with sequence similarity 43, member B
PA134935316	404636	FAM45A	chr10	120853594	120900496	46902	family with sequence similarity 45, member A
PA38531	55603	FAM46A	chr6	82363829	82472607	108778	family with sequence similarity 46, member A
PA134962922	115572	FAM46B	chr1	27328511	27349333	20822	family with sequence similarity 46, member B
PA134955264	54855	FAM46C	chr1	118138604	118174011	35407	family with sequence similarity 46, member C
PA134947605	169966	FAM46D	chrX	79581003	79703810	122807	family with sequence similarity 46, member D
PA134944222	158724	FAM47A	chrX	34144869	34160447	15578	family with sequence similarity 47, member A
PA134969396	170062	FAM47B	chrX	34950913	34966034	15121	family with sequence similarity 47, member B
PA145148924	442444	FAM47C	chrX	37016432	37032739	16307	family with sequence similarity 47, member C
PA162387656	100129583	FAM47E	chr4	77125193	77207936	82743	family with sequence similarity 47, member E
PA128394730	81553	FAM49A	chr2	16727727	16857134	129407	family with sequence similarity 49, member A
PA134990565	51571	FAM49B	chr8	130848839	131038897	190058	family with sequence similarity 49, member B
PA134984709	9130	FAM50A	chrX	153662473	153682002	19529	family with sequence similarity 50, member A
PA134912073	26240	FAM50B	chr6	3839632	3854551	14919	family with sequence similarity 50, member B
PA142671887	152877	FAM53A	chr4	1638608	1695988	57380	family with sequence similarity 53, member A
PA134957918	9679	FAM53B	chr10	126304861	126442930	138069	family with sequence similarity 53, member B
PA25917	51307	FAM53C	chr5	137663224	137688418	25194	family with sequence similarity 53, member C
PA142671861	79850	FAM57A	chr17	625847	649075	23228	family with sequence similarity 57, member A
PA142671862	83723	FAM57B	chr16	30032748	30074338	41590	family with sequence similarity 57, member B
PA142671863	92002	FAM58A	chrX	152850383	152874632	24249	family with sequence similarity 58, member A
PA134921007	58516	FAM60A	chr12	31430356	31489159	58803	family with sequence similarity 60, member A
PA142671872	55793	FAM63A	chr1	150966213	150990854	24641	family with sequence similarity 63, member A
PA142671873	54629	FAM63B	chr15	59053393	59152754	99361	family with sequence similarity 63, member B
PA142671874	54478	FAM64A	chr17	6337735	6357385	19650	family with sequence similarity 64, member A
PA142671875	79567	FAM65A	chr16	67552717	67583691	30974	family with sequence similarity 65, member A
PA162387677	9750	FAM65B	chr6	24801512	24946275	144763	family with sequence similarity 65, member B
PA162387710	140876	FAM65C	chr20	49199645	49318277	118632	family with sequence similarity 65, member C
PA142671883	388650	FAM69A	chr1	93295286	93437079	141793	family with sequence similarity 69, member A
PA142671884	138311	FAM69B	chr9	139597024	139622170	25146	family with sequence similarity 69, member B
PA165428999	125704	FAM69C	chr18	72099963	72135070	35107	family with sequence similarity 69, member C
PA142671831	149647	FAM71A	chr1	212787789	212803120	15331	family with sequence similarity 71, member A
PA142671832	153745	FAM71B	chr5	156586343	156603279	16936	family with sequence similarity 71, member B
PA143485460	196472	FAM71C	chr12	100031528	100046892	15364	family with sequence similarity 71, member C
PA162387759	161142	FAM71D	chr14	67646110	67698493	52383	family with sequence similarity 71, member D
PA162387782	112703	FAM71E1	chr19	50967045	50990085	23040	family with sequence similarity 71, member E1
PA164719912	284418	FAM71E2	chr19	55863276	55884620	21344	family with sequence similarity 71, member E2
PA162387797	84691	FAM71F1	chr7	128339115	128374797	35682	family with sequence similarity 71, member F1
PA162387816	346653	FAM71F2	chr7	128301743	128331949	30206	family with sequence similarity 71, member F2
PA142671833	729533	FAM72A	chr1	206128911	206158074	29163	family with sequence similarity 72, member A
PA142671834	653820	FAM72B	chr1	120828959	120858681	29722	family with sequence similarity 72, member B
PA162387831	728833	FAM72D	chr1	143893452	143923143	29691	family with sequence similarity 72, member D
PA142671836	374986	FAM73A	chr1	78235309	78348225	112916	family with sequence similarity 73, member A
PA134896424	84895	FAM73B	chr9	131788899	131837361	48462	family with sequence similarity 73, member B
PA142671837	199870	FAM76A	chr1	28042490	28092426	49936	family with sequence similarity 76, member A
PA142671838	143684	FAM76B	chr11	95499106	95532954	33848	family with sequence similarity 76, member B
PA134970135	286336	FAM78A	chr9	134130465	134161906	31441	family with sequence similarity 78, member A
PA142671841	149297	FAM78B	chr1	166023663	166145992	122329	family with sequence similarity 78, member B
PA142671846	145773	FAM81A	chr15	59720372	59818751	98379	family with sequence similarity 81, member A
PA142671847	153643	FAM81B	chr5	94717048	94789145	72097	family with sequence similarity 81, member B
PA142671851	84985	FAM83A	chr8	124184752	124225318	40566	family with sequence similarity 83, member A
PA134987811	222584	FAM83B	chr6	54701569	54812897	111328	family with sequence similarity 83, member B
PA25669	128876	FAM83C	chr20	33870534	33890225	19691	family with sequence similarity 83, member C
PA25670	81610	FAM83D	chr20	37544955	37584703	39748	family with sequence similarity 83, member D
PA142671852	54854	FAM83E	chr19	49100857	49128098	27241	family with sequence similarity 83, member E
PA142671853	113828	FAM83F	chr22	40380953	40429043	48090	family with sequence similarity 83, member F
PA144596433	644815	FAM83G	chr17	18871381	18918060	46679	family with sequence similarity 83, member G
PA144596434	286077	FAM83H	chr8	144803103	144832710	29607	family with sequence similarity 83, member H
PA142671854	151354	FAM84A	chr2	14762810	14783170	20360	family with sequence similarity 84, member A
PA142671855	157638	FAM84B	chr8	127561683	127580717	19034	family with sequence similarity 84, member B
PA142671859	85002	FAM86B1	chr8	12036613	12061624	25011	family with sequence similarity 86, member B1
PA142671860	653333	FAM86B2	chr8	12280064	12303909	23845	family with sequence similarity 86, member B2
PA143485461	55199	FAM86C1	chr11	71488557	71515280	26723	family with sequence similarity 86, member C1
PA145008455	692099	FAM86DP	chr3	75467703	75494266	26563	family with sequence similarity 86, member D, pseudogene
PA142671794	375061	FAM89A	chr1	231151704	231185995	34291	family with sequence similarity 89, member A
PA142671795	23625	FAM89B	chr11	65329820	65344669	14849	family with sequence similarity 89, member B
PA27986	51439	FAM8A1	chr6	17590518	17614950	24432	family with sequence similarity 8, member A1
PA142671796	55138	FAM90A1	chr12	8370856	8390214	19358	family with sequence similarity 90, member A1
PA142671805	441328	FAM90A10P	chr8	7617106	7631835	14729	family with sequence similarity 90, member A10, pseudogene
PA142671806	441331	FAM90A11P	chr8	7866312	7882873	16561	family with sequence similarity 90, member A11, pseudogene
PA142671807	645879	FAM90A12P	chr8	7882158	7898168	16010	family with sequence similarity 90, member A12, pseudogene
PA142671808	441314	FAM90A13P	chr8	7127292	7143302	16010	family with sequence similarity 90, member A13, pseudogene
PA142671809	645651	FAM90A14P	chr8	7562965	7578975	16010	family with sequence similarity 90, member A14, pseudogene
PA142671810	389630	FAM90A15P	chr8	7104426	7120436	16010	family with sequence similarity 90, member A15, pseudogene
PA142671813	441326	FAM90A18P	chr8	7570613	7586623	16010	family with sequence similarity 90, member A18, pseudogene
PA142671814	728753	FAM90A19P	chr8	7601204	7617214	16010	family with sequence similarity 90, member A19, pseudogene
PA142671815	728430	FAM90A20P	chr8	7142536	7158546	16010	family with sequence similarity 90, member A20, pseudogene
PA142671798	389611	FAM90A3P	chr8	7112048	7128058	16010	family with sequence similarity 90, member A3, pseudogene
PA142671799	441313	FAM90A4P	chr8	7119670	7135680	16010	family with sequence similarity 90, member A4, pseudogene
PA142671800	441315	FAM90A5P	chr8	7134914	7150924	16010	family with sequence similarity 90, member A5, pseudogene
PA142671802	441317	FAM90A7P	chr8	7410660	7426626	15966	family with sequence similarity 90, member A7, pseudogene
PA142671803	441324	FAM90A8P	chr8	7585909	7601918	16009	family with sequence similarity 90, member A8, pseudogene
PA142671804	441327	FAM90A9P	chr8	7608852	7624862	16010	family with sequence similarity 90, member A9, pseudogene
PA142671820	157769	FAM91A1	chr8	124770679	124830692	60013	family with sequence similarity 91, member A1
PA142671823	137392	FAM92A1	chr8	94702480	94744481	42001	family with sequence similarity 92, member A1
PA142671826	339145	FAM92B	chr16	85128964	85156114	27150	family with sequence similarity 92, member B
PA142671829	84191	FAM96A	chr15	64361761	64396207	34446	family with sequence similarity 96, member A
PA142671830	51647	FAM96B	chr16	66962958	66978326	15368	family with sequence similarity 96, member B
PA142671777	25940	FAM98A	chr2	33805727	33834362	28635	family with sequence similarity 98, member A
PA142671778	283742	FAM98B	chr15	38736328	38780063	43735	family with sequence similarity 98, member B
PA142671779	147965	FAM98C	chr19	38883775	38902728	18953	family with sequence similarity 98, member C
PA27992	171482	FAM9A	chrX	8755836	8779424	23588	family with sequence similarity 9, member A
PA27993	171483	FAM9B	chrX	8989271	9012168	22897	family with sequence similarity 9, member B
PA27994	171484	FAM9C	chrX	13050736	13072917	22181	family with sequence similarity 9, member C
PA165478601	22909	FAN1	chr15	31181703	31238311	56608	FANCD2/FANCI-associated nuclease 1
PA27995	2175	FANCA	chr16	89800959	89893066	92107	Fanconi anemia, complementation group A
PA27996	2187	FANCB	chrX	14858529	14901184	42655	Fanconi anemia, complementation group B
PA27997	2176	FANCC	chr9	97858336	98089991	231655	Fanconi anemia, complementation group C
PA27999	2177	FANCD2	chr3	10058113	10146614	88501	Fanconi anemia, complementation group D2
PA142672385	115795	FANCD2OS	chr3	10120004	10159975	39971	FANCD2 opposite strand
PA28000	2178	FANCE	chr6	35410116	35437918	27802	Fanconi anemia, complementation group E
PA28001	2188	FANCF	chr11	22641079	22657387	16308	Fanconi anemia, complementation group F
PA28002	2189	FANCG	chr9	35070833	35090043	19210	Fanconi anemia, complementation group G
PA162387928	55215	FANCI	chr15	89775634	89863362	87728	Fanconi anemia, complementation group I
PA134887656	55120	FANCL	chr2	58383378	58478515	95137	Fanconi anemia, complementation group L
PA134943156	57697	FANCM	chr14	45595136	45673093	77957	Fanconi anemia, complementation group M
PA134976727	92565	FANK1	chr10	127575108	127701161	126053	fibronectin type III and ankyrin repeat domains 1
PA28003	2191	FAP	chr2	163024194	163110045	85851	fibroblast activation protein, alpha
PA162388007	84188	FAR1	chr11	13680206	13756893	76687	fatty acyl CoA reductase 1
PA162388036	55711	FAR2	chr12	29291936	29491549	199613	fatty acyl CoA reductase 2
PA28004	10160	FARP1	chr13	98784893	99105023	320130	FERM, RhoGEF (ARHGEF) and pleckstrin domain protein 1 (chondrocyte-derived)
PA134873245	9855	FARP2	chr2	242285664	242437256	151592	FERM, RhoGEF and pleckstrin domain protein 2
PA134954893	10667	FARS2	chr6	5251251	5774816	523565	phenylalanyl-tRNA synthetase 2, mitochondrial
PA28005	2193	FARSA	chr19	13030284	13054558	24274	phenylalanyl-tRNA synthetase, alpha subunit
PA162388068	10056	FARSB	chr2	223433162	223530827	97665	phenylalanyl-tRNA synthetase, beta subunit
PA36613	355	FAS	chr10	90740288	90778542	38254	Fas cell surface death receptor
PA56	356	FASLG	chr1	172618185	172639013	20828	Fas ligand (TNF superfamily, member 6)
PA28006	2194	FASN	chr17	80033214	80066106	32892	fatty acid synthase
PA142671775	10922	FASTK	chr7	150770708	150787970	17262	Fas-activated serine/threonine kinase
PA145148834	79675	FASTKD1	chr2	170383259	170440431	57172	FAST kinase domains 1
PA134974924	22868	FASTKD2	chr2	207620112	207663913	43801	FAST kinase domains 2
PA145148868	79072	FASTKD3	chr5	7856272	7879150	22878	FAST kinase domains 3
PA145148886	60493	FASTKD5	chr20	3124165	3150532	26367	FAST kinase domains 5
PA164719952	2195	FAT1	chr4	187505937	187657876	151939	FAT atypical cadherin 1
PA28009	2196	FAT2	chr5	150880653	150958505	77852	FAT atypical cadherin 2
PA134962612	120114	FAT3	chr11	92037446	92632636	595190	FAT atypical cadherin 3
PA134954366	79633	FAT4	chr4	126227003	126417087	190084	FAT atypical cadherin 4
PA134875203	89885	FATE1	chrX	150874508	150894666	20158	fetal and adult testis expressed 1
PA28010	2197	FAU	chr11	64885099	64899672	14573	Finkel-Biskis-Reilly murine sarcoma virus (FBR-MuSV) ubiquitously expressed
PA134918761	84553	FAXC	chr6	99717793	99807594	89801	failed axon connections homolog (Drosophila)
PA25915	10826	FAXDC2	chr5	154193594	154240213	46619	fatty acid hydroxylase domain containing 2
PA134941499	85302	FBF1	chr17	73902925	73947119	44194	Fas (TNFRSF6) binding factor 1
PA28012	2091	FBL	chr19	40322093	40347054	24961	fibrillarin
PA142671776	54751	FBLIM1	chr1	16073107	16116089	42982	filamin binding LIM protein 1
PA28013	2192	FBLN1	chr22	45888719	46000014	111295	fibulin 1
PA28014	2199	FBLN2	chr3	13563824	13682922	119098	fibulin 2
PA28015	10516	FBLN5	chr14	92332755	92424046	91291	fibulin 5
PA162388107	129804	FBLN7	chr2	112885962	112948793	62831	fibulin 7
PA28016	2200	FBN1	chr15	48697503	48947985	250482	fibrillin 1
PA28017	2201	FBN2	chr5	127590601	127883735	293134	fibrillin 2
PA38681	84467	FBN3	chr19	8127286	8224730	97444	fibrillin 3
PA28018	2203	FBP1	chr9	97362415	97412531	50116	fructose-1,6-bisphosphatase 1
PA28019	8789	FBP2	chr9	97318002	97366075	48073	fructose-1,6-bisphosphatase 2
PA162388128	64319	FBRS	chr16	30665778	30685131	19353	fibrosin
PA164720011	57666	FBRSL1	chr12	133057041	133164774	107733	fibrosin-like 1
PA134934043	54850	FBXL12	chr19	9917943	9940101	22158	F-box and leucine-rich repeat protein 12
PA134938720	222235	FBXL13	chr7	102450308	102725288	274980	F-box and leucine-rich repeat protein 13
PA134979350	144699	FBXL14	chr12	1672159	1713331	41172	F-box and leucine-rich repeat protein 14
PA134928704	79176	FBXL15	chr10	104168979	104185894	16915	F-box and leucine-rich repeat protein 15
PA25536	146330	FBXL16	chr16	739500	765825	26325	F-box and leucine-rich repeat protein 16
PA134920563	64839	FBXL17	chr5	107191734	107728080	536346	F-box and leucine-rich repeat protein 17
PA134949446	80028	FBXL18	chr7	5512428	5563423	50995	F-box and leucine-rich repeat protein 18
PA134911396	54620	FBXL19	chr16	30924392	30963104	38712	F-box and leucine-rich repeat protein 19
PA28021	25827	FBXL2	chr3	33308934	33448505	139571	F-box and leucine-rich repeat protein 2
PA134976410	84961	FBXL20	chr17	37405897	37568530	162633	F-box and leucine-rich repeat protein 20
PA28023	26223	FBXL21	chr5	135256006	135280367	24361	F-box and leucine-rich repeat protein 21 (gene/pseudogene)
PA134959373	283807	FBXL22	chr15	63879327	63897627	18300	F-box and leucine-rich repeat protein 22
PA28022	26224	FBXL3	chr13	77576389	77611331	34942	F-box and leucine-rich repeat protein 3
PA28024	26235	FBXL4	chr6	99318601	99405882	87281	F-box and leucine-rich repeat protein 4
PA28025	26234	FBXL5	chr4	15603007	15671487	68480	F-box and leucine-rich repeat protein 5
PA28026	26233	FBXL6	chr8	145576088	145592183	16095	F-box and leucine-rich repeat protein 6
PA28027	23194	FBXL7	chr5	15490305	15942905	452600	F-box and leucine-rich repeat protein 7
PA28028	55336	FBXL8	chr16	67183891	67201077	17186	F-box and leucine-rich repeat protein 8
PA28030	26267	FBXO10	chr9	37507889	37586250	78361	F-box protein 10
PA28031	80204	FBXO11	chr2	48031059	48143524	112465	F-box protein 11
PA134894755	201456	FBXO15	chr18	71737588	71825100	87512	F-box protein 15
PA134901223	157574	FBXO16	chr8	28282925	28357835	74910	F-box protein 16
PA38676	115290	FBXO17	chr19	39429041	39476453	47412	F-box protein 17
PA134948258	84893	FBXO18	chr10	5921535	5982558	61023	F-box protein, helicase, 18
PA31895	26232	FBXO2	chr1	11704924	11724888	19964	F-box protein 2
PA28034	23014	FBXO21	chr12	117578278	117638305	60027	F-box protein 21
PA28035	26263	FBXO22	chr15	76186200	76230609	44409	F-box protein 22
PA28037	26261	FBXO24	chr7	100173840	100201740	27900	F-box protein 24
PA28038	26260	FBXO25	chr8	346808	422876	76068	F-box protein 25
PA38675	126433	FBXO27	chr19	39511661	39533198	21537	F-box protein 27
PA134876528	23219	FBXO28	chr1	224291789	224352749	60960	F-box protein 28
PA28040	26273	FBXO3	chr11	33759490	33806071	46581	F-box protein 3
PA28041	84085	FBXO30	chr6	146116271	146145929	29658	F-box protein 30
PA28042	79791	FBXO31	chr16	87359942	87435708	75766	F-box protein 31
PA28043	114907	FBXO32	chr8	124507127	124563493	56366	F-box protein 32
PA134861757	254170	FBXO33	chr14	39862577	39911704	49127	F-box protein 33
PA134910884	55030	FBXO34	chr14	55728021	55823329	95308	F-box protein 34
PA134918778	130888	FBXO36	chr2	230777023	230880825	103802	F-box protein 36
PA134929999	81545	FBXO38	chr5	147753498	147825399	71901	F-box protein 38
PA134889729	162517	FBXO39	chr17	6669523	6703420	33897	F-box protein 39
PA28044	26272	FBXO4	chr5	41915352	41944672	29320	F-box protein 4
PA134971542	51725	FBXO40	chr3	121302170	121352139	49969	F-box protein 40
PA134946052	150726	FBXO41	chr2	73478810	73506758	27948	F-box protein 41
PA134951560	54455	FBXO42	chr1	16570339	16688965	118626	F-box protein 42
PA134913061	286151	FBXO43	chr8	101142588	101168099	25511	F-box protein 43
PA134863106	93611	FBXO44	chr1	11704432	11726384	21952	F-box protein 44
PA134904114	200933	FBXO45	chr3	196285725	196318930	33205	F-box protein 45
PA134985344	23403	FBXO46	chr19	46210887	46244151	33264	F-box protein 46
PA162388157	494188	FBXO47	chr17	37089685	37133655	43970	F-box protein 47
PA162388158	554251	FBXO48	chr2	68686498	68704448	17950	F-box protein 48
PA28045	26271	FBXO5	chr6	153288658	153314740	26082	F-box protein 5
PA28046	26270	FBXO6	chr1	11714150	11737411	23261	F-box protein 6
PA28047	25793	FBXO7	chr22	32860707	32897818	37111	F-box protein 7
PA28048	26269	FBXO8	chr4	175154809	175215415	60606	F-box protein 8
PA28049	26268	FBXO9	chr6	52912586	52968671	56085	F-box protein 9
PA25575	10517	FBXW10	chr17	18637326	18685662	48336	F-box and WD repeat domain containing 10
PA28050	23291	FBXW11	chr5	171285553	171443877	158324	F-box and WD repeat domain containing 11
PA134980842	285231	FBXW12	chr3	48403709	48439190	35481	F-box and WD repeat domain containing 12
PA28052	26190	FBXW2	chr9	123516254	123565740	49486	F-box and WD repeat domain containing 2
PA35751	6468	FBXW4	chr10	103367421	103465345	97924	F-box and WD repeat domain containing 4
PA134928070	54461	FBXW5	chr9	139831885	139849298	17413	F-box and WD repeat domain containing 5
PA28054	55294	FBXW7	chr4	153239410	153466393	226983	F-box and WD repeat domain containing 7, E3 ubiquitin protein ligase
PA28039	26259	FBXW8	chr12	117338756	117471953	133197	F-box and WD repeat domain containing 8
PA134910095	84261	FBXW9	chr19	12796730	12817649	20919	F-box and WD repeat domain containing 9
PA142671773	83953	FCAMR	chr1	207128312	207153970	25658	Fc receptor, IgA, IgM, high affinity
PA28055	2204	FCAR	chr19	55375549	55404839	29290	Fc fragment of IgA, receptor for
PA28056	2205	FCER1A	chr1	159243678	159281014	37336	Fc fragment of IgE, high affinity I, receptor for; alpha polypeptide
PA28057	2207	FCER1G	chr1	161175087	161192038	16951	Fc fragment of IgE, high affinity I, receptor for; gamma polypeptide
PA28058	2208	FCER2	chr19	7750643	7777036	26393	Fc fragment of IgE, low affinity II, receptor for (CD23)
PA162388159	51077	FCF1	chr14	75169817	75208323	38506	FCF1 rRNA-processing protein
PA28059	8857	FCGBP	chr19	40350963	40450910	99947	Fc fragment of IgG binding protein
PA28060	2209	FCGR1A	chr1	149744232	149767074	22842	Fc fragment of IgG, high affinity Ia, receptor (CD64)
PA28061	2210	FCGR1B	chr1	120923128	120945944	22816	Fc fragment of IgG, high affinity Ib, receptor (CD64)
PA28063	2212	FCGR2A	chr1	161465205	161492360	27155	Fc fragment of IgG, low affinity IIa, receptor (CD32)
PA28064	2213	FCGR2B	chr1	161622905	161651444	28539	Fc fragment of IgG, low affinity IIb, receptor (CD32)
PA142671774	9103	FCGR2C	chr1	161541129	161574010	32881	Fc fragment of IgG, low affinity IIc, receptor for (CD32) (gene/pseudogene)
PA28065	2214	FCGR3A	chr1	161508549	161530413	21864	Fc fragment of IgG, low affinity IIIa, receptor (CD16a)
PA28066	2215	FCGR3B	chr1	161589986	161611753	21767	Fc fragment of IgG, low affinity IIIb, receptor (CD16b)
PA28067	2217	FCGRT	chr19	50005536	50032685	27149	Fc fragment of IgG, receptor, transporter, alpha
PA134870625	23149	FCHO1	chr19	17848527	17902377	53850	FCH domain only 1
PA134911830	115548	FCHO2	chr5	72241808	72389349	147541	FCH domain only 2
PA134871859	89848	FCHSD1	chr5	141015869	141040986	25117	FCH and double SH3 domains 1
PA128394562	9873	FCHSD2	chr11	72544788	72863727	318939	FCH and double SH3 domains 2
PA28069	2219	FCN1	chr9	137794711	137819849	25138	ficolin (collagen/fibrinogen domain containing) 1
PA28070	2220	FCN2	chr9	137762658	137782366	19708	ficolin (collagen/fibrinogen domain containing lectin) 2
PA28071	8547	FCN3	chr1	27692601	27711315	18714	ficolin (collagen/fibrinogen domain containing) 3
PA142671766	115350	FCRL1	chr1	157761193	157799940	38747	Fc receptor-like 1
PA37913	79368	FCRL2	chr1	157712523	157757119	44596	Fc receptor-like 2
PA142671767	115352	FCRL3	chr1	157643271	157680775	37504	Fc receptor-like 3
PA142671768	83417	FCRL4	chr1	157540539	157577870	37331	Fc receptor-like 4
PA142671769	83416	FCRL5	chr1	157480167	157532310	52143	Fc receptor-like 5
PA142671770	343413	FCRL6	chr1	159760282	159789047	28765	Fc receptor-like 6
PA162388180	84824	FCRLA	chr1	161666762	161687142	20380	Fc receptor-like A
PA162388195	127943	FCRLB	chr1	161681598	161700933	19335	Fc receptor-like B
PA134922601	260436	FDCSP	chr4	71081788	71103969	22181	follicular dendritic cell secreted protein
PA28073	2222	FDFT1	chr8	11643467	11699818	56351	farnesyl-diphosphate farnesyltransferase 1
PA28075	2224	FDPS	chr1	155268539	155293457	24918	farnesyl diphosphate synthase
PA28082	2230	FDX1	chr11	110290661	110338608	47947	ferredoxin 1
PA162388212	112812	FDX1L	chr19	10417887	10437241	19354	ferredoxin 1-like
PA164720055	91893	FDXACB1	chr11	111741780	111760181	18401	ferredoxin-fold anticodon binding domain containing 1
PA28086	2232	FDXR	chr17	72855619	72879156	23537	ferredoxin reductase
PA28087	2235	FECH	chr18	55209073	55263969	54896	ferrochelatase
PA134940973	55527	FEM1A	chr19	4781728	4798571	16843	fem-1 homolog a (C. elegans)
PA28089	10116	FEM1B	chr15	68560141	68586640	26499	fem-1 homolog b (C. elegans)
PA134891999	56929	FEM1C	chr5	114853605	114890591	36986	fem-1 homolog c (C. elegans)
PA28090	2237	FEN1	chr11	61550109	61567716	17607	flap structure-specific endonuclease 1
PA28095	2241	FER	chr5	108073523	108526373	452850	fer (fps/fes related) tyrosine kinase
PA142671764	90342	FER1L5	chr2	97298574	97373624	75050	fer-1-like family member 5
PA162388227	654463	FER1L6	chr8	124854227	125135412	281185	fer-1-like family member 6
PA134973730	222894	FERD3L	chr7	19177618	19195044	17426	Fer3-like bHLH transcription factor
PA162388314	55612	FERMT1	chr20	6052492	6114191	61699	fermitin family member 1
PA162388349	10979	FERMT2	chr14	53320989	53427856	106867	fermitin family member 2
PA162388384	83706	FERMT3	chr11	63964152	63994363	30211	fermitin family member 3
PA28098	2242	FES	chr15	91417665	91442006	24341	FES proto-oncogene, tyrosine kinase
PA28099	26998	FETUB	chr3	186343758	186373797	30039	fetuin B
PA134875093	54738	FEV	chr2	219842809	219860379	17570	FEV (ETS oncogene family)
PA28100	9638	FEZ1	chr11	125312641	125376206	63565	fasciculation and elongation protein zeta 1 (zygin I)
PA28101	9637	FEZ2	chr2	36776397	36835333	58936	fasciculation and elongation protein zeta 2 (zygin II)
PA162388419	389549	FEZF1	chr7	121938373	121961173	22800	FEZ family zinc finger 1
PA162388420	55079	FEZF2	chr3	62352347	62369190	16843	FEZ family zinc finger 2
PA28887	2864	FFAR1	chr19	35831645	35847764	16119	free fatty acid receptor 1
PA28890	2867	FFAR2	chr19	35929185	35945669	16484	free fatty acid receptor 2
PA28888	2865	FFAR3	chr19	35839249	35854391	15142	free fatty acid receptor 3
PA134924595	338557	FFAR4	chr10	95316422	95352829	36407	free fatty acid receptor 4
PA429	2243	FGA	chr4	155501280	155521897	20617	fibrinogen alpha chain
PA163	2244	FGB	chr4	155474132	155496915	22783	fibrinogen beta chain
PA28102	2245	FGD1	chrX	54468887	54532599	63712	FYVE, RhoGEF and PH domain containing 1
PA28103	221472	FGD2	chr6	36963423	36999845	36422	FYVE, RhoGEF and PH domain containing 2
PA28104	89846	FGD3	chr9	95699601	95801518	101917	FYVE, RhoGEF and PH domain containing 3
PA134907925	121512	FGD4	chr12	32542518	32801984	259466	FYVE, RhoGEF and PH domain containing 4
PA134874843	152273	FGD5	chr3	14842247	14979072	136825	FYVE, RhoGEF and PH domain containing 5
PA134967436	55785	FGD6	chr12	95467525	95621240	153715	FYVE, RhoGEF and PH domain containing 6
PA28105	2246	FGF1	chr5	141968743	142087635	118892	fibroblast growth factor 1 (acidic)
PA28106	2255	FGF10	chr5	44302004	44399808	97804	fibroblast growth factor 10
PA28107	2256	FGF11	chr17	7331784	7351256	19472	fibroblast growth factor 11
PA28108	2257	FGF12	chr3	191854033	192455388	601355	fibroblast growth factor 12
PA28109	2258	FGF13	chrX	137710734	138315051	604317	fibroblast growth factor 13
PA28110	2259	FGF14	chr13	102370205	103064124	693919	fibroblast growth factor 14
PA28111	8823	FGF16	chrX	76699645	76715013	15368	fibroblast growth factor 16
PA28112	8822	FGF17	chr8	21890264	21909320	19056	fibroblast growth factor 17
PA28113	8817	FGF18	chr5	170836667	170887630	50963	fibroblast growth factor 18
PA28114	9965	FGF19	chr11	69510006	69529106	19100	fibroblast growth factor 19
PA28115	2247	FGF2	chr4	123737568	123822390	84822	fibroblast growth factor 2 (basic)
PA28116	26281	FGF20	chr8	16847334	16869674	22340	fibroblast growth factor 20
PA28117	26291	FGF21	chr19	49248816	49264587	15771	fibroblast growth factor 21
PA28118	27006	FGF22	chr19	629901	646824	16923	fibroblast growth factor 22
PA28119	8074	FGF23	chr12	4474393	4498894	24501	fibroblast growth factor 23
PA28120	2248	FGF3	chr11	69621736	69644192	22456	fibroblast growth factor 3
PA28121	2249	FGF4	chr11	69584797	69600171	15374	fibroblast growth factor 4
PA28122	2250	FGF5	chr4	81177742	81215171	37429	fibroblast growth factor 5
PA28123	2251	FGF6	chr12	4540308	4564780	24472	fibroblast growth factor 6
PA28124	2252	FGF7	chr15	49705375	49782523	77148	fibroblast growth factor 7
PA28125	2253	FGF8	chr10	103526887	103550126	23239	fibroblast growth factor 8 (androgen-induced)
PA28126	2254	FGF9	chr13	22235215	22281640	46425	fibroblast growth factor 9
PA134880558	9982	FGFBP1	chr4	15934192	15950363	16171	fibroblast growth factor binding protein 1
PA162388435	83888	FGFBP2	chr4	15958863	15974859	15996	fibroblast growth factor binding protein 2
PA162388444	143282	FGFBP3	chr10	93663345	93679258	15913	fibroblast growth factor binding protein 3
PA28127	2260	FGFR1	chr8	38265656	38336352	70696	fibroblast growth factor receptor 1
PA134941638	11116	FGFR1OP	chr6	167402805	167461064	58259	FGFR1 oncogene partner
PA134972108	26127	FGFR1OP2	chr12	27081305	27122581	41276	FGFR1 oncogene partner 2
PA28128	2263	FGFR2	chr10	123234844	123367972	133128	fibroblast growth factor receptor 2
PA28129	2261	FGFR3	chr4	1785039	1813599	28560	fibroblast growth factor receptor 3
PA28130	2264	FGFR4	chr5	176503906	176528143	24237	fibroblast growth factor receptor 4
PA28132	53834	FGFRL1	chr4	994712	1023686	28974	fibroblast growth factor receptor-like 1
PA430	2266	FGG	chr4	155522286	155543902	21616	fibrinogen gamma chain
PA162388453	55277	FGGY	chr1	59752625	60231402	478777	FGGY carbohydrate kinase domain containing
PA28133	2267	FGL1	chr8	17718894	17777874	58980	fibrinogen-like 1
PA28134	10875	FGL2	chr7	76819688	76839150	19462	fibrinogen-like 2
PA28135	2268	FGR	chr1	27935800	27971727	35927	FGR proto-oncogene, Src family tyrosine kinase
PA28139	2271	FH	chr1	241657857	241693085	35228	fumarate hydratase
PA142671762	114827	FHAD1	chr1	15563730	15727767	164037	forkhead-associated (FHA) phosphopeptide binding domain 1
PA162388490	85462	FHDC1	chr4	153847265	153903848	56583	FH2 domain containing 1
PA28140	2272	FHIT	chr3	59732036	61247133	1515097	fragile histidine triad
PA28141	2273	FHL1	chrX	135218861	135296518	77657	four and a half LIM domains 1
PA164	2274	FHL2	chr2	105974272	106065230	90958	four and a half LIM domains 2
PA28142	2275	FHL3	chr1	38459439	38481199	21760	four and a half LIM domains 3
PA134971720	9457	FHL5	chr6	97000406	97070806	70400	four and a half LIM domains 5
PA28143	29109	FHOD1	chr16	67260292	67291425	31133	formin homology 2 domain containing 1
PA134929910	80206	FHOD3	chr18	33867677	34363019	495342	formin homology 2 domain containing 3
PA134891641	84929	FIBCD1	chr9	133774825	133824455	49630	fibrinogen C domain containing 1
PA164720070	387758	FIBIN	chr11	27005628	27021634	16006	fin bud initiation factor homolog (zebrafish)
PA28145	9158	FIBP	chr11	65648211	65666010	17799	fibroblast growth factor (acidic) intracellular binding protein
PA162388517	11153	FICD	chr12	108899051	108916380	17329	FIC domain containing
PA162388528	9896	FIG4	chr6	110002424	110149634	147210	FIG4 phosphoinositide 5-phosphatase
PA28146	2277	FIGF	chrX	15360713	15412535	51822	c-fos induced growth factor (vascular endothelial growth factor D)
PA145008379	344018	FIGLA	chr2	71001442	71027775	26333	folliculogenesis specific basic helix-loop-helix
PA28147	55137	FIGN	chr2	164458447	164602618	144171	fidgetin
PA28148	63979	FIGNL1	chr7	50508827	50528088	19261	fidgetin-like 1
PA134992638	27145	FILIP1	chr6	76001607	76213516	211909	filamin A interacting protein 1
PA162388580	11259	FILIP1L	chr3	99548988	99843349	294361	filamin A interacting protein 1-like
PA134875694	81608	FIP1L1	chr4	54233803	54329103	95300	factor interacting with PAPOLA and CPSF1
PA134984211	51024	FIS1	chr7	100879893	100899009	19116	fission 1 (mitochondrial outer membrane) homolog (S. cerevisiae)
PA165478932	161247	FITM1	chr14	24590675	24605058	14383	fat storage-inducing transmembrane protein 1
PA25685	128486	FITM2	chr20	42932197	42949889	17692	fat storage-inducing transmembrane protein 2
PA162388597	84922	FIZ1	chr19	56099737	56120893	21156	FLT3-interacting zinc finger 1
PA28151	24147	FJX1	chr11	35629735	35645421	15686	four jointed box 1 (Drosophila)
PA28152	60681	FKBP10	chr17	39958962	39982469	23507	FK506 binding protein 10, 65 kDa
PA38607	51303	FKBP11	chr12	49312742	49329330	16588	FK506 binding protein 11, 19 kDa
PA38608	55033	FKBP14	chr7	30047199	30076417	29218	FK506 binding protein 14, 22 kDa
PA162388608	23307	FKBP15	chr9	115924800	115993641	68841	FK506 binding protein 15, 133kDa
PA28153	2280	FKBP1A	chr20	1346621	1383816	37195	FK506 binding protein 1A, 12kDa
PA28154	2281	FKBP1B	chr2	24262584	24289551	26967	FK506 binding protein 1B, 12.6 kDa
PA28159	2286	FKBP2	chr11	63998413	64014607	16194	FK506 binding protein 2, 13kDa
PA28160	2287	FKBP3	chr14	45581802	45613732	31930	FK506 binding protein 3, 25kDa
PA28161	2288	FKBP4	chr12	2894108	2917589	23481	FK506 binding protein 4, 59kDa
PA28162	2289	FKBP5	chr6	35538362	35706360	167998	FK506 binding protein 5
PA28163	8468	FKBP6	chr7	72732155	72775646	43491	FK506 binding protein 6, 36kDa
PA28164	51661	FKBP7	chr2	179325391	179353646	28255	FK506 binding protein 7
PA28165	23770	FKBP8	chr19	18639568	18664887	25319	FK506 binding protein 8, 38kDa
PA28166	11328	FKBP9	chr7	32987005	33049543	62538	FK506 binding protein 9, 63 kDa
PA28167	63943	FKBPL	chr6	32093484	32108067	14583	FK506 binding protein like
PA134976709	79147	FKRP	chr19	47239303	47264832	25529	fukutin related protein
PA162388669	2218	FKTN	chr9	108310411	108406399	95988	fukutin
PA142671759	80308	FLAD1	chr1	154945770	154968587	22817	flavin adenine dinucleotide synthetase 1
PA134901005	201163	FLCN	chr17	17112523	17150502	37979	folliculin
PA28169	2312	FLG	chr1	152271651	152307679	36028	filaggrin
PA162388694	388698	FLG2	chr1	152318213	152342482	24269	filaggrin family member 2
PA28170	2313	FLI1	chr11	128546430	128686162	139732	Fli-1 proto-oncogene, ETS transcription factor
PA28171	2314	FLII	chr17	18145129	18172230	27101	flightless I homolog (Drosophila)
PA28172	2316	FLNA	chrX	153573900	153613006	39106	filamin A, alpha
PA28173	2317	FLNB	chr3	57984127	58160982	176855	filamin B, beta
PA28174	2318	FLNC	chr7	128460436	128502328	41892	filamin C, gamma
PA28175	10211	FLOT1	chr6	30692506	30720687	28181	flotillin 1
PA28176	2319	FLOT2	chr17	27203356	27234715	31359	flotillin 2
PA28177	23769	FLRT1	chr11	63793442	63889655	96213	fibronectin leucine rich transmembrane protein 1
PA28178	23768	FLRT2	chr14	85986411	86098040	111629	fibronectin leucine rich transmembrane protein 2
PA28179	23767	FLRT3	chr20	14301639	14328313	26674	fibronectin leucine rich transmembrane protein 3
PA28180	2321	FLT1	chr13	28871483	29079265	207782	fms-related tyrosine kinase 1
PA28181	2322	FLT3	chr13	28574411	28692904	118493	fms-related tyrosine kinase 3
PA28182	2323	FLT3LG	chr19	49967455	49992491	25036	fms-related tyrosine kinase 3 ligand
PA28183	2324	FLT4	chr5	180025506	180086624	61118	fms-related tyrosine kinase 4
PA162388695	28982	FLVCR1	chr1	213021597	213075705	54108	feline leukemia virus subgroup C cellular receptor 1
PA162388720	55640	FLVCR2	chr14	76034940	76117512	82572	feline leukemia virus subgroup C cellular receptor family, member 2
PA142671760	84256	FLYWCH1	chr16	2951943	3004209	52266	FLYWCH-type zinc finger 1
PA162388745	114984	FLYWCH2	chr16	2922924	2952383	29459	FLYWCH family member 2
PA28184	342184	FMN1	chr15	33054745	33496934	442189	formin 1
PA28185	56776	FMN2	chr1	240245185	240641491	396306	formin 2
PA28186	752	FMNL1	chr17	43289192	43327685	38493	formin-like 1
PA28144	114793	FMNL2	chr2	153181684	153509348	327664	formin-like 2
PA134992328	91010	FMNL3	chr12	50028724	50111197	82473	formin-like 3
PA165	2326	FMO1	chr1	171207610	171258113	50503	flavin containing monooxygenase 1
PA164741534	2327	FMO2	chr1	171144388	171184822	40434	flavin containing monooxygenase 2 (non-functional)
PA166	2328	FMO3	chr1	171050018	171089961	39943	flavin containing monooxygenase 3
PA28188	2329	FMO4	chr1	171273318	171314223	40905	flavin containing monooxygenase 4
PA28189	2330	FMO5	chr1	146652884	146707390	54506	flavin containing monooxygenase 5
PA28190	2331	FMOD	chr1	203306749	203330557	23808	fibromodulin
PA28191	2332	FMR1	chrX	146983469	147035647	52178	fragile X mental retardation 1
PA134927784	158521	FMR1NB	chrX	147052849	147111187	58338	fragile X mental retardation 1 neighbor
PA28194	2335	FN1	chr2	216222177	216310890	88713	fibronectin 1
PA134870460	64122	FN3K	chr17	80683452	80712073	28621	fructosamine 3 kinase
PA164720079	79672	FN3KRP	chr17	80664582	80688893	24311	fructosamine 3 kinase related protein
PA128394597	23048	FNBP1	chr9	132646458	132815473	169015	formin binding protein 1
PA128394675	54874	FNBP1L	chr1	93903688	94023218	119530	formin binding protein 1-like
PA134971679	23360	FNBP4	chr11	47735055	47799012	63957	formin binding protein 4
PA134906656	84624	FNDC1	chr6	159580429	159696140	115711	fibronectin type III domain containing 1
PA128394588	22862	FNDC3A	chr13	49540048	49786915	246867	fibronectin type III domain containing 3A
PA134936830	64778	FNDC3B	chr3	171747418	172121493	374075	fibronectin type III domain containing 3B
PA134883376	64838	FNDC4	chr2	27711750	27728126	16376	fibronectin type III domain containing 4
PA134924607	252995	FNDC5	chr1	33324869	33348093	23224	fibronectin type III domain containing 5
PA142671756	163479	FNDC7	chr1	109245556	109288371	42815	fibronectin type III domain containing 7
PA142671757	54752	FNDC8	chr17	33438598	33460751	22153	fibronectin type III domain containing 8
PA162380178	408263	FNDC9	chr5	156765607	156782729	17122	fibronectin type III domain containing 9
PA142671758	96459	FNIP1	chr5	130974407	131142756	168349	folliculin interacting protein 1
PA162388758	57600	FNIP2	chr4	159680182	159832202	152020	folliculin interacting protein 2
PA28199	2339	FNTA	chr8	42901442	42943931	42489	farnesyltransferase, CAAX box, alpha
PA28202	2342	FNTB	chr14	65443507	65532370	88863	farnesyltransferase, CAAX box, beta
PA134934777	54914	FOCAD	chr9	20648309	20998954	350645	focadhesin
PA28205	2346	FOLH1	chr11	49165187	49240222	75035	folate hydrolase (prostate-specific membrane antigen) 1
PA165543408	219595	FOLH1B	chr11	89360675	89434886	74211	folate hydrolase 1B
PA28207	2348	FOLR1	chr11	71890602	71910367	19765	folate receptor 1 (adult)
PA28209	2350	FOLR2	chr11	71917819	71935994	18175	folate receptor 2 (fetal)
PA28211	2352	FOLR3	chr11	71836771	71853934	17163	folate receptor 3 (gamma)
PA143485399	123811	FOPNL	chr16	15956576	15992510	35934	FGFR1OP N-terminal like
PA28212	2353	FOS	chr14	75735477	75751937	16460	FBJ murine osteosarcoma viral oncogene homolog
PA28213	2354	FOSB	chr19	45961253	45981437	20184	FBJ murine osteosarcoma viral oncogene homolog B
PA28214	8061	FOSL1	chr11	65656616	65677997	21381	FOS-like antigen 1
PA28215	2355	FOSL2	chr2	28605704	28640516	34812	FOS-like antigen 2
PA201090	3169	FOXA1	chr14	38055757	38074325	18568	forkhead box A1
PA201091	3170	FOXA2	chr20	22558642	22576101	17459	forkhead box A2
PA201092	3171	FOXA3	chr19	46357518	46380055	22537	forkhead box A3
PA28216	27023	FOXB1	chr15	60286421	60301142	14721	forkhead box B1
PA145148830	442425	FOXB2	chr9	79624571	79638869	14298	forkhead box B2
PA28217	2296	FOXC1	chr6	1600681	1617132	16451	forkhead box C1
PA28218	2303	FOXC2	chr16	86590857	86605539	14682	forkhead box C2 (MFH-1, mesenchyme forkhead 1)
PA28220	2306	FOXD2	chr1	47891689	47909363	17674	forkhead box D2
PA28221	27022	FOXD3	chr1	63778730	63793797	15067	forkhead box D3
PA28222	2298	FOXD4	chr9	113231	128417	15186	forkhead box D4
PA134928763	200350	FOXD4L1	chr2	114246661	114261727	15066	forkhead box D4-like 1
PA162388797	100036519	FOXD4L2	chr9	42707234	42723342	16108	forkhead box D4-like 2
PA134941846	286380	FOXD4L3	chr9	70907783	70923000	15217	forkhead box D4-like 3
PA142671752	349334	FOXD4L4	chr9	70423623	70439731	16108	forkhead box D4-like 4
PA162388804	653427	FOXD4L5	chr9	70172707	70188815	16108	forkhead box D4-like 5
PA162388805	653404	FOXD4L6	chr9	69196480	69212204	15724	forkhead box D4-like 6
PA28223	2304	FOXE1	chr9	100605537	100621997	16460	forkhead box E1 (thyroid transcription factor 2)
PA28225	2301	FOXE3	chr1	47871744	47886724	14980	forkhead box E3
PA28226	2294	FOXF1	chr16	86534133	86551070	16937	forkhead box F1
PA28227	2295	FOXF2	chr6	1380069	1398832	18763	forkhead box F2
PA162388806	2290	FOXG1	chr14	29226278	29242483	16205	forkhead box G1
PA28231	8928	FOXH1	chr8	145696115	145711718	15603	forkhead box H1
PA28232	2299	FOXI1	chr5	169522917	169539729	16812	forkhead box I1
PA162388813	399823	FOXI2	chr10	129525538	129542450	16912	forkhead box I2
PA28233	2302	FOXJ1	chr17	74129414	74147380	17966	forkhead box J1
PA134982817	55810	FOXJ2	chr12	8175298	8211118	35820	forkhead box J2
PA134945417	22887	FOXJ3	chr1	42639210	42811548	172338	forkhead box J3
PA134978307	221937	FOXK1	chr7	4711930	4814074	102144	forkhead box K1
PA29851	3607	FOXK2	chr17	80467594	80565483	97889	forkhead box K2
PA28234	2300	FOXL1	chr16	86602115	86618304	16189	forkhead box L1
PA28235	668	FOXL2	chr3	138660066	138675982	15916	forkhead box L2
PA162379723	401089	FOXL2NB	chr3	138656076	138675830	19754	FOXL2 neighbor
PA28236	2305	FOXM1	chr12	2963846	2996321	32475	forkhead box M1
PA37368	8456	FOXN1	chr17	26823249	26868175	44926	forkhead box N1
PA162388822	3344	FOXN2	chr2	48531783	48609434	77651	forkhead box N2
PA26460	1112	FOXN3	chr14	89619516	90095506	475990	forkhead box N3
PA134982965	121643	FOXN4	chr12	109712783	109757025	44242	forkhead box N4
PA28237	2308	FOXO1	chr13	41126801	41250734	123933	forkhead box O1
PA28239	2309	FOXO3	chr6	108871026	109008972	137946	forkhead box O3
PA162388882	4303	FOXO4	chrX	70305999	70326384	20385	forkhead box O4
PA162388893	100132074	FOXO6	chr1	41817227	41859020	41793	forkhead box O6
PA28241	27086	FOXP1	chr3	71000865	71643140	642275	forkhead box P1
PA28242	93986	FOXP2	chr7	113716365	114336827	620462	forkhead box P2
PA201094	50943	FOXP3	chrX	49103897	49132200	28303	forkhead box P3
PA134943098	116113	FOXP4	chr6	41504164	41573122	68958	forkhead box P4
PA134924898	94234	FOXQ1	chr6	1302675	1317993	15318	forkhead box Q1
PA134959382	283150	FOXR1	chr11	118832417	118854997	22580	forkhead box R1
PA134950741	139628	FOXR2	chrX	55639833	55655621	15788	forkhead box R2
PA143485473	55572	FOXRED1	chr11	126128935	126151027	22092	FAD-dependent oxidoreductase domain containing 1
PA145148808	80020	FOXRED2	chr22	36880233	36913148	32915	FAD-dependent oxidoreductase domain containing 2
PA162388894	2307	FOXS1	chr20	30429103	30443420	14317	forkhead box S1
PA167	2356	FPGS	chr9	130555137	130579799	24662	folylpolyglutamate synthase
PA28243	8790	FPGT	chr1	74653896	74677533	23637	fucose-1-phosphate guanylyltransferase
PA28244	2357	FPR1	chr19	52246023	52265150	19127	formyl peptide receptor 1
PA162388901	2358	FPR2	chr19	52254453	52276779	22326	formyl peptide receptor 2
PA162388910	2359	FPR3	chr19	52288411	52332334	43923	formyl peptide receptor 3
PA25476	118924	FRA10AC1	chr10	95424640	95472329	47689	fragile site, folic acid type, rare, fra(10)(q23.3) or fra(10)(q24.2) candidate 1
PA134980133	80144	FRAS1	chr4	78968724	79468423	499699	Fraser extracellular matrix complex subunit 1
PA28361	10023	FRAT1	chr10	99069022	99084672	15650	frequently rearranged in advanced T-cell lymphomas 1
PA28362	23401	FRAT2	chr10	99089254	99104458	15204	frequently rearranged in advanced T-cell lymphomas 2
PA134892147	158326	FREM1	chr9	14731664	14920993	189329	FRAS1 related extracellular matrix 1
PA134930862	341640	FREM2	chr13	39251173	39464268	213095	FRAS1 related extracellular matrix protein 2
PA134941914	166752	FREM3	chr4	144495560	144631828	136268	FRAS1 related extracellular matrix 3
PA28372	2483	FRG1	chr4	190851974	190887360	35386	FSHD region gene 1
PA162388919	448831	FRG2	chr4	190942522	190958412	15890	FSHD region gene 2
PA162388920	441581	FRG2B	chr10	135435603	135450299	14696	FSHD region gene 2 family, member B
PA162388921	100288801	FRG2C	chr3	75703487	75719368	15881	FSHD region gene 2 family, member C
PA28373	2444	FRK	chr6	116259691	116407360	147669	fyn-related Src family tyrosine kinase
PA134993010	79981	FRMD1	chr6	168453425	168492237	38812	FERM domain containing 1
PA134903920	257019	FRMD3	chr9	85854905	86163348	308443	FERM domain containing 3
PA134946784	55691	FRMD4A	chr10	13682706	14382866	700160	FERM domain containing 4A
PA128394605	23150	FRMD4B	chr3	69216146	69445430	229284	FERM domain containing 4B
PA142671751	84978	FRMD5	chr15	44159962	44497429	337467	FERM domain containing 5
PA134913028	122786	FRMD6	chr14	51945819	52200445	254626	FERM domain containing 6
PA162388934	90167	FRMD7	chrX	131208021	131272050	64029	FERM domain containing 7
PA162388963	83786	FRMD8	chr11	65144041	65183996	39955	FERM domain containing 8
PA134910182	22844	FRMPD1	chr9	37641052	37749901	108849	FERM and PDZ domain containing 1
PA134947461	143162	FRMPD2	chr10	49361602	49492941	131339	FERM and PDZ domain containing 2
PA143485474	84443	FRMPD3	chrX	106755680	106851479	95799	FERM and PDZ domain containing 3
PA134977575	9758	FRMPD4	chrX	12146585	12745642	599057	FERM and PDZ domain containing 4
PA142670941	391059	FRRS1	chr1	100171206	100242186	70980	ferric-chelate reductase 1
PA25979	23732	FRRS1L	chr9	111896581	111939571	42990	ferric-chelate reductase 1-like
PA134850063	10818	FRS2	chr12	69854129	69976573	122444	fibroblast growth factor receptor substrate 2
PA134961503	10817	FRS3	chr6	41734914	41757643	22729	fibroblast growth factor receptor substrate 3
PA134927490	10129	FRY	chr13	32595269	32873794	278525	furry homolog (Drosophila)
PA134967984	285527	FRYL	chr4	48496380	48792329	295949	FRY-like
PA28377	2487	FRZB	chr2	183695002	183741498	46496	frizzled-related protein
PA162389023	84075	FSCB	chr14	44970352	44986499	16147	fibrous sheath CABYR binding protein
PA128394534	6624	FSCN1	chr7	5622436	5649287	26851	fascin actin-bundling protein 1
PA28378	25794	FSCN2	chr17	79471022	79507156	36134	fascin actin-bundling protein 2, retinal
PA28379	29999	FSCN3	chr7	127223689	127244851	21162	fascin actin-bundling protein 3, testicular
PA134882882	79187	FSD1	chr19	4294591	4326843	32252	fibronectin type III and SPRY domain containing 1
PA26931	83856	FSD1L	chr9	108200077	108317714	117637	fibronectin type III and SPRY domain containing 1-like
PA38279	123722	FSD2	chr15	83423827	83484850	61023	fibronectin type III and SPRY domain containing 2
PA28382	2488	FSHB	chr11	30242563	30259824	17261	follicle stimulating hormone, beta polypeptide
PA28386	2492	FSHR	chr2	49186296	49391666	205370	follicle stimulating hormone receptor
PA142671750	161835	FSIP1	chr15	39883422	40085039	201617	fibrous sheath interacting protein 1
PA134991479	401024	FSIP2	chr2	186593355	186701016	107661	fibrous sheath interacting protein 2
PA28388	10468	FST	chr5	52766183	52785964	19781	follistatin
PA28389	11167	FSTL1	chr3	120110061	120179918	69857	follistatin-like 1
PA28390	10272	FSTL3	chr19	666389	686392	20003	follistatin-like 3 (secreted glycoprotein)
PA134969998	23105	FSTL4	chr5	132529152	132958223	429071	follistatin-like 4
PA134978045	56884	FSTL5	chr4	162302044	163095186	793142	follistatin-like 5
PA28391	10841	FTCD	chr21	47553065	47585499	32434	formimidoyltransferase cyclodeaminase
PA28392	2495	FTH1	chr11	61728757	61745132	16375	ferritin, heavy polypeptide 1
PA28402	53940	FTHL17	chrX	31086358	31100170	13812	ferritin, heavy polypeptide-like 17
PA28412	2512	FTL	chr19	49457659	49473136	15477	ferritin, light polypeptide
PA134941146	94033	FTMT	chr5	121177650	121191528	13878	ferritin mitochondrial
PA152208656	79068	FTO	chr16	53727875	54151379	423504	fat mass and obesity associated
PA28417	24140	FTSJ1	chrX	48324454	48347752	23298	FtsJ RNA methyltransferase homolog 1 (E. coli)
PA28418	29960	FTSJ2	chr7	2270830	2291840	21010	FtsJ RNA methyltransferase homolog 2 (E. coli)
PA28419	117246	FTSJ3	chr17	61893793	61915031	21238	FtsJ homolog 3 (E. coli)
PA28420	8880	FUBP1	chr1	78406740	78454839	48099	far upstream element (FUSE) binding protein 1
PA28421	8939	FUBP3	chr9	133444954	133516739	71785	far upstream element (FUSE) binding protein 3
PA28422	2517	FUCA1	chr1	24168567	24204859	36292	fucosidase, alpha-L- 1, tissue
PA28424	2519	FUCA2	chr6	143812949	143843020	30071	fucosidase, alpha-L- 2, plasma
PA134863646	197258	FUK	chr16	70478498	70517177	38679	fucokinase
PA134875965	139341	FUNDC1	chrX	44379885	44412221	32336	FUN14 domain containing 1
PA134908797	65991	FUNDC2	chrX	154245064	154288191	43127	FUN14 domain containing 2
PA134972390	282969	FUOM	chr10	135165658	135181529	15871	fucose mutarotase
PA32894	5045	FURIN	chr15	91401885	91429687	27802	furin (paired basic amino acid cleaving enzyme)
PA28425	2521	FUS	chr16	31181431	31209192	27761	FUS RNA binding protein
PA28428	2523	FUT1	chr19	49248268	49268647	20379	fucosyltransferase 1 (galactoside 2-alpha-L-fucosyltransferase, H blood group)
PA134872572	84750	FUT10	chr8	33225057	33340664	115607	fucosyltransferase 10 (alpha (1,3) fucosyltransferase)
PA134914077	170384	FUT11	chr10	75521830	75538977	17147	fucosyltransferase 11 (alpha (1,3) fucosyltransferase)
PA28429	2524	FUT2	chr19	49189228	49212191	22963	fucosyltransferase 2 (secretor status included)
PA28430	2525	FUT3	chr19	5839899	5861485	21586	fucosyltransferase 3 (galactoside 3(4)-L-fucosyltransferase, Lewis blood group)
PA28431	2526	FUT4	chr11	94267017	94286064	19047	fucosyltransferase 4 (alpha (1,3) fucosyltransferase, myeloid-specific)
PA28432	2527	FUT5	chr19	5862837	5880551	17714	fucosyltransferase 5 (alpha (1,3) fucosyltransferase)
PA28433	2528	FUT6	chr19	5827637	5849764	22127	fucosyltransferase 6 (alpha (1,3) fucosyltransferase)
PA28434	2529	FUT7	chr9	139921626	139937292	15666	fucosyltransferase 7 (alpha (1,3) fucosyltransferase)
PA28435	2530	FUT8	chr14	65867310	66213839	346529	fucosyltransferase 8 (alpha (1,6) fucosyltransferase)
PA28436	10690	FUT9	chr6	96453845	96666488	212643	fucosyltransferase 9 (alpha (1,3) fucosyltransferase)
PA145148782	80199	FUZ	chr19	50307123	50326567	19444	fuzzy planar cell polarity protein
PA28369	2395	FXN	chr9	71640479	71718094	77615	frataxin
PA28439	8087	FXR1	chr3	180620096	180703541	83445	fragile X mental retardation, autosomal homolog 1
PA28440	9513	FXR2	chr17	7491548	7528215	36667	fragile X mental retardation, autosomal homolog 2
PA28441	5348	FXYD1	chr19	35619693	35636959	17266	FXYD domain containing ion transport regulator 1
PA28442	486	FXYD2	chr11	117687790	117709408	21618	FXYD domain containing ion transport regulator 2
PA28443	5349	FXYD3	chr19	35596732	35618228	21496	FXYD domain containing ion transport regulator 3
PA28444	53828	FXYD4	chr10	43857092	43874783	17691	FXYD domain containing ion transport regulator 4
PA28445	53827	FXYD5	chr19	35635625	35663788	28163	FXYD domain containing ion transport regulator 5
PA28446	53826	FXYD6	chr11	117704691	117758201	53510	FXYD domain containing ion transport regulator 6
PA28450	53822	FXYD7	chr19	35624154	35648205	24051	FXYD domain containing ion transport regulator 7
PA28452	2533	FYB	chr5	39102354	39280759	178405	FYN binding protein
PA28453	79443	FYCO1	chr3	45956391	46047316	90925	FYVE and coiled-coil domain containing 1
PA28454	2534	FYN	chr6	111978535	112204655	226120	FYN proto-oncogene, Src family tyrosine kinase
PA134946373	84248	FYTTD1	chr3	197466424	197514317	47893	forty-two-three domain containing 1
PA28455	8321	FZD1	chr7	90883783	90901132	17349	frizzled class receptor 1
PA28456	11211	FZD10	chr12	130637004	130653285	16281	frizzled class receptor 10
PA28457	2535	FZD2	chr17	42624812	42641630	16818	frizzled class receptor 2
PA28458	7976	FZD3	chr8	28341722	28434785	93063	frizzled class receptor 3
PA28459	8322	FZD4	chr11	86653717	86676440	22723	frizzled class receptor 4
PA28460	7855	FZD5	chr2	208624310	208644143	19833	frizzled class receptor 5
PA28461	8323	FZD6	chr8	104300661	104348094	47433	frizzled class receptor 6
PA28462	8324	FZD7	chr2	202889310	202906160	16850	frizzled class receptor 7
PA28463	8325	FZD8	chr10	35924177	35940362	16185	frizzled class receptor 8
PA28464	8326	FZD9	chr7	72838109	72853450	15341	frizzled class receptor 9
PA134896003	51343	FZR1	chr19	3496261	3539755	43494	fizzy/cell division cycle 20 related 1 (Drosophila)
PA142671707	50486	G0S2	chr1	209838670	209852735	14065	G0/G1 switch 2
PA164720127	55632	G2E3	chr14	31018329	31092046	73717	G2/M-phase specific E3 ubiquitin protein ligase
PA162389105	10146	G3BP1	chr5	151141476	151187915	46439	GTPase activating protein (SH3 domain) binding protein 1
PA162389134	9908	G3BP2	chr4	76564953	76659709	94756	GTPase activating protein (SH3 domain) binding protein 2
PA28468	2538	G6PC	chr17	41042814	41069450	26636	glucose-6-phosphatase, catalytic subunit
PA134944773	57818	G6PC2	chr2	169747750	169769510	21760	glucose-6-phosphatase, catalytic, 2
PA134968446	92579	G6PC3	chr17	42138098	42156712	18614	glucose 6 phosphatase, catalytic, 3
PA28469	2539	G6PD	chrX	153756606	153785796	29190	glucose-6-phosphate dehydrogenase
PA28476	2548	GAA	chr17	78065339	78096680	31341	glucosidase, alpha; acid
PA28477	2549	GAB1	chr4	144247680	144398718	151038	GRB2-associated binding protein 1
PA28478	9846	GAB2	chr11	77923336	78138868	215532	GRB2-associated binding protein 2
PA28479	139716	GAB3	chrX	153900526	153989855	89329	GRB2-associated binding protein 3
PA134933290	128954	GAB4	chr22	17439826	17499112	59286	GRB2-associated binding protein family, member 4
PA28480	11337	GABARAP	chr17	7140738	7155753	15015	GABA(A) receptor-associated protein
PA28481	23710	GABARAPL1	chr12	10355435	10378727	23292	GABA(A) receptor-associated protein like 1
PA28482	11345	GABARAPL2	chr16	75590249	75614779	24530	GABA(A) receptor-associated protein-like 2
PA28484	2550	GABBR1	chr6	29567005	29610962	43957	gamma-aminobutyric acid (GABA) B receptor, 1
PA28896	9568	GABBR2	chr9	101047364	101481479	434115	gamma-aminobutyric acid (GABA) B receptor, 2
PA28485	2551	GABPA	chr21	27097258	27147771	50513	GA binding protein transcription factor, alpha subunit 60kDa
PA162389163	2553	GABPB1	chr15	50566389	50657605	91216	GA binding protein transcription factor, beta subunit 1
PA164741559	126626	GABPB2	chr1	151032784	151094007	61223	GA binding protein transcription factor, beta subunit 2
PA28489	2554	GABRA1	chr5	161264197	161329965	65768	gamma-aminobutyric acid (GABA) A receptor, alpha 1
PA28490	2555	GABRA2	chr4	46243470	46402056	158586	gamma-aminobutyric acid (GABA) A receptor, alpha 2
PA28491	2556	GABRA3	chrX	151331706	151629831	298125	gamma-aminobutyric acid (GABA) A receptor, alpha 3
PA28492	2557	GABRA4	chr4	46917917	47006424	88507	gamma-aminobutyric acid (GABA) A receptor, alpha 4
PA28493	2558	GABRA5	chr15	27101866	27197357	95491	gamma-aminobutyric acid (GABA) A receptor, alpha 5
PA28494	2559	GABRA6	chr5	161102658	161132598	29940	gamma-aminobutyric acid (GABA) A receptor, alpha 6
PA28495	2560	GABRB1	chr4	47023295	47435801	412506	gamma-aminobutyric acid (GABA) A receptor, beta 1
PA28496	2561	GABRB2	chr5	160712426	160985130	272704	gamma-aminobutyric acid (GABA) A receptor, beta 2
PA28497	2562	GABRB3	chr15	26785693	27028935	243242	gamma-aminobutyric acid (GABA) A receptor, beta 3
PA28498	2563	GABRD	chr1	1940768	1965192	24424	gamma-aminobutyric acid (GABA) A receptor, delta
PA28499	2564	GABRE	chrX	151118596	151153156	34560	gamma-aminobutyric acid (GABA) A receptor, epsilon
PA28500	2565	GABRG1	chr4	46034786	46136082	101296	gamma-aminobutyric acid (GABA) A receptor, gamma 1
PA28501	2566	GABRG2	chr5	161484648	161585545	100897	gamma-aminobutyric acid (GABA) A receptor, gamma 2
PA28502	2567	GABRG3	chr15	27206429	27781373	574944	gamma-aminobutyric acid (GABA) A receptor, gamma 3
PA28503	2568	GABRP	chr5	170200723	170244051	43328	gamma-aminobutyric acid (GABA) A receptor, pi
PA28504	55879	GABRQ	chrX	151796637	151824825	28188	gamma-aminobutyric acid (GABA) A receptor, theta
PA28505	2569	GABRR1	chr6	89884223	89951007	66784	gamma-aminobutyric acid (GABA) A receptor, rho 1
PA28506	2570	GABRR2	chr6	89963840	90035018	71178	gamma-aminobutyric acid (GABA) A receptor, rho 2
PA134952133	200959	GABRR3	chr3	97702527	97764148	61621	gamma-aminobutyric acid (GABA) A receptor, rho 3 (gene/pseudogene)
PA28507	2571	GAD1	chr2	171663200	171720661	57461	glutamate decarboxylase 1 (brain, 67kDa)
PA28508	2572	GAD2	chr10	26495236	26596491	101255	glutamate decarboxylase 2 (pancreatic islets and brain, 65kDa)
PA28510	1647	GADD45A	chr1	68140860	68157021	16161	growth arrest and DNA-damage-inducible, alpha
PA28511	4616	GADD45B	chr19	2466123	2481257	15134	growth arrest and DNA-damage-inducible, beta
PA28512	10912	GADD45G	chr9	92209913	92224470	14557	growth arrest and DNA-damage-inducible, gamma
PA134954784	90480	GADD45GIP1	chr19	13061970	13078068	16098	growth arrest and DNA-damage-inducible, gamma interacting protein 1
PA134944477	339896	GADL1	chr3	30764692	30946153	181461	glutamate decarboxylase-like 1
PA28513	2543	GAGE1	chrX	49353616	49376139	22523	G antigen 1
PA145148765	643832	GAGE10	chrX	49150125	49179311	29186	G antigen 10
PA145148770	729428	GAGE12B	chrX	49305928	49326189	20261	G antigen 12B
PA145148771	729422	GAGE12C	chrX	49286780	49307144	20364	G antigen 12C
PA145148773	100132399	GAGE12D	chrX	49296325	49316710	20385	G antigen 12D
PA145148775	729431	GAGE12E	chrX	49305892	49326252	20360	G antigen 12E
PA145148777	100008586	GAGE12F	chrX	49315416	49335811	20395	G antigen 12F
PA145148778	645073	GAGE12G	chrX	49325003	49345360	20357	G antigen 12G
PA145148780	729442	GAGE12H	chrX	49334552	49354907	20355	G antigen 12H
PA162389185	26748	GAGE12I	chrX	49206677	49226943	20266	G antigen 12I
PA162389200	729396	GAGE12J	chrX	49168516	49188866	20350	G antigen 12J
PA162389215	645051	GAGE13	chrX	49178094	49198366	20272	G antigen 13
PA162389230	729447	GAGE2A	chrX	49344118	49364430	20312	G antigen 2A
PA162389245	645037	GAGE2B	chrX	49225708	49245997	20289	G antigen 2B
PA162389260	2574	GAGE2C	chrX	49216171	49236491	20320	G antigen 2C
PA162389275	729408	GAGE2D	chrX	49197116	49217420	20304	G antigen 2D
PA162389276	26749	GAGE2E	chrX	49187607	49207923	20316	G antigen 2E
PA28516	2576	GAGE4	chrX	49093594	49113885	20291	G antigen 4
PA28517	2577	GAGE5	chrX	49093602	49113888	20286	G antigen 5
PA28518	2578	GAGE6	chrX	49202425	49222753	20328	G antigen 6
PA28519	2579	GAGE7	chrX	49093597	49113885	20288	G antigen 7
PA28521	100101629	GAGE8	chrX	49197161	49217421	20260	G antigen 8
PA28528	2580	GAK	chr4	840065	936174	96109	cyclin G associated kinase
PA28529	51083	GAL	chr11	68441983	68461643	19660	galanin/GMAP prepropeptide
PA134889661	9514	GAL3ST1	chr22	30947622	30980572	32950	galactose-3-O-sulfotransferase 1
PA134913637	64090	GAL3ST2	chr2	242706240	242746702	40462	galactose-3-O-sulfotransferase 2
PA134864180	89792	GAL3ST3	chr11	65805236	65826651	21415	galactose-3-O-sulfotransferase 3
PA134921067	79690	GAL3ST4	chr7	99753865	99776373	22508	galactose-3-O-sulfotransferase 4
PA28530	2581	GALC	chr14	88301164	88470009	168845	galactosylceramidase
PA28531	2582	GALE	chr1	24119089	24137294	18205	UDP-galactose-4-epimerase
PA28533	2584	GALK1	chr17	73751018	73771280	20262	galactokinase 1
PA28534	2585	GALK2	chr15	49437974	49662955	224981	galactokinase 2
PA134980075	130589	GALM	chr2	38883052	38964909	81857	galactose mutarotase (aldose 1-epimerase)
PA28535	2588	GALNS	chr16	88877142	88933374	56232	galactosamine (N-acetyl)-6-sulfatase
PA28536	2589	GALNT1	chr18	33197400	33294798	97398	polypeptide N-acetylgalactosaminyltransferase 1
PA134870832	55568	GALNT10	chr5	153560295	153803544	243249	polypeptide N-acetylgalactosaminyltransferase 10
PA134911149	63917	GALNT11	chr7	151712774	151822427	109653	polypeptide N-acetylgalactosaminyltransferase 11
PA134929192	79695	GALNT12	chr9	101559981	101615363	55382	polypeptide N-acetylgalactosaminyltransferase 12
PA134887166	114805	GALNT13	chr2	154718426	155313489	595063	polypeptide N-acetylgalactosaminyltransferase 13
PA134920089	79623	GALNT14	chr2	31130331	31371592	241261	polypeptide N-acetylgalactosaminyltransferase 14
PA134936170	117248	GALNT15	chr3	16206086	16289033	82947	polypeptide N-acetylgalactosaminyltransferase 15
PA134991608	57452	GALNT16	chr14	69716681	69824190	107509	polypeptide N-acetylgalactosaminyltransferase 16
PA134950929	374378	GALNT18	chr11	11289421	11653561	364140	polypeptide N-acetylgalactosaminyltransferase 18
PA28537	2590	GALNT2	chr1	230192956	230420875	227919	polypeptide N-acetylgalactosaminyltransferase 2
PA28538	2591	GALNT3	chr2	166601313	166660803	59490	polypeptide N-acetylgalactosaminyltransferase 3
PA28539	8693	GALNT4	chr12	89910189	89928583	18394	polypeptide N-acetylgalactosaminyltransferase 4
PA28540	11227	GALNT5	chr2	158104340	158170913	66573	polypeptide N-acetylgalactosaminyltransferase 5
PA28541	11226	GALNT6	chr12	51742654	51795739	53085	polypeptide N-acetylgalactosaminyltransferase 6
PA28542	51809	GALNT7	chr4	174079904	174248118	168214	polypeptide N-acetylgalactosaminyltransferase 7
PA28543	26290	GALNT8	chr12	4819752	4884892	65140	polypeptide N-acetylgalactosaminyltransferase 8
PA28544	50614	GALNT9	chr12	132821460	132915905	94445	polypeptide N-acetylgalactosaminyltransferase 9
PA134934705	168391	GALNTL5	chr7	151643464	151720019	76555	polypeptide N-acetylgalactosaminyltransferase-like 5
PA164720162	442117	GALNTL6	chr4	172724575	173964559	1239984	polypeptide N-acetylgalactosaminyltransferase-like 6
PA162389277	85569	GALP	chr19	56677389	56700144	22755	galanin-like peptide
PA28545	2587	GALR1	chr18	74952008	74985098	33090	galanin receptor 1
PA28546	8811	GALR2	chr17	74060892	74076573	15681	galanin receptor 2
PA28547	8484	GALR3	chr22	38209389	38224502	15113	galanin receptor 3
PA28548	2592	GALT	chr9	34636586	34653595	17009	galactose-1-phosphate uridylyltransferase
PA28549	2593	GAMT	chr19	1394025	1411569	17544	guanidinoacetate N-methyltransferase
PA28550	8139	GAN	chr16	81338571	81416803	78232	gigaxonin
PA28551	23193	GANAB	chr11	62389298	62424198	34900	glucosidase, alpha; neutral AB
PA28552	2595	GANC	chr15	42556366	42649599	93233	glucosidase, alpha; neutral C
PA28553	2596	GAP43	chr3	115332151	115443334	111183	growth associated protein 43
PA28554	2597	GAPDH	chr12	6633585	6650537	16952	glyceraldehyde-3-phosphate dehydrogenase
PA134934259	26330	GAPDHS	chr19	36014314	36039221	24907	glyceraldehyde-3-phosphate dehydrogenase, spermatogenic
PA164720193	202309	GAPT	chr5	57777262	57795185	17923	GRB2-binding adaptor protein, transmembrane
PA142671748	26130	GAPVD1	chr9	128014073	128130290	116217	GTPase activating protein and VPS9 domains 1
PA164720194	54433	GAR1	chr4	110726666	110748893	22227	GAR1 ribonucleoprotein
PA134888032	64762	GAREM	chr18	29840484	30060447	219963	GRB2 associated, regulator of MAPK1
PA142671865	150946	GAREML	chr2	26385960	26415532	29572	GRB2 associated, regulator of MAPK1-like
PA134861523	84253	GARNL3	chr9	129976750	130158828	182078	GTPase activating Rap/RanGAP domain-like 3
PA28575	2617	GARS	chr7	30624181	30676649	52468	glycyl-tRNA synthetase
PA28576	2618	GART	chr21	34873238	34925223	51985	phosphoribosylglycinamide formyltransferase, phosphoribosylglycinamide synthetase, phosphoribosylaminoimidazole synthetase
PA28578	2619	GAS1	chr9	89556277	89572104	15827	growth arrest-specific 1
PA28580	2620	GAS2	chr11	22678160	22837547	159387	growth arrest-specific 2
PA38195	10634	GAS2L1	chr22	29692985	29711778	18793	growth arrest-specific 2 like 1
PA134986846	246176	GAS2L2	chr17	34068530	34089897	21367	growth arrest-specific 2 like 2
PA134979032	283431	GAS2L3	chr12	100957446	101023657	66211	growth arrest-specific 2 like 3
PA28582	2621	GAS6	chr13	114520522	114577046	56524	growth arrest-specific 6
PA28583	8522	GAS7	chr17	9810926	10111868	300942	growth arrest-specific 7
PA28579	2622	GAS8	chr16	90076056	90114379	38323	growth arrest-specific 8
PA28577	2520	GAST	chr17	39858578	39875221	16643	gastrin
PA28584	2623	GATA1	chrX	48634982	48655718	20736	GATA binding protein 1 (globin transcription factor 1)
PA28585	2624	GATA2	chr3	128195265	128222030	26765	GATA binding protein 2
PA28586	2625	GATA3	chr10	8077294	8120164	42870	GATA binding protein 3
PA28587	2626	GATA4	chr8	11524433	11620510	96077	GATA binding protein 4
PA28588	140628	GATA5	chr20	61035553	61061026	25473	GATA binding protein 5
PA28589	2627	GATA6	chr18	19739404	19785491	46087	GATA binding protein 6
PA142671745	57798	GATAD1	chr7	92066762	92092381	25619	GATA zinc finger domain containing 1
PA142671746	54815	GATAD2A	chr19	19486642	19622741	136099	GATA zinc finger domain containing 2A
PA142671747	57459	GATAD2B	chr1	153774201	153905451	131250	GATA zinc finger domain containing 2B
PA33191	5188	GATB	chr4	152588808	152692175	103367	glutamyl-tRNA(Gln) amidotransferase, subunit B
PA162389278	283459	GATC	chr12	120874241	120904556	30315	glutamyl-tRNA(Gln) amidotransferase, subunit C
PA28590	2628	GATM	chr15	45650322	45680980	30658	glycine amidinotransferase (L-arginine:glycine amidinotransferase)
PA164720213	352954	GATS	chr7	99795276	99879855	84579	GATS, stromal antigen 3 opposite strand
PA164720214	389523	GATSL1	chr7	74412144	74441909	29765	GATS protein-like 1
PA164720237	729438	GATSL2	chr7	74804605	74877341	72736	GATS protein-like 2
PA164720260	652968	GATSL3	chr22	30678106	30695616	17510	GATS protein-like 3
PA28591	2629	GBA	chr1	155201239	155224653	23414	glucosidase, beta, acid
PA38773	57704	GBA2	chr9	35733863	35759925	26062	glucosidase, beta (bile acid) 2
PA134861643	57733	GBA3	chr4	22684537	22824198	139661	glucosidase, beta, acid 3 (gene/pseudogene)
PA28592	2630	GBAP1	chr1	155180616	155207325	26709	glucosidase, beta, acid pseudogene 1
PA28593	2631	GBAS	chr7	56022270	56070875	48605	glioblastoma amplified sequence
PA28594	2632	GBE1	chr3	81535850	81820950	285100	glucan (1,4-alpha-), branching enzyme 1
PA28595	8729	GBF1	chr10	103995255	104145656	150401	golgi brefeldin A resistant guanine nucleotide exchange factor 1
PA134967297	26301	GBGT1	chr9	136025335	136049320	23985	globoside alpha-1,3-N-acetylgalactosaminyltransferase 1
PA28596	2633	GBP1	chr1	89514987	89541043	26056	guanylate binding protein 1, interferon-inducible
PA28597	2634	GBP2	chr1	89568815	89601842	33027	guanylate binding protein 2, interferon-inducible
PA28598	2635	GBP3	chr1	89469360	89498556	29196	guanylate binding protein 3
PA134959399	115361	GBP4	chr1	89643831	89674633	30802	guanylate binding protein 4
PA134862968	115362	GBP5	chr1	89721633	89748544	26911	guanylate binding protein 5
PA134964409	163351	GBP6	chr1	89819436	89856719	37283	guanylate binding protein family, member 6
PA142671744	388646	GBP7	chr1	89594434	89651723	57289	guanylate binding protein 7
PA28599	2636	GBX1	chr7	150842676	150874867	32191	gastrulation brain homeobox 1
PA28600	2637	GBX2	chr2	237071307	237086652	15345	gastrulation brain homeobox 2
PA28601	2638	GC	chr4	72604410	72681237	76827	group-specific component (vitamin D binding protein)
PA28602	25801	GCA	chr2	163190583	163239525	48942	grancalcin, EF-hand calcium binding protein
PA28603	23464	GCAT	chr22	38193906	38216183	22277	glycine C-acetyltransferase
PA38796	79571	GCC1	chr7	127217682	127235654	17972	GRIP and coiled-coil domain containing 1
PA134876902	9648	GCC2	chr2	109055577	109128854	73277	GRIP and coiled-coil domain containing 2
PA28604	2639	GCDH	chr19	12991943	13013813	21870	glutaryl-CoA dehydrogenase
PA25892	6936	GCFC2	chr2	75886831	75948482	61651	GC-rich sequence DNA-binding factor 2
PA28606	2641	GCG	chr2	162996379	163018914	22535	glucagon
PA28607	2642	GCGR	chr17	79752010	79774889	22879	glucagon receptor
PA28608	2643	GCH1	chr14	55305723	55379603	73880	GTP cyclohydrolase 1
PA28609	2644	GCHFR	chr15	41046285	41062911	16626	GTP cyclohydrolase I feedback regulator
PA28610	2645	GCK	chr7	44180870	44239022	58152	glucokinase (hexokinase 4)
PA28611	2646	GCKR	chr2	27709470	27749556	40086	glucokinase (hexokinase 4) regulator
PA28612	2729	GCLC	chr6	53359139	53419927	60788	glutamate-cysteine ligase, catalytic subunit
PA28613	2730	GCLM	chr1	94349590	94385154	35564	glutamate-cysteine ligase, modifier subunit
PA28614	8521	GCM1	chr6	52988759	53023624	34865	glial cells missing homolog 1 (Drosophila)
PA28615	9247	GCM2	chr6	10870456	10892098	21642	glial cells missing homolog 2 (Drosophila)
PA28616	10985	GCN1L1	chr12	120562014	120642513	80499	GCN1 general control of amino-acid synthesis 1-like 1 (yeast)
PA168	2650	GCNT1	chr9	79024752	79125332	100580	glucosaminyl (N-acetyl) transferase 1, core 2
PA169	2651	GCNT2	chr6	10511542	10632601	121059	glucosaminyl (N-acetyl) transferase 2, I-branching enzyme (I blood group)
PA28620	9245	GCNT3	chr15	59893982	59915210	21228	glucosaminyl (N-acetyl) transferase 3, mucin type
PA143485475	51301	GCNT4	chr5	74320246	74360743	40497	glucosaminyl (N-acetyl) transferase 4, core 2
PA134945752	644378	GCNT6	chr6	10623993	10650501	26508	glucosaminyl (N-acetyl) transferase 6
PA162389279	140687	GCNT7	chr20	55063548	55110981	47433	glucosaminyl (N-acetyl) transferase family member 7
PA162389298	145781	GCOM1	chr15	57874102	58012755	138653	GRINL1A complex locus 1
PA134980592	257144	GCSAM	chr3	111836688	111862453	25765	germinal center-associated, signaling and motility
PA142672467	148823	GCSAML	chr1	247660417	247743990	83573	germinal center-associated, signaling and motility-like
PA28621	2653	GCSH	chr16	81112552	81139980	27428	glycine cleavage system protein H (aminomethyl carrier)
PA28625	9615	GDA	chr9	74719511	74870140	150629	guanine deaminase
PA28626	54332	GDAP1	chr8	75252618	75282345	29727	ganglioside induced differentiation associated protein 1
PA28627	78997	GDAP1L1	chr20	42865739	42912557	46818	ganglioside induced differentiation associated protein 1-like 1
PA28628	54834	GDAP2	chr1	118403107	118482302	79195	ganglioside induced differentiation associated protein 2
PA162389327	51573	GDE1	chr16	19510015	19543450	33435	glycerophosphodiester phosphodiesterase 1
PA28629	2657	GDF1	chr19	18976361	19016953	40592	growth differentiation factor 1
PA28630	2662	GDF10	chr10	48422785	48449138	26353	growth differentiation factor 10
PA28631	10220	GDF11	chr12	56127064	56149665	22601	growth differentiation factor 11
PA134866647	9518	GDF15	chr19	18486968	18502986	16018	growth differentiation factor 15
PA28632	2658	GDF2	chr10	48410092	48426853	16761	growth differentiation factor 2
PA28633	9573	GDF3	chr12	7839381	7858360	18979	growth differentiation factor 3
PA28635	8200	GDF5	chr20	34018149	34036027	17878	growth differentiation factor 5
PA28636	392255	GDF6	chr8	97151558	97183020	31462	growth differentiation factor 6
PA28637	151449	GDF7	chr2	20856424	20874250	17826	growth differentiation factor 7
PA28639	2661	GDF9	chr5	132193877	132212238	18361	growth differentiation factor 9
PA28641	2664	GDI1	chrX	153655259	153674814	19555	GDP dissociation inhibitor 1
PA28642	2665	GDI2	chr10	5804186	5865512	61326	GDP dissociation inhibitor 2
PA28644	2668	GDNF	chr5	37809779	37849782	40003	glial cell derived neurotrophic factor
PA134879258	284161	GDPD1	chr17	57287828	57356331	68503	glycerophosphodiester phosphodiesterase domain containing 1
PA134907263	54857	GDPD2	chrX	69632881	69656241	23360	glycerophosphodiester phosphodiesterase domain containing 2
PA142671741	79153	GDPD3	chr16	30112977	30135264	22287	glycerophosphodiester phosphodiesterase domain containing 3
PA142671742	220032	GDPD4	chr11	76924603	77022699	98096	glycerophosphodiester phosphodiesterase domain containing 4
PA142671743	81544	GDPD5	chr11	75142683	75246991	104308	glycerophosphodiester phosphodiesterase domain containing 5
PA162378247	390637	GDPGP1	chr15	90767487	90788312	20825	GDP-D-glucose phosphorylase 1
PA28645	2669	GEM	chr8	95258481	95284547	26066	GTP binding protein overexpressed in skeletal muscle
PA35784	8487	GEMIN2	chr14	39573488	39609177	35689	gem (nuclear organelle) associated protein 2
PA28646	50628	GEMIN4	chr17	644661	666038	21377	gem (nuclear organelle) associated protein 4
PA134945791	25929	GEMIN5	chr5	154263976	154327776	63800	gem (nuclear organelle) associated protein 5
PA134952855	79833	GEMIN6	chr2	38995327	39012598	17271	gem (nuclear organelle) associated protein 6
PA134959810	79760	GEMIN7	chr19	45569024	45597782	28758	gem (nuclear organelle) associated protein 7
PA162389344	54960	GEMIN8	chrX	14021845	14058035	36190	gem (nuclear organelle) associated protein 8
PA162389359	348654	GEN1	chr2	17925152	17969632	44480	GEN1 Holliday junction 5' flap endonuclease
PA165618100	51608	GET4	chr7	906191	939073	32882	golgi to ER traffic protein 4 homolog (S. cerevisiae)
PA28647	2670	GFAP	chr17	42979994	43002920	22926	glial fibrillary acidic protein
PA28648	2671	GFER	chr16	2024150	2040750	16600	growth factor, augmenter of liver regeneration
PA24344	2672	GFI1	chr1	92937318	92962433	25115	growth factor independent 1 transcription repressor
PA28649	8328	GFI1B	chr9	135810888	135870084	59196	growth factor independent 1B transcription repressor
PA134971637	85476	GFM1	chr3	158352286	158413361	61075	G elongation factor, mitochondrial 1
PA134949527	84340	GFM2	chr5	74014029	74073196	59167	G elongation factor, mitochondrial 2
PA128394667	54438	GFOD1	chr6	13360587	13497869	137282	glucose-fructose oxidoreductase domain containing 1
PA144596430	81577	GFOD2	chr16	67705436	67763273	57837	glucose-fructose oxidoreductase domain containing 2
PA28651	2673	GFPT1	chr2	69543901	69624386	80485	glutamine--fructose-6-phosphate transaminase 1
PA28652	9945	GFPT2	chr5	179724698	179790341	65643	glutamine-fructose-6-phosphate transaminase 2
PA28653	2674	GFRA1	chr10	117813436	118043126	229690	GDNF family receptor alpha 1
PA28654	2675	GFRA2	chr8	21546530	21682392	135862	GDNF family receptor alpha 2
PA28655	2676	GFRA3	chr5	137585069	137620544	35475	GDNF family receptor alpha 3
PA28656	64096	GFRA4	chr20	3636939	3654046	17107	GDNF family receptor alpha 4
PA145008357	389400	GFRAL	chr6	55182267	55270291	88024	GDNF family receptor alpha like
PA28657	26088	GGA1	chr22	37994481	38032571	38090	golgi-associated, gamma adaptin ear containing, ARF binding protein 1
PA28658	23062	GGA2	chr16	23471863	23531815	59952	golgi-associated, gamma adaptin ear containing, ARF binding protein 2
PA28659	23163	GGA3	chr17	73229694	73268444	38750	golgi-associated, gamma adaptin ear containing, ARF binding protein 3
PA164714645	87769	GGACT	chr13	101179418	101251046	71628	gamma-glutamylamine cyclotransferase
PA162389392	79017	GGCT	chr7	30533237	30554457	21220	gamma-glutamylcyclotransferase
PA28660	2677	GGCX	chr2	85768978	85798657	29679	gamma-glutamyl carboxylase
PA432	8836	GGH	chr8	63924638	63961610	36972	gamma-glutamyl hydrolase (conjugase, folylpolygammaglutamyl hydrolase)
PA134903452	199720	GGN	chr19	38871992	38889096	17104	gametogenetin
PA162389409	79893	GGNBP2	chr17	34890737	34949278	58541	gametogenetin binding protein 2
PA28661	9453	GGPS1	chr1	235481753	235510847	29094	geranylgeranyl diphosphate synthase 1
PA28662	2678	GGT1	chr22	24969629	25027972	58343	gamma-glutamyltransferase 1
PA28663	728441	GGT2	chr22	21559427	21589843	30416	gamma-glutamyltransferase 2
PA162389442	2687	GGT5	chr22	24612622	24651317	38695	gamma-glutamyltransferase 5
PA142671739	124975	GGT6	chr17	4457222	4473876	16654	gamma-glutamyltransferase 6
PA28669	2686	GGT7	chr20	33429523	33470661	41138	gamma-glutamyltransferase 7
PA28671	92086	GGTLC1	chr20	23962687	23979475	16788	gamma-glutamyltransferase light chain 1
PA162389523	91227	GGTLC2	chr22	22978782	22993368	14586	gamma-glutamyltransferase light chain 2
PA171	2688	GH1	chr17	61991560	62006206	14646	growth hormone 1
PA28672	2689	GH2	chr17	61954572	61970039	15467	growth hormone 2
PA147358034	84514	GHDC	chr17	40338105	40356550	18445	GH3 domain containing
PA28673	27069	GHITM	chr10	85889185	85916311	27126	growth hormone inducible transmembrane protein
PA28674	2690	GHR	chr5	42413577	42724980	311403	growth hormone receptor
PA28675	2691	GHRH	chr20	35876489	35897534	21045	growth hormone releasing hormone
PA28676	2692	GHRHR	chr7	30993636	31022146	28510	growth hormone releasing hormone receptor
PA142671740	51738	GHRL	chr3	10324434	10344631	20197	ghrelin/obestatin prepropeptide
PA28677	2693	GHSR	chr3	172158081	172176246	18165	growth hormone secretagogue receptor
PA134994398	79018	GID4	chr17	17932611	17974719	42108	GID complex subunit 4
PA25649	54994	GID8	chr20	61559421	61582827	23406	GID complex subunit 8
PA28678	2694	GIF	chr11	59593746	59622974	29228	gastric intrinsic factor (vitamin B synthesis)
PA162389554	64599	GIGYF1	chr7	100274130	100296870	22740	GRB10 interacting GYF protein 1
PA36647	26058	GIGYF2	chr2	233552015	233728287	176272	GRB10 interacting GYF protein 2
PA134978698	170575	GIMAP1	chr7	150403645	150424368	20723	GTPase, IMAP family member 1
PA134984698	26157	GIMAP2	chr7	150372690	150393729	21039	GTPase, IMAP family member 2
PA128394681	55303	GIMAP4	chr7	150254458	150274043	19585	GTPase, IMAP family member 4
PA29578	55340	GIMAP5	chr7	150424436	150443737	19301	GTPase, IMAP family member 5
PA128394720	474344	GIMAP6	chr7	150319463	150339736	20273	GTPase, IMAP family member 6
PA134915933	168537	GIMAP7	chr7	150201945	150221161	19216	GTPase, IMAP family member 7
PA128394762	155038	GIMAP8	chr7	150137748	150179483	41735	GTPase, IMAP family member 8
PA162389674	54826	GIN1	chr5	102418704	102465842	47138	gypsy retrotransposon integrase 1
PA134959041	116254	GINM1	chr6	149877528	149915067	37539	glycoprotein integral membrane 1
PA145008291	9837	GINS1	chr20	25378323	25432191	53868	GINS complex subunit 1 (Psf1 homolog)
PA145008313	51659	GINS2	chr16	85708280	85732588	24308	GINS complex subunit 2 (Psf2 homolog)
PA145008327	64785	GINS3	chr16	58416298	58443048	26750	GINS complex subunit 3 (Psf3 homolog)
PA145008337	84296	GINS4	chr8	41376725	41405565	28840	GINS complex subunit 4 (Sld5 homolog)
PA28681	2695	GIP	chr17	47032918	47055955	23037	gastric inhibitory polypeptide
PA34371	10755	GIPC1	chr19	14585571	14616961	31390	GIPC PDZ domain containing family, member 1
PA142671735	54810	GIPC2	chr1	78500646	78607129	106483	GIPC PDZ domain containing family, member 2
PA142671736	126326	GIPC3	chr19	3575557	3596539	20982	GIPC PDZ domain containing family, member 3
PA28682	2696	GIPR	chr19	46161490	46188717	27227	gastric inhibitory polypeptide receptor
PA28683	28964	GIT1	chr17	27897487	27926610	29123	G protein-coupled receptor kinase interacting ArfGAP 1
PA28684	9815	GIT2	chr12	110364607	110444194	79587	G protein-coupled receptor kinase interacting ArfGAP 2
PA28685	2697	GJA1	chr6	121746745	121773873	27128	gap junction protein, alpha 1, 43kDa
PA164741581	84694	GJA10	chr6	90594188	90608819	14631	gap junction protein, alpha 10, 62kDa
PA28688	2700	GJA3	chr13	20709394	20745524	36130	gap junction protein, alpha 3, 46kDa
PA28689	2701	GJA4	chr1	35248559	35264351	15792	gap junction protein, alpha 4, 37kDa
PA28690	2702	GJA5	chr1	147225332	147263165	37833	gap junction protein, alpha 5, 40kDa
PA28692	2703	GJA8	chr1	147364946	147384396	19450	gap junction protein, alpha 8, 50kDa
PA164741587	81025	GJA9	chr1	39336739	39357298	20559	gap junction protein, alpha 9, 59kDa
PA28694	2705	GJB1	chrX	70425062	70448065	23003	gap junction protein, beta 1, 32kDa
PA28695	2706	GJB2	chr13	20758602	20778605	20003	gap junction protein, beta 2, 26kDa
PA28696	2707	GJB3	chr1	35236790	35254967	18177	gap junction protein, beta 3, 31kDa
PA28697	127534	GJB4	chr1	35215342	35232325	16983	gap junction protein, beta 4, 30.3kDa
PA28698	2709	GJB5	chr1	35210648	35227113	16465	gap junction protein, beta 5, 31.1kDa
PA28699	10804	GJB6	chr13	20793101	20816534	23433	gap junction protein, beta 6, 30kDa
PA134949515	375519	GJB7	chr6	87989696	88048996	59300	gap junction protein, beta 7, 25kDa
PA164741588	10052	GJC1	chr17	42872816	42918179	45363	gap junction protein, gamma 1, 45kDa
PA162389696	57165	GJC2	chr1	228327415	228350527	23112	gap junction protein, gamma 2, 47kDa
PA162389705	349149	GJC3	chr7	99517892	99541833	23941	gap junction protein, gamma 3, 30.2kDa
PA162389706	57369	GJD2	chr15	35041642	35056782	15140	gap junction protein, delta 2, 36kDa
PA162389714	219770	GJD4	chr10	35884338	35900863	16525	gap junction protein, delta 4, 40.1kDa
PA28700	2710	GK	chrX	30661476	30752579	91103	glycerol kinase
PA28702	2712	GK2	chr4	80324507	80339372	14865	glycerol kinase 2
PA162389723	256356	GK5	chr3	141873369	141954449	81080	glycerol kinase 5 (putative)
PA134880503	80318	GKAP1	chr9	86351336	86454431	103095	G kinase anchoring protein 1
PA134898851	56287	GKN1	chr2	69191705	69211112	19407	gastrokine 1
PA162389760	200504	GKN2	chr2	69169364	69190102	20738	gastrokine 2
PA28707	2717	GLA	chrX	100649779	100673001	23222	galactosidase, alpha
PA28709	2720	GLB1	chr3	33035100	33148694	113594	galactosidase, beta 1
PA134885559	79411	GLB1L	chr2	220098331	220120155	21824	galactosidase, beta 1-like
PA162389761	89944	GLB1L2	chr11	134191768	134249222	57454	galactosidase, beta 1-like 2
PA145148764	112937	GLB1L3	chr11	134135293	134192458	57165	galactosidase, beta 1-like 3
PA38657	113263	GLCCI1	chr7	7998374	8131710	133336	glucocorticoid induced transcript 1
PA145148750	26035	GLCE	chr15	69442921	69567546	124625	glucuronic acid epimerase
PA28716	2731	GLDC	chr9	6529464	6655692	126228	glycine dehydrogenase (decarboxylating)
PA134882405	342035	GLDN	chr15	51623713	51703210	79497	gliomedin
PA28718	2733	GLE1	chr9	131256971	131307580	50609	GLE1 RNA export mediator
PA28719	2734	GLG1	chr16	74478325	74651042	172717	golgi glycoprotein 1
PA28720	2735	GLI1	chr12	57843918	57869051	25133	GLI family zinc finger 1
PA28721	2736	GLI2	chr2	121483441	121753229	269788	GLI family zinc finger 2
PA28722	2737	GLI3	chr7	41997547	42287469	289922	GLI family zinc finger 3
PA28723	2738	GLI4	chr8	144323524	144362101	38577	GLI family zinc finger 4
PA134988403	11010	GLIPR1	chr12	75864513	75898716	34203	GLI pathogenesis-related 1
PA145008265	256710	GLIPR1L1	chr12	75717550	75767170	49620	GLI pathogenesis-related 1 like 1
PA145008279	144321	GLIPR1L2	chr12	75774850	75829468	54618	GLI pathogenesis-related 1 like 2
PA164720283	152007	GLIPR2	chr9	36126730	36166910	40180	GLI pathogenesis-related 2
PA134948186	148979	GLIS1	chr1	53968904	54213748	244844	GLIS family zinc finger 1
PA134919876	84662	GLIS2	chr16	4356240	4392598	36358	GLIS family zinc finger 2
PA134878768	169792	GLIS3	chr9	3821128	4310036	488908	GLIS family zinc finger 3
PA134870088	11146	GLMN	chr1	92708955	92774566	65611	glomulin, FKBP associated protein
PA28724	2739	GLO1	chr6	38640701	38680952	40251	glyoxalase I
PA162389795	51031	GLOD4	chr17	659549	695571	36022	glyoxalase domain containing 4
PA162389818	392465	GLOD5	chrX	48610154	48635064	24910	glyoxalase domain containing 5
PA28725	2740	GLP1R	chr6	39006557	39059657	53100	glucagon-like peptide 1 receptor
PA28726	9340	GLP2R	chr17	9719152	9797269	78117	glucagon-like peptide 2 receptor
PA28727	2741	GLRA1	chr5	151199074	151314397	115323	glycine receptor, alpha 1
PA28728	2742	GLRA2	chrX	14537420	14752934	215514	glycine receptor, alpha 2
PA28729	8001	GLRA3	chr4	175542367	175760465	218098	glycine receptor, alpha 3
PA142671731	441509	GLRA4	chrX	102959272	102993552	34280	glycine receptor, alpha 4
PA28730	2743	GLRB	chr4	157987277	158096251	108974	glycine receptor, beta
PA28731	2745	GLRX	chr5	95146553	95168577	22024	glutaredoxin (thioltransferase)
PA28732	51022	GLRX2	chr1	193062595	193085659	23064	glutaredoxin 2
PA162389829	10539	GLRX3	chr10	131924639	131981646	57007	glutaredoxin 3
PA134992547	51218	GLRX5	chr14	95991323	96014055	22732	glutaredoxin 5
PA162389830	100132510	GLRXP3	chr5	161174462	161188843	14381	glutaredoxin (thioltransferase) pseudogene 3
PA28734	2744	GLS	chr2	191735547	191833278	97731	glutaminase
PA134933506	27165	GLS2	chr12	56861728	56892198	30470	glutaminase 2 (liver, mitochondrial)
PA128394758	144423	GLT1D1	chr12	129327985	129472513	144528	glycosyltransferase 1 domain containing 1
PA134906610	360203	GLT6D1	chr9	138512502	138541386	28884	glycosyltransferase 6 domain containing 1
PA134947079	55830	GLT8D1	chr3	52725500	52750099	24599	glycosyltransferase 8 domain containing 1
PA134939919	83468	GLT8D2	chr12	104379762	104467961	88199	glycosyltransferase 8 domain containing 2
PA142671729	51228	GLTP	chr12	110285748	110328293	42545	glycolipid transfer protein
PA162389864	388323	GLTPD2	chr17	4681723	4696887	15164	glycolipid transfer protein domain containing 2
PA28735	29998	GLTSCR1	chr19	48101453	48209534	108081	glioma tumor suppressor candidate region gene 1
PA134964468	23506	GLTSCR1L	chr6	42739790	42839296	99506	GLTSCR1-like
PA28736	29997	GLTSCR2	chr19	48238793	48263323	24530	glioma tumor suppressor candidate region gene 2
PA28737	2746	GLUD1	chr10	88806959	88864776	57817	glutamate dehydrogenase 1
PA28738	2747	GLUD2	chrX	120171462	120186796	15334	glutamate dehydrogenase 2
PA28743	2752	GLUL	chr1	182347839	182371341	23502	glutamate-ammonia ligase
PA28748	10249	GLYAT	chr11	58473230	58509447	36217	glycine-N-acyltransferase
PA142671727	92292	GLYATL1	chr11	58685102	58727543	42441	glycine-N-acyltransferase-like 1
PA142671728	219970	GLYATL2	chr11	58598538	58621997	23459	glycine-N-acyltransferase-like 2
PA165617919	389396	GLYATL3	chr6	49457671	49498777	41106	glycine-N-acyltransferase-like 3
PA162389865	132158	GLYCTK	chr3	52311836	52332272	20436	glycerate kinase
PA165450093	84656	GLYR1	chr16	4850204	4907383	57179	glyoxylate reductase 1 homolog (Arabidopsis)
PA28752	2760	GM2A	chr5	150622613	150653083	30470	GM2 ganglioside activator
PA143485477	64395	GMCL1	chr2	70046818	70109727	62909	germ cell-less, spermatogenesis associated 1
PA28754	2762	GMDS	chr6	1621035	2255868	634833	GDP-mannose 4,6-dehydratase
PA28755	10691	GMEB1	chr1	28985234	29045115	59881	glucocorticoid modulatory element binding protein 1
PA28756	26205	GMEB2	chr20	62215955	62268381	52426	glucocorticoid modulatory element binding protein 2
PA28758	2764	GMFB	chr14	54938202	54965785	27583	glia maturation factor, beta
PA28759	9535	GMFG	chr19	39815999	39836726	20727	glia maturation factor, gamma
PA134963566	51291	GMIP	chr19	19737285	19764457	27172	GEM interacting protein
PA28760	2765	GML	chr8	143906217	143931262	25045	glycosylphosphatidylinositol anchored molecule like
PA38455	51053	GMNN	chr6	24765159	24789327	24168	geminin, DNA replication inhibitor
PA134925506	29926	GMPPA	chr2	220353587	220374718	21131	GDP-mannose pyrophosphorylase A
PA134875590	29925	GMPPB	chr3	49755909	49771407	15498	GDP-mannose pyrophosphorylase B
PA28761	2766	GMPR	chr6	16228811	16298780	69969	guanosine monophosphate reductase
PA28762	51292	GMPR2	chr14	24691633	24711448	19815	guanosine monophosphate reductase 2
PA28763	8833	GMPS	chr3	155578325	155660150	81825	guanine monphosphate synthase
PA28764	2767	GNA11	chr19	3084408	3124468	40060	guanine nucleotide binding protein (G protein), alpha 11 (Gq class)
PA28765	2768	GNA12	chr7	2764739	2893963	129224	guanine nucleotide binding protein (G protein) alpha 12
PA28766	10672	GNA13	chr17	63002407	63062920	60513	guanine nucleotide binding protein (G protein), alpha 13
PA28767	9630	GNA14	chr9	80034995	80273232	238237	guanine nucleotide binding protein (G protein), alpha 14
PA28768	2769	GNA15	chr19	3126191	3166766	40575	guanine nucleotide binding protein (G protein), alpha 15 (Gq class)
PA172	2770	GNAI1	chr7	79754140	79851725	97585	guanine nucleotide binding protein (G protein), alpha inhibiting activity polypeptide 1
PA24347	2771	GNAI2	chr3	50254120	50299786	45666	guanine nucleotide binding protein (G protein), alpha inhibiting activity polypeptide 2
PA173	2773	GNAI3	chr1	110081186	110141465	60279	guanine nucleotide binding protein (G protein), alpha inhibiting activity polypeptide 3
PA28770	2774	GNAL	chr18	11679014	11888684	209670	guanine nucleotide binding protein (G protein), alpha activating activity polypeptide, olfactory type
PA28771	2775	GNAO1	chr16	56215251	56394356	179105	guanine nucleotide binding protein (G protein), alpha activating activity polypeptide O
PA174	2776	GNAQ	chr9	80332189	80656219	324030	guanine nucleotide binding protein (G protein), q polypeptide
PA175	2778	GNAS	chr20	57404756	57489250	84494	GNAS complex locus
PA28773	2779	GNAT1	chr3	50219043	50238129	19086	guanine nucleotide binding protein (G protein), alpha transducing activity polypeptide 1
PA28774	2780	GNAT2	chr1	110142889	110165705	22816	guanine nucleotide binding protein (G protein), alpha transducing activity polypeptide 2
PA134931156	346562	GNAT3	chr7	80084987	80151242	66255	guanine nucleotide binding protein, alpha transducing 3
PA28775	2781	GNAZ	chr22	23402669	23470224	67555	guanine nucleotide binding protein (G protein), alpha z polypeptide
PA28776	2782	GNB1	chr1	1713725	1832552	118827	guanine nucleotide binding protein (G protein), beta polypeptide 1
PA28777	54584	GNB1L	chr22	19772932	19852462	79530	guanine nucleotide binding protein (G protein), beta polypeptide 1-like
PA28778	2783	GNB2	chr7	100261363	100279792	18429	guanine nucleotide binding protein (G protein), beta polypeptide 2
PA28779	10399	GNB2L1	chr5	180660928	180681209	20281	guanine nucleotide binding protein (G protein), beta polypeptide 2-like 1
PA176	2784	GNB3	chr12	6939375	6959564	20189	guanine nucleotide binding protein (G protein), beta polypeptide 3
PA134864200	59345	GNB4	chr3	179110876	179179371	68495	guanine nucleotide binding protein (G protein), beta polypeptide 4
PA28780	10681	GNB5	chr15	52410123	52493565	83442	guanine nucleotide binding protein (G protein), beta 5
PA134987566	10020	GNE	chr9	36211438	36287053	75615	glucosamine (UDP-N-acetyl)-2-epimerase/N-acetylmannosamine kinase
PA28781	2790	GNG10	chr9	114413851	114435526	21675	guanine nucleotide binding protein (G protein), gamma 10
PA28782	2791	GNG11	chr7	93541016	93558826	17810	guanine nucleotide binding protein (G protein), gamma 11
PA134956700	55970	GNG12	chr1	68164149	68309436	145287	guanine nucleotide binding protein (G protein), gamma 12
PA28783	51764	GNG13	chr16	845041	860733	15692	guanine nucleotide binding protein (G protein), gamma 13
PA28784	54331	GNG2	chr14	52317022	52439518	122496	guanine nucleotide binding protein (G protein), gamma 2
PA28785	2785	GNG3	chr11	62465066	62479678	14612	guanine nucleotide binding protein (G protein), gamma 3
PA28786	2786	GNG4	chr1	235707985	235824054	116069	guanine nucleotide binding protein (G protein), gamma 4
PA28787	2787	GNG5	chr1	84961006	84982262	21256	guanine nucleotide binding protein (G protein), gamma 5
PA28789	2788	GNG7	chr19	2508218	2712746	204528	guanine nucleotide binding protein (G protein), gamma 7
PA134921496	94235	GNG8	chr19	47134333	47147939	13606	guanine nucleotide binding protein (G protein), gamma 8
PA28790	2792	GNGT1	chr7	93525820	93543485	17665	guanine nucleotide binding protein (G protein), gamma transducing activity polypeptide 1
PA28791	2793	GNGT2	chr17	47280596	47297936	17340	guanine nucleotide binding protein (G protein), gamma transducing activity polypeptide 2
PA28792	2794	GNL1	chr6	30506154	30535371	29217	guanine nucleotide binding protein-like 1
PA134944852	29889	GNL2	chr1	38029413	38071586	42173	guanine nucleotide binding protein-like 2 (nucleolar)
PA134952132	26354	GNL3	chr3	52709936	52731513	21577	guanine nucleotide binding protein-like 3 (nucleolar)
PA134922876	54552	GNL3L	chrX	54546644	54596720	50076	guanine nucleotide binding protein-like 3 (nucleolar)-like
PA28793	10578	GNLY	chr2	85911414	85928967	17553	granulysin
PA28794	27232	GNMT	chr6	42918500	42934618	16118	glycine N-methyltransferase
PA28795	8443	GNPAT	chr1	231366919	231416719	49800	glyceronephosphate O-acyltransferase
PA28796	10007	GNPDA1	chr5	141377234	141402620	25386	glucosamine-6-phosphate deaminase 1
PA134939177	132789	GNPDA2	chr4	44691190	44738651	47461	glucosamine-6-phosphate deaminase 2
PA134901326	64841	GNPNAT1	chr14	53238911	53268386	29475	glucosamine-phosphate N-acetyltransferase 1
PA128394710	79158	GNPTAB	chr12	102136275	102234645	98370	N-acetylglucosamine-1-phosphate transferase, alpha and beta subunits
PA134990433	84572	GNPTG	chr16	1391900	1416352	24452	N-acetylglucosamine-1-phosphate transferase, gamma subunit
PA28798	2796	GNRH1	chr8	25273774	25292556	18782	gonadotropin-releasing hormone 1 (luteinizing-releasing hormone)
PA28799	2797	GNRH2	chr20	3014268	3029391	15123	gonadotropin-releasing hormone 2
PA28800	2798	GNRHR	chr4	68600093	68631804	31711	gonadotropin-releasing hormone receptor
PA28802	2799	GNS	chr12	65104222	65163226	59004	glucosamine (N-acetyl)-6-sulfatase
PA28804	2800	GOLGA1	chr9	127637573	127713386	75813	golgin A1
PA28805	2801	GOLGA2	chr9	131015108	131048286	33178	golgin A2
PA28806	84559	GOLGA2P2Y	chrY	26353114	26370978	17864	golgin A2 pseudogene 2, Y-linked
PA142671725	401634	GOLGA2P3Y	chrY	27591458	27609322	17864	golgin A2 pseudogene 3, Y-linked
PA165512779	55592	GOLGA2P5	chr12	100547169	100577121	29952	golgin A2 pseudogene 5
PA28807	2802	GOLGA3	chr12	133342495	133415659	73164	golgin A3
PA28808	2803	GOLGA4	chr3	37274682	37411370	136688	golgin A4
PA28809	9950	GOLGA5	chr14	93250576	93309308	58732	golgin A5
PA38364	342096	GOLGA6A	chr15	74359198	74384891	25693	golgin A6 family, member A
PA162389878	55889	GOLGA6B	chr15	72937038	72962738	25700	golgin A6 family, member B
PA162389919	653641	GOLGA6C	chr15	75540899	75568796	27897	golgin A6 family, member C
PA162389960	653643	GOLGA6D	chr15	75565182	75591148	25966	golgin A6 family, member D
PA165478683	283767	GOLGA6L1	chr15	22726246	22749002	22756	golgin A6 family-like 1
PA165478685	647042	GOLGA6L10	chr15	82629347	82651706	22359	golgin A6 family-like 10
PA165478787	100133220	GOLGA6L3	chr15	85773641	85793401	19760	golgin A6 family-like 3
PA165478846	727832	GOLGA6L6	chr15	20734094	20757114	23020	golgin A6 family-like 6
PA165478891	440295	GOLGA6L9	chr15	82699883	82734587	34704	golgin A6 family-like 9
PA134991547	51125	GOLGA7	chr8	41338081	41371499	33418	golgin A7
PA164720284	401647	GOLGA7B	chr10	99599995	99634335	34340	golgin A7 family, member B
PA142671716	23015	GOLGA8A	chr15	34668269	34739667	71398	golgin A8 family, member A
PA142671717	440270	GOLGA8B	chr15	34814296	34885836	71540	golgin A8 family, member B
PA165478923	728498	GOLGA8H	chr15	30886233	30909859	23626	golgin A8 family, member H
PA165478975	653073	GOLGA8J	chr15	30365158	30388702	23544	golgin A8 family, member J
PA28810	2804	GOLGB1	chr3	121379046	121478662	99616	golgin B1
PA162390001	27333	GOLIM4	chr3	167723457	167823712	100255	golgi integral membrane protein 4
PA28811	51280	GOLM1	chr9	88626018	88725116	99098	golgi membrane protein 1
PA28812	64083	GOLPH3	chr5	32121817	32184425	62608	golgi phosphoprotein 3 (coat-protein)
PA134922683	55204	GOLPH3L	chr1	150615701	150679672	63971	golgi phosphoprotein 3-like
PA134874119	127845	GOLT1A	chr1	204164288	204193220	28932	golgi transport 1A
PA134898810	51026	GOLT1B	chr12	21644699	21674337	29638	golgi transport 1B
PA142671723	54856	GON4L	chr1	155716450	155839185	122735	gon-4-like (C. elegans)
PA134904944	57120	GOPC	chr6	117878432	117933705	55273	golgi-associated PDZ and coiled-coil motif containing
PA164720285	92344	GORAB	chr1	170491263	170525974	34711	golgin, RAB6-interacting
PA28814	64689	GORASP1	chr3	39135090	39159854	24764	golgi reassembly stacking protein 1, 65kDa
PA38457	26003	GORASP2	chr2	171774948	171826645	51697	golgi reassembly stacking protein 2, 55kDa
PA28815	9527	GOSR1	chr17	28794426	28856832	62406	golgi SNAP receptor complex member 1
PA28816	9570	GOSR2	chr17	44990486	45047366	56880	golgi SNAP receptor complex member 2
PA28817	2805	GOT1	chr10	101153627	101200530	46903	glutamic-oxaloacetic transaminase 1, soluble
PA142671724	137362	GOT1L1	chr8	37788799	37807664	18865	glutamic-oxaloacetic transaminase 1-like 1
PA28818	2806	GOT2	chr16	58738035	58778246	40211	glutamic-oxaloacetic transaminase 2, mitochondrial
PA178	2811	GP1BA	chr17	4825312	4841325	16013	glycoprotein Ib (platelet), alpha polypeptide
PA179	2812	GP1BB	chr22	19701066	19715297	14231	glycoprotein Ib (platelet), beta polypeptide
PA28822	2813	GP2	chr16	20317896	20349684	31788	glycoprotein 2 (zymogen granule membrane)
PA28823	2814	GP5	chr3	194112550	194129995	17445	glycoprotein V (platelet)
PA28824	51206	GP6	chr19	55522073	55559632	37559	glycoprotein VI (platelet)
PA28825	2815	GP9	chr3	128765459	128784254	18795	glycoprotein IX (platelet)
PA28826	10223	GPA33	chr1	167019082	167069868	50786	glycoprotein A33 (transmembrane)
PA28827	8733	GPAA1	chr8	145127064	145144119	17055	glycosylphosphatidylinositol anchor attachment 1
PA134943194	55425	GPALPP1	chr13	45553687	45605405	51718	GPALPP motifs containing 1
PA134983031	57678	GPAM	chr10	113904971	113985153	80182	glycerol-3-phosphate acyltransferase, mitochondrial
PA25265	7918	GPANK1	chr6	31626006	31644060	18054	G patch domain and ankyrin repeats 1
PA165696677	150763	GPAT2	chr2	96684694	96711722	27028	glycerol-3-phosphate acyltransferase 2, mitochondrial
PA162390063	55094	GPATCH1	chr19	33561786	33624318	62532	G patch domain containing 1
PA143485427	253635	GPATCH11	chr2	37301594	37329387	27793	G patch domain containing 11
PA162390064	55105	GPATCH2	chr1	217600834	217814426	213592	G patch domain containing 2
PA134963976	55668	GPATCH2L	chr14	76608255	76674239	65984	G patch domain containing 2-like
PA162390065	63906	GPATCH3	chr1	27213979	27236962	22983	G patch domain containing 3
PA162390084	54865	GPATCH4	chr1	156561100	156581288	20188	G patch domain containing 4
PA162390105	23131	GPATCH8	chr17	42469645	42590957	121312	G patch domain containing 8
PA134903170	151306	GPBAR1	chr2	219115738	219131582	15844	G protein-coupled bile acid receptor 1
PA142671714	65056	GPBP1	chr5	56459676	56563506	103830	GC-rich promoter binding protein 1
PA142671715	60313	GPBP1L1	chr1	46089976	46163782	73806	GC-rich promoter binding protein 1-like 1
PA28830	2817	GPC1	chr2	241365115	241410495	45380	glypican 1
PA28831	221914	GPC2	chr7	99764229	99784990	20761	glypican 2
PA28832	2719	GPC3	chrX	132666773	133129673	462900	glypican 3
PA28833	2239	GPC4	chrX	132430815	132559205	128390	glypican 4
PA28834	2262	GPC5	chr13	92040935	93522490	1481555	glypican 5
PA28835	10082	GPC6	chr13	93869078	95063274	1194196	glypican 6
PA165392351	56261	GPCPD1	chr20	5522080	5601672	79592	glycerophosphocholine phosphodiesterase GDE1 homolog (S. cerevisiae)
PA28836	2819	GPD1	chr12	50487602	50508103	20501	glycerol-3-phosphate dehydrogenase 1 (soluble)
PA134986345	23171	GPD1L	chr3	32138003	32213207	75204	glycerol-3-phosphate dehydrogenase 1-like
PA28837	2820	GPD2	chr2	157281965	157445915	163950	glycerol-3-phosphate dehydrogenase 2 (mitochondrial)
PA28873	2852	GPER1	chr7	1116443	1136451	20008	G protein-coupled estrogen receptor 1
PA28839	170589	GPHA2	chr11	64698943	64713360	14417	glycoprotein hormone alpha 2
PA28840	10243	GPHN	chr14	66964125	67651525	687400	gephyrin
PA28841	2821	GPI	chr19	34845645	34896318	50673	glucose-6-phosphate isomerase
PA162390135	338328	GPIHBP1	chr8	144285068	144302044	16976	glycosylphosphatidylinositol anchored high density lipoprotein binding protein 1
PA134956055	27238	GPKOW	chrX	48966022	48990079	24057	G patch domain and KOW motifs
PA28842	2822	GPLD1	chr6	24423060	24505433	82373	glycosylphosphatidylinositol specific phospholipase D1
PA28843	2823	GPM6A	chr4	176551088	176933842	382754	glycoprotein M6A
PA28844	2824	GPM6B	chrX	13786062	13966861	180799	glycoprotein M6B
PA162390148	11321	GPN1	chr2	27841515	27876713	35198	GPN-loop GTPase 1
PA162390149	54707	GPN2	chr1	27202872	27226869	23997	GPN-loop GTPase 2
PA162390164	51184	GPN3	chr12	110887291	110916667	29376	GPN-loop GTPase 3
PA28845	10457	GPNMB	chr7	23276305	23317729	41424	glycoprotein (transmembrane) nmb
PA28846	2825	GPR1	chr2	207037040	207092771	55731	G protein-coupled receptor 1
PA28849	83550	GPR101	chrX	136109307	136123833	14526	G protein-coupled receptor 101
PA28854	57720	GPR107	chr9	132805985	132905448	99463	G protein-coupled receptor 107
PA28855	56927	GPR108	chr19	6726925	6747633	20708	G protein-coupled receptor 108
PA128394769	266977	GPR110	chr6	46964116	47020082	55966	G protein-coupled receptor 110
PA134984088	222611	GPR111	chr6	47614223	47668533	54310	G protein-coupled receptor 111
PA134885132	139378	GPR112	chrX	135373122	135502047	128925	G protein-coupled receptor 112
PA134918027	165082	GPR113	chr2	26528041	26579685	51644	G protein-coupled receptor 113
PA134896363	221188	GPR114	chr16	57566333	57614101	47768	G protein-coupled receptor 114
PA134954617	221393	GPR115	chr6	47656289	47692757	36468	G protein-coupled receptor 115
PA134886165	221395	GPR116	chr6	46817242	46932681	115439	G protein-coupled receptor 116
PA134928131	139760	GPR119	chrX	129515319	129529511	14192	G protein-coupled receptor 119
PA28856	2835	GPR12	chr13	27326337	27344922	18585	G protein-coupled receptor 12
PA134910893	84435	GPR123	chr10	134874433	134948179	73746	G protein-coupled receptor 123
PA134869404	25960	GPR124	chr8	37644401	37704504	60103	G protein-coupled receptor 124
PA134919579	166647	GPR125	chr4	22385997	22527677	141680	G protein-coupled receptor 125
PA134878328	57211	GPR126	chr6	142613056	142770403	157347	G protein-coupled receptor 126
PA134982718	84873	GPR128	chr3	100318433	100417323	98890	G protein-coupled receptor 128
PA134940832	29933	GPR132	chr14	105512726	105541887	29161	G protein-coupled receptor 132
PA134923933	283383	GPR133	chr12	131428452	131629010	200558	G protein-coupled receptor 133
PA134863427	64582	GPR135	chr14	59927240	59942059	14819	G protein-coupled receptor 135
PA143485482	56834	GPR137	chr11	64041781	64059972	18191	G protein-coupled receptor 137
PA36563	7107	GPR137B	chr1	236295832	236418314	122482	G protein-coupled receptor 137B
PA143485483	283554	GPR137C	chr14	53009866	53107431	97565	G protein-coupled receptor 137C
PA134970866	124274	GPR139	chr16	20039981	20095100	55119	G protein-coupled receptor 139
PA134923895	353345	GPR141	chr7	37560212	37784888	224676	G protein-coupled receptor 141
PA134891802	350383	GPR142	chr17	72353532	72372104	18572	G protein-coupled receptor 142
PA31872	4935	GPR143	chrX	9690453	9744005	53552	G protein-coupled receptor 143
PA134882616	347088	GPR144	chr9	127203423	127242379	38956	G protein-coupled receptor 144
PA134958088	115330	GPR146	chr7	1074218	1101905	27687	G protein-coupled receptor 146
PA134942667	344561	GPR148	chr2	131476643	131490909	14266	G protein-coupled receptor 148
PA134981369	344758	GPR149	chr3	154052461	154157504	105043	G protein-coupled receptor 149
PA28858	2838	GPR15	chr3	98240743	98254994	14251	G protein-coupled receptor 15
PA134984082	285601	GPR150	chr5	94945980	94960284	14304	G protein-coupled receptor 150
PA134975199	134391	GPR151	chr5	145891417	145905676	14259	G protein-coupled receptor 151
PA134897297	390212	GPR152	chr11	67215772	67230200	14428	G protein-coupled receptor 152
PA134929175	387509	GPR153	chr1	6304406	6331035	26629	G protein-coupled receptor 153
PA134943679	151556	GPR155	chr2	175293299	175361816	68517	G protein-coupled receptor 155
PA134918005	165829	GPR156	chr3	119881328	120013921	132593	G protein-coupled receptor 156
PA134876230	80045	GPR157	chr1	9160472	9199229	38757	G protein-coupled receptor 157
PA134939018	57512	GPR158	chr10	25454290	25894158	439868	G protein-coupled receptor 158
PA134936972	26996	GPR160	chr3	169745735	169806184	60449	G protein-coupled receptor 160
PA134931474	23432	GPR161	chr1	168045780	168116905	71125	G protein-coupled receptor 161
PA142671713	27239	GPR162	chr12	6920963	6939583	18620	G protein-coupled receptor 162
PA28859	2840	GPR17	chr2	128393439	128413213	19774	G protein-coupled receptor 17
PA134948560	29909	GPR171	chr3	150912537	150930997	18460	G protein-coupled receptor 171
PA134896710	54328	GPR173	chrX	53068506	53112797	44291	G protein-coupled receptor 173
PA134971573	84636	GPR174	chrX	78390512	78433815	43303	G protein-coupled receptor 174
PA142671712	11245	GPR176	chr15	40088223	40223093	134870	G protein-coupled receptor 176
PA134900696	440435	GPR179	chr17	36478493	36509693	31200	G protein-coupled receptor 179
PA28860	2841	GPR18	chr13	99903967	99920682	16715	G protein-coupled receptor 18
PA144596429	160897	GPR180	chr13	95244104	95289899	45795	G protein-coupled receptor 180
PA162390165	11318	GPR182	chr12	57378355	57393469	15114	G protein-coupled receptor 182
PA162390174	1880	GPR183	chr13	99943789	99969749	25960	G protein-coupled receptor 183
PA28861	2842	GPR19	chr12	12810995	12859121	48126	G protein-coupled receptor 19
PA28863	2843	GPR20	chr8	142363585	142387365	23780	G protein-coupled receptor 20
PA28864	2844	GPR21	chr9	125785916	125804380	18464	G protein-coupled receptor 21
PA28865	2845	GPR22	chr7	107100502	107119125	18623	G protein-coupled receptor 22
PA28868	2848	GPR25	chr1	200832083	200846306	14223	G protein-coupled receptor 25
PA28869	2849	GPR26	chr10	125415871	125459915	44044	G protein-coupled receptor 26
PA28870	2850	GPR27	chr3	71793201	71807328	14127	G protein-coupled receptor 27
PA28872	2827	GPR3	chr1	27709148	27725318	16170	G protein-coupled receptor 3
PA28874	2853	GPR31	chr6	167567360	167581319	13959	G protein-coupled receptor 31
PA28875	2854	GPR32	chr19	51263721	51277989	14268	G protein-coupled receptor 32
PA28878	2857	GPR34	chrX	41538221	41559530	21309	G protein-coupled receptor 34
PA28880	2859	GPR35	chr2	241534825	241573676	38851	G protein-coupled receptor 35
PA28882	2861	GPR37	chr7	124382655	124416079	33424	G protein-coupled receptor 37 (endothelin receptor type B-like)
PA28883	9283	GPR37L1	chr1	202082029	202101634	19605	G protein-coupled receptor 37 like 1
PA28885	2863	GPR39	chr2	133164147	133407169	243022	G protein-coupled receptor 39
PA28886	2828	GPR4	chr19	46090022	46115466	25444	G protein-coupled receptor 4
PA28892	11250	GPR45	chr2	105829595	105863085	33490	G protein-coupled receptor 45
PA28895	9248	GPR50	chrX	150335056	150352937	17881	G protein-coupled receptor 50
PA28897	9293	GPR52	chr1	174407212	174421683	14471	G protein-coupled receptor 52
PA28900	9290	GPR55	chr2	231769043	231799953	30910	G protein-coupled receptor 55
PA28901	9289	GPR56	chr16	57643442	57701944	58502	G protein-coupled receptor 56
PA28904	2830	GPR6	chr6	110289459	110304923	15464	G protein-coupled receptor 6
PA28905	83873	GPR61	chr1	110072494	110091487	18993	G protein-coupled receptor 61
PA28906	118442	GPR62	chr3	51979330	51994520	15190	G protein-coupled receptor 62
PA28907	81491	GPR63	chr6	97238998	97295353	56355	G protein-coupled receptor 63
PA28908	10149	GPR64	chrX	19004425	19150755	146330	G protein-coupled receptor 64
PA28909	8477	GPR65	chr14	88461468	88484155	22687	G protein-coupled receptor 65
PA28911	8111	GPR68	chr14	91695876	91740898	45022	G protein-coupled receptor 68
PA28919	10936	GPR75	chr2	54077050	54097170	20120	G protein-coupled receptor 75
PA28921	27201	GPR78	chr4	8571964	8594750	22786	G protein-coupled receptor 78
PA28926	27197	GPR82	chrX	41573408	41592388	18980	G protein-coupled receptor 82
PA28927	10888	GPR83	chr11	94107477	94144585	37108	G protein-coupled receptor 83
PA28928	53831	GPR84	chr12	54753229	54768270	15041	G protein-coupled receptor 84
PA28929	54329	GPR85	chr7	112717468	112737833	20365	G protein-coupled receptor 85
PA28931	53836	GPR87	chr3	151008874	151044636	35762	G protein-coupled receptor 87
PA28932	54112	GPR88	chr1	100993728	101010583	16855	G protein-coupled receptor 88
PA134986137	653519	GPR89A	chr1	145761595	145837103	75508	G protein-coupled receptor 89A
PA143485480	51463	GPR89B	chr1	147390506	147468753	78247	G protein-coupled receptor 89B
PA143485481	728932	GPR89C	chr1	145873858	145927049	53191	G protein-coupled receptor 89C
PA28936	222487	GPR97	chr16	57692099	57726290	34191	G protein-coupled receptor 97
PA134960779	84059	GPR98	chr5	89844617	90463254	618637	G protein-coupled receptor 98
PA134970616	9737	GPRASP1	chrX	101896294	101917011	20717	G protein-coupled receptor associated sorting protein 1
PA134976848	114928	GPRASP2	chrX	101957104	101975661	18557	G protein-coupled receptor associated sorting protein 2
PA34194	9052	GPRC5A	chr12	13033956	13069600	35644	G protein-coupled receptor, class C, group 5, member A
PA28938	51704	GPRC5B	chr16	19867293	19907049	39756	G protein-coupled receptor, class C, group 5, member B
PA28939	55890	GPRC5C	chr17	72417480	72450797	33317	G protein-coupled receptor, class C, group 5, member C
PA28940	55507	GPRC5D	chr12	13090407	13116828	26421	G protein-coupled receptor, class C, group 5, member D
PA38342	222545	GPRC6A	chr6	117110248	117160256	50008	G protein-coupled receptor, class C, group 6, member A
PA162390183	114787	GPRIN1	chr5	176019803	176054339	34536	G protein regulated inducer of neurite outgrowth 1
PA162390192	9721	GPRIN2	chr10	46983003	47008654	25651	G protein regulated inducer of neurite outgrowth 2
PA162390203	285513	GPRIN3	chr4	90159427	90239161	79734	GPRIN family member 3
PA28944	2873	GPS1	chr17	79999746	80018346	18600	G protein pathway suppressor 1
PA28945	2874	GPS2	chr17	7212978	7228658	15680	G protein pathway suppressor 2
PA134986171	26086	GPSM1	chr9	139211932	139257057	45125	G-protein signaling modulator 1
PA134993615	29899	GPSM2	chr1	109407972	109476044	68072	G-protein signaling modulator 2
PA25940	63940	GPSM3	chr6	32155543	32173300	17757	G-protein signaling modulator 3
PA28947	2875	GPT	chr8	145719465	145735555	16090	glutamic-pyruvate transaminase (alanine aminotransferase)
PA28948	84706	GPT2	chr16	46908308	46968201	59893	glutamic pyruvate transaminase (alanine aminotransferase) 2
PA28949	2876	GPX1	chr3	49391609	49405791	14182	glutathione peroxidase 1
PA28950	2877	GPX2	chr14	65402870	65419623	16753	glutathione peroxidase 2 (gastrointestinal)
PA28951	2878	GPX3	chr5	150389999	150411554	21555	glutathione peroxidase 3 (plasma)
PA28952	2879	GPX4	chr19	1093936	1109787	15851	glutathione peroxidase 4
PA28953	2880	GPX5	chr6	28483789	28505728	21939	glutathione peroxidase 5
PA28954	257202	GPX6	chr6	28468073	28493570	25497	glutathione peroxidase 6 (olfactory)
PA28955	2882	GPX7	chr1	53058043	53077723	19680	glutathione peroxidase 7
PA164720300	493869	GPX8	chr5	54445984	54466129	20145	glutathione peroxidase 8 (putative)
PA134869487	57655	GRAMD1A	chr19	35475688	35520375	44687	GRAM domain containing 1A
PA142671708	57476	GRAMD1B	chr11	123315191	123501478	186287	GRAM domain containing 1B
PA142671709	54762	GRAMD1C	chr3	113547671	113669021	121350	GRAM domain containing 1C
PA142671710	196996	GRAMD2	chr15	72449147	72500136	50989	GRAM domain containing 2
PA142671711	65983	GRAMD3	chr5	125685788	125832853	147065	GRAM domain containing 3
PA162390212	23151	GRAMD4	chr22	46963124	47081652	118528	GRAM domain containing 4
PA28958	10750	GRAP	chr17	18920969	18960336	39367	GRB2-related adaptor protein
PA28959	9402	GRAP2	chr22	40287086	40372347	85261	GRB2-related adaptor protein 2
PA165431929	400581	GRAPL	chr17	19020782	19065148	44366	GRB2-related adaptor protein-like
PA38651	160622	GRASP	chr12	52390729	52412673	21944	GRP1 (general receptor for phosphoinositides 1)-associated scaffold protein
PA28960	2887	GRB10	chr7	50654760	50871159	216399	growth factor receptor-bound protein 10
PA28961	2888	GRB14	chr2	165346323	165488360	142037	growth factor receptor-bound protein 14
PA28962	2885	GRB2	chr17	73311157	73411790	100633	growth factor receptor-bound protein 2
PA28963	2886	GRB7	chr17	37884162	37906538	22376	growth factor receptor-bound protein 7
PA164747489	9687	GREB1	chr2	11664242	11785914	121672	growth regulation by estrogen in breast cancer 1
PA165429012	80000	GREB1L	chr18	18812203	19108384	296181	growth regulation by estrogen in breast cancer-like
PA26537	26585	GREM1	chr15	33000175	33029870	29695	gremlin 1, DAN family BMP antagonist
PA134968998	64388	GREM2	chr1	240649873	240785462	135589	gremlin 2, DAN family BMP antagonist
PA134971477	29841	GRHL1	chr2	10081792	10145412	63620	grainyhead-like 1 (Drosophila)
PA27270	79977	GRHL2	chr8	102494668	102684954	190286	grainyhead-like 2 (Drosophila)
PA134987320	57822	GRHL3	chr1	24635812	24693972	58160	grainyhead-like 3 (Drosophila)
PA28965	9380	GRHPR	chr9	37412693	37439990	27297	glyoxylate reductase/hydroxypyruvate reductase
PA28966	2890	GRIA1	chr5	152860084	153196429	336345	glutamate receptor, ionotropic, AMPA 1
PA28967	2891	GRIA2	chr4	158131736	158290227	158491	glutamate receptor, ionotropic, AMPA 2
PA28968	2892	GRIA3	chrX	122307996	122627766	319770	glutamate receptor, ionotropic, AMPA 3
PA28969	2893	GRIA4	chr11	105470800	105855819	385019	glutamate receptor, ionotropic, AMPA 4
PA28970	2894	GRID1	chr10	87356312	88136250	779938	glutamate receptor, ionotropic, delta 1
PA28971	2895	GRID2	chr4	93215453	94698707	1483254	glutamate receptor, ionotropic, delta 2
PA134951825	392862	GRID2IP	chr7	6533409	6601067	67658	glutamate receptor, ionotropic, delta 2 (Grid2) interacting protein
PA28973	2897	GRIK1	chr21	30906254	31322282	416028	glutamate receptor, ionotropic, kainate 1
PA164741600	2898	GRIK2	chr6	101831584	102520958	689374	glutamate receptor, ionotropic, kainate 2
PA28975	2899	GRIK3	chr1	37258128	37509844	251716	glutamate receptor, ionotropic, kainate 3
PA28976	2900	GRIK4	chr11	120372465	120862514	490049	glutamate receptor, ionotropic, kainate 4
PA28977	2901	GRIK5	chr19	42499468	42584278	84810	glutamate receptor, ionotropic, kainate 5
PA28978	2902	GRIN1	chr9	140023609	140066214	42605	glutamate receptor, ionotropic, N-methyl D-aspartate 1
PA28979	2903	GRIN2A	chr16	9844265	10286611	442346	glutamate receptor, ionotropic, N-methyl D-aspartate 2A
PA28980	2904	GRIN2B	chr12	13710684	14143022	432338	glutamate receptor, ionotropic, N-methyl D-aspartate 2B
PA28981	2905	GRIN2C	chr17	72835162	72866966	31804	glutamate receptor, ionotropic, N-methyl D-aspartate 2C
PA28982	2906	GRIN2D	chr19	48888132	48951188	63056	glutamate receptor, ionotropic, N-methyl D-aspartate 2D
PA28983	116443	GRIN3A	chr9	104328634	104510862	182228	glutamate receptor, ionotropic, N-methyl-D-aspartate 3A
PA28984	116444	GRIN3B	chr19	990437	1012723	22286	glutamate receptor, ionotropic, N-methyl-D-aspartate 3B
PA28985	2907	GRINA	chr8	145054226	145070596	16370	glutamate receptor, ionotropic, N-methyl D-aspartate-associated protein 1 (glutamate binding)
PA38652	23426	GRIP1	chr12	66738178	67473014	734836	glutamate receptor interacting protein 1
PA134986170	80852	GRIP2	chr3	14527396	14593588	66192	glutamate receptor interacting protein 2
PA38650	56850	GRIPAP1	chrX	48827130	48868675	41545	GRIP1 associated protein 1
PA34391	6011	GRK1	chr13	114416046	114441637	25591	G protein-coupled receptor kinase 1
PA28941	2868	GRK4	chr4	2955232	3045474	90242	G protein-coupled receptor kinase 4
PA180	2869	GRK5	chr10	120957197	121218131	260934	G protein-coupled receptor kinase 5
PA28942	2870	GRK6	chr5	176843687	176872850	29163	G protein-coupled receptor kinase 6
PA38433	131890	GRK7	chr3	141487043	141538892	51849	G protein-coupled receptor kinase 7
PA28990	2911	GRM1	chr6	146276032	146761782	485750	glutamate receptor, metabotropic 1
PA28991	2912	GRM2	chr3	51731081	51755629	24548	glutamate receptor, metabotropic 2
PA28992	2913	GRM3	chr7	86263230	86497193	233963	glutamate receptor, metabotropic 3
PA28993	2914	GRM4	chr6	33986623	34133399	146776	glutamate receptor, metabotropic 4
PA28994	2915	GRM5	chr11	88234256	88806846	572590	glutamate receptor, metabotropic 5
PA28995	2916	GRM6	chr5	178402328	178432124	29796	glutamate receptor, metabotropic 6
PA28996	2917	GRM7	chr3	6892802	7786218	893416	glutamate receptor, metabotropic 7
PA28997	2918	GRM8	chr7	126075652	126902428	826776	glutamate receptor, metabotropic 8
PA28998	2896	GRN	chr17	42412491	42433474	20983	granulin
PA28999	2922	GRP	chr18	56877400	56901003	23603	gastrin-releasing peptide
PA134918140	80273	GRPEL1	chr4	7058780	7079800	21020	GrpE-like 1, mitochondrial (E. coli)
PA134885090	134266	GRPEL2	chr5	148714364	148737146	22782	GrpE-like 2, mitochondrial (E. coli)
PA29002	2925	GRPR	chrX	16131424	16174641	43217	gastrin-releasing peptide receptor
PA29003	2926	GRSF1	chr4	71678499	71715627	37128	G-rich RNA sequence binding factor 1
PA134908043	79774	GRTP1	chr13	113975505	114028463	52958	growth hormone regulated TBC protein 1
PA134897548	83743	GRWD1	chr19	48939030	48960164	21134	glutamate-rich WD repeat containing 1
PA162390253	389207	GRXCR1	chr4	42885283	43035675	150392	glutaredoxin, cysteine rich 1
PA164720311	643226	GRXCR2	chr5	145236204	145309816	73612	glutaredoxin, cysteine rich 2
PA164724500	54103	GSAP	chr7	76937068	77055719	118651	gamma-secretase activating protein
PA29004	145258	GSC	chr14	95231560	95246499	14939	goosecoid homeobox
PA162390265	2928	GSC2	chr22	19133504	19147796	14292	goosecoid homeobox 2
PA162390274	284110	GSDMA	chr17	38109226	38137019	27793	gasdermin A
PA162390303	55876	GSDMB	chr17	38057848	38084903	27055	gasdermin B
PA162390324	56169	GSDMC	chr8	130757442	130809134	51692	gasdermin C
PA162390357	79792	GSDMD	chr8	144625383	144648232	22849	gasdermin D
PA143485512	23199	GSE1	chr16	85193152	85712812	519660	Gse1 coiled-coil protein
PA134868096	83445	GSG1	chr12	13233471	13266659	33188	germ cell associated 1
PA145148734	146395	GSG1L	chr16	27795850	28084830	288980	GSG1-like
PA134909705	83903	GSG2	chr17	3617197	3632993	15796	germ cell associated 2 (haspin)
PA29008	2931	GSK3A	chr19	42731338	42756736	25398	glycogen synthase kinase 3 alpha
PA29009	2932	GSK3B	chr3	119537800	119823264	285464	glycogen synthase kinase 3 beta
PA134987554	51527	GSKIP	chr14	96819789	96856627	36838	GSK3B interacting protein
PA29011	2934	GSN	chr9	124020380	124098122	77742	gelsolin
PA29012	2935	GSPT1	chr16	11958985	12020519	61534	G1 to S phase transition 1
PA29013	23708	GSPT2	chrX	51476481	51492328	15847	G1 to S phase transition 2
PA29014	2936	GSR	chr8	30532578	30595486	62908	glutathione reductase
PA29015	2937	GSS	chr20	33513236	33553794	40558	glutathione synthetase
PA29016	2938	GSTA1	chr6	52653178	52678664	25486	glutathione S-transferase alpha 1
PA29017	2939	GSTA2	chr6	52611885	52638361	26476	glutathione S-transferase alpha 2
PA29018	2940	GSTA3	chr6	52758437	52784496	26059	glutathione S-transferase alpha 3
PA29019	2941	GSTA4	chr6	52839746	52870178	30432	glutathione S-transferase alpha 4
PA134962856	221357	GSTA5	chr6	52693540	52720893	27353	glutathione S-transferase alpha 5
PA144596427	79807	GSTCD	chr4	106619935	106771882	151947	glutathione S-transferase, C-terminal domain containing
PA134948237	373156	GSTK1	chr7	142950506	142969222	18716	glutathione S-transferase kappa 1
PA182	2944	GSTM1	chr1	110220418	110243828	23410	glutathione S-transferase mu 1
PA29023	2946	GSTM2	chr1	110200644	110229619	28975	glutathione S-transferase mu 2 (muscle)
PA29024	2947	GSTM3	chr1	110273554	110293660	20106	glutathione S-transferase mu 3 (brain)
PA29026	2948	GSTM4	chr1	110188698	110211123	22425	glutathione S-transferase mu 4
PA29027	2949	GSTM5	chr1	110244406	110263890	19484	glutathione S-transferase mu 5
PA133787054	9446	GSTO1	chr10	106003952	106030222	26270	glutathione S-transferase omega 1
PA133787053	119391	GSTO2	chr10	106018174	106062176	44002	glutathione S-transferase omega 2
PA29028	2950	GSTP1	chr11	67341066	67357125	16059	glutathione S-transferase pi 1
PA183	2952	GSTT1	chr22	24373135	24394284	21149	glutathione S-transferase theta 1
PA29030	2953	GSTT2	chr22	24312291	24329106	16815	glutathione S-transferase theta 2 (gene/pseudogene)
PA162390358	653689	GSTT2B	chr22	24296601	24313416	16815	glutathione S-transferase theta 2B (gene/pseudogene)
PA29031	2954	GSTZ1	chr14	77777230	77800940	23710	glutathione S-transferase zeta 1
PA162390373	219409	GSX1	chr13	28356780	28371089	14309	GS homeobox 1
PA162390374	170825	GSX2	chr4	54956248	54971122	14874	GS homeobox 2
PA134892601	79712	GTDC1	chr2	144699502	145122578	423076	glycosyltransferase-like domain containing 1
PA29033	2957	GTF2A1	chr14	81638796	81697575	58779	general transcription factor IIA, 1, 19/37kDa
PA162390383	11036	GTF2A1L	chr2	48834937	49006645	171708	general transcription factor IIA, 1-like
PA29034	2958	GTF2A2	chr15	59927261	59959737	32476	general transcription factor IIA, 2, 12kDa
PA29035	2959	GTF2B	chr1	89315321	89367301	51980	general transcription factor IIB
PA29036	2960	GTF2E1	chr3	120451558	120505216	53658	general transcription factor IIE, polypeptide 1, alpha 56kDa
PA29037	2961	GTF2E2	chr8	30433031	30525738	92707	general transcription factor IIE, polypeptide 2, beta 34kDa
PA29038	2962	GTF2F1	chr19	6376580	6403291	26711	general transcription factor IIF, polypeptide 1, 74kDa
PA29039	2963	GTF2F2	chr13	45684631	45861240	176609	general transcription factor IIF, polypeptide 2, 30kDa
PA29041	2965	GTF2H1	chr11	18333816	18391590	57774	general transcription factor IIH, polypeptide 1, 62kDa
PA29042	2966	GTF2H2	chr5	70327951	70373516	45565	general transcription factor IIH, polypeptide 2, 44kDa
PA164720312	728340	GTF2H2C	chr5	68846001	68891730	45729	GTF2H2 family member C
PA164720349	730394	GTF2H2C_2	chr5	68846075	68891353	45278	GTF2H2 family member C, copy 2
PA29043	2967	GTF2H3	chr12	124108286	124150151	41865	general transcription factor IIH, polypeptide 3, 34kDa
PA29044	2968	GTF2H4	chr6	30865957	30884883	18926	general transcription factor IIH, polypeptide 4, 52kDa
PA134962077	404672	GTF2H5	chr6	158579379	158623376	43997	general transcription factor IIH, polypeptide 5
PA29045	2969	GTF2I	chr7	74061991	74178022	116031	general transcription factor IIi
PA29047	9569	GTF2IRD1	chr7	73858120	74019931	161811	GTF2I repeat domain containing 1
PA162390407	84163	GTF2IRD2	chr7	74207483	74277872	70389	GTF2I repeat domain containing 2
PA162390444	389524	GTF2IRD2B	chr7	74498187	74568623	70436	GTF2I repeat domain containing 2B
PA29048	2971	GTF3A	chr13	27988681	28012846	24165	general transcription factor IIIA
PA29052	2975	GTF3C1	chr16	27468934	27571251	102317	general transcription factor IIIC, polypeptide 1, alpha 220kDa
PA29053	2976	GTF3C2	chr2	27545716	27590243	44527	general transcription factor IIIC, polypeptide 2, beta 110kDa
PA29054	9330	GTF3C3	chr2	197624756	197674492	49736	general transcription factor IIIC, polypeptide 3, 102kDa
PA29055	9329	GTF3C4	chr9	135535728	135568471	32743	general transcription factor IIIC, polypeptide 4, 90kDa
PA29056	9328	GTF3C5	chr9	135896062	135936890	40828	general transcription factor IIIC, polypeptide 5, 63kDa
PA162390481	112495	GTF3C6	chr6	111269763	111292091	22328	general transcription factor IIIC, polypeptide 6, alpha 35kDa
PA29057	9567	GTPBP1	chr22	39091733	39132592	40859	GTP binding protein 1
PA162390482	85865	GTPBP10	chr7	89965341	90023769	58428	GTP-binding protein 10 (putative)
PA29058	54676	GTPBP2	chr6	43585218	43606977	21759	GTP binding protein 2
PA134883205	84705	GTPBP3	chr19	17435735	17456540	20805	GTP binding protein 3 (mitochondrial)
PA134922009	23560	GTPBP4	chr10	1024349	1066708	42359	GTP binding protein 4
PA128394538	8225	GTPBP6	chrY	168426	190887	22461	GTP binding protein 6 (putative)
PA142671705	29083	GTPBP8	chr3	112699323	112723221	23898	GTP-binding protein 8 (putative)
PA29061	51512	GTSE1	chr22	46682638	46732596	49958	G-2 and S-phase expressed 1
PA162390507	121355	GTSF1	chr12	54846736	54877386	30650	gametocyte specific factor 1
PA25775	149699	GTSF1L	chr20	42351801	42365647	13846	gametocyte specific factor 1-like
PA29062	2978	GUCA1A	chr6	42113144	42150794	37650	guanylate cyclase activator 1A (retina)
PA29063	2979	GUCA1B	chr6	42148022	42172694	24672	guanylate cyclase activator 1B (retina)
PA29064	9626	GUCA1C	chr3	108623491	108682742	59251	guanylate cyclase activator 1C
PA29065	2980	GUCA2A	chr1	42625362	42640395	15033	guanylate cyclase activator 2A (guanylin)
PA29066	2981	GUCA2B	chr1	42609092	42624495	15403	guanylate cyclase activator 2B (uroguanylin)
PA25882	83606	GUCD1	chr22	24933406	24961901	28495	guanylyl cyclase domain containing 1
PA186	2977	GUCY1A2	chr11	106541738	106899171	357433	guanylate cyclase 1, soluble, alpha 2
PA29067	2982	GUCY1A3	chr4	156577862	156661214	83352	guanylate cyclase 1, soluble, alpha 3
PA29068	2983	GUCY1B3	chr4	156670126	156731783	61657	guanylate cyclase 1, soluble, beta 3
PA29069	2984	GUCY2C	chr12	14762566	14859519	96953	guanylate cyclase 2C (heat stable enterotoxin receptor)
PA187	3000	GUCY2D	chr17	7895988	7926658	30670	guanylate cyclase 2D, membrane (retina-specific)
PA29071	2986	GUCY2F	chrX	108613135	108735285	122150	guanylate cyclase 2F, retinal
PA143485485	60558	GUF1	chr4	44670433	44705944	35511	GUF1 GTPase homolog (S. cerevisiae)
PA29072	2987	GUK1	chr1	228317668	228339656	21988	guanylate kinase 1
PA134993283	51454	GULP1	chr2	189146396	189463653	317257	GULP, engulfment adaptor PTB domain containing 1
PA29075	2990	GUSB	chr7	65422671	65457301	34630	glucuronidase, beta
PA165512868	283464	GXYLT1	chr12	42472647	42548673	76026	glucoside xylosyltransferase 1
PA165697418	727936	GXYLT2	chr3	72927385	73027525	100140	glucoside xylosyltransferase 2
PA29077	2992	GYG1	chr3	148699195	148748456	49261	glycogenin 1
PA29078	8908	GYG2	chrX	2736863	2803861	66998	glycogenin 2
PA29079	352887	GYG2P1	chrY	14514915	14543389	28474	glycogenin 2 pseudogene 1
PA142671704	120071	GYLTL1B	chr11	45933172	45953647	20475	glycosyltransferase-like 1B
PA29080	2993	GYPA	chr4	145027456	145071904	44448	glycophorin A (MNS blood group)
PA29081	2994	GYPB	chr4	144914257	144950498	36241	glycophorin B (MNS blood group)
PA29082	2995	GYPC	chr2	127403426	127457251	53825	glycophorin C (Gerbich blood group)
PA29083	2996	GYPE	chr4	144789019	144836716	47697	glycophorin E (MNS blood group)
PA29084	2997	GYS1	chr19	49468382	49506610	38228	glycogen synthase 1 (muscle)
PA29085	2998	GYS2	chr12	21681461	21793722	112261	glycogen synthase 2 (liver)
PA162390561	64412	GZF1	chr20	23332769	23356683	23914	GDNF-inducible zinc finger protein 1
PA29086	3001	GZMA	chr5	54388474	54409080	20606	granzyme A (granzyme 1, cytotoxic T-lymphocyte-associated serine esterase 3)
PA29087	3002	GZMB	chr14	25097160	25113490	16330	granzyme B (granzyme 2, cytotoxic T-lymphocyte-associated serine esterase 1)
PA29088	2999	GZMH	chr14	25072686	25088926	16240	granzyme H (cathepsin G-like 2, protein h-CCPX)
PA29089	3003	GZMK	chr5	54310107	54332960	22853	granzyme K (granzyme 3; tryptase II)
PA29090	3004	GZMM	chr19	534034	552920	18886	granzyme M (lymphocyte met-ase 1)
PA29092	3005	H1F0	chr22	38191114	38206443	15329	H1 histone family, member 0
PA143485486	341567	H1FNT	chr12	48712763	48727062	14299	H1 histone family, member N, testis-specific
PA134958422	132243	H1FOO	chr3	129252057	129273310	21253	H1 histone family, member O, oocyte-specific
PA29099	8971	H1FX	chr3	129030614	129045120	14506	H1 histone family, member X
PA134862083	474382	H2AFB1	chrX	154103317	154116833	13516	H2A histone family, member B1
PA134903705	474381	H2AFB2	chrX	154600355	154613948	13593	H2A histone family, member B2
PA29101	83740	H2AFB3	chrX	154686080	154699596	13516	H2A histone family, member B3
PA29108	55766	H2AFJ	chr12	14917270	14933936	16666	H2A histone family, member J
PA134895050	94239	H2AFV	chr7	44863488	44897725	34237	H2A histone family, member V
PA29116	3014	H2AFX	chr11	118961580	118976177	14597	H2A histone family, member X
PA29117	9555	H2AFY	chr5	134667071	134745645	78574	H2A histone family, member Y
PA29118	55506	H2AFY2	chr10	71802357	71875040	72683	H2A histone family, member Y2
PA29119	3015	H2AFZ	chr4	100866242	100881512	15270	H2A histone family, member Z
PA142671702	286436	H2BFM	chrX	103284516	103300021	15505	H2B histone family, member M
PA134930988	158983	H2BFWT	chrX	103262719	103278259	15540	H2B histone family, member W, testis-specific
PA29139	3020	H3F3A	chr1	226240408	226262703	22295	H3 histone, family 3A
PA29140	3021	H3F3B	chr17	73769515	73785860	16345	H3 histone, family 3B (H3.3B)
PA165512903	440093	H3F3C	chr12	31941119	31955175	14056	H3 histone, family 3C
PA29170	9563	H6PD	chr1	9284822	9334396	49574	hexose-6-phosphate dehydrogenase (glucose 1-dehydrogenase)
PA29171	23498	HAAO	chr2	42991229	43029753	38524	3-hydroxyanthranilate 3,4-dioxygenase
PA29172	3026	HABP2	chr10	115300590	115352361	51771	hyaluronan binding protein 2
PA38434	22927	HABP4	chr9	99202414	99256618	54204	hyaluronan binding protein 4
PA134983914	57531	HACE1	chr6	105172968	105317794	144826	HECT domain and ankyrin repeat containing E3 ubiquitin protein ligase 1
PA142671172	26061	HACL1	chr3	15599239	15653359	54120	2-hydroxyacyl-CoA lyase 1
PA29173	3033	HADH	chr4	108900870	108959331	58461	hydroxyacyl-CoA dehydrogenase
PA29175	3030	HADHA	chr2	26410504	26477665	67161	hydroxyacyl-CoA dehydrogenase/3-ketoacyl-CoA thiolase/enoyl-CoA hydratase (trifunctional protein), alpha subunit
PA29177	3032	HADHB	chr2	26457616	26516333	58717	hydroxyacyl-CoA dehydrogenase/3-ketoacyl-CoA thiolase/enoyl-CoA hydratase (trifunctional protein), beta subunit
PA29179	3029	HAGH	chr16	1856104	1887195	31091	hydroxyacylglutathione hydrolase
PA29180	84264	HAGHL	chr16	766958	782715	15757	hydroxyacylglutathione hydrolase-like
PA29181	3034	HAL	chr12	96363440	96400143	36703	histidine ammonia-lyase
PA29182	57817	HAMP	chr19	35763410	35779046	15636	hepcidin antimicrobial peptide
PA29183	9421	HAND1	chr5	153851532	153867824	16292	heart and neural crest derivatives expressed 1
PA29184	9464	HAND2	chr4	174444652	174461378	16726	heart and neural crest derivatives expressed 2
PA29185	54363	HAO1	chr20	7860631	7931093	70462	hydroxyacid oxidase (glycolate oxidase) 1
PA29186	51179	HAO2	chr1	119901399	119939753	38354	hydroxyacid oxidase 2 (long chain)
PA29188	9001	HAP1	chr17	39875891	39900898	25007	huntingtin-associated protein 1
PA26901	1404	HAPLN1	chr5	82931017	83026896	95879	hyaluronan and proteoglycan link protein 1
PA134878581	60484	HAPLN2	chr1	156579085	156598517	19432	hyaluronan and proteoglycan link protein 2
PA134919215	145864	HAPLN3	chr15	89417519	89448857	31338	hyaluronan and proteoglycan link protein 3
PA134886721	404037	HAPLN4	chr19	19363450	19383596	20146	hyaluronan and proteoglycan link protein 4
PA162390577	283254	HARBI1	chr11	46621856	46648933	27077	harbinger transposase derived 1
PA29191	3035	HARS	chr5	140050490	140081681	31191	histidyl-tRNA synthetase
PA29192	23438	HARS2	chr5	140061011	140081903	20892	histidyl-tRNA synthetase 2, mitochondrial
PA29194	3036	HAS1	chr19	52213365	52237239	23874	hyaluronan synthase 1
PA29195	3037	HAS2	chr8	122621356	122663675	42319	hyaluronan synthase 2
PA29196	3038	HAS3	chr16	69129467	69155622	26155	hyaluronan synthase 3
PA29197	8520	HAT1	chr2	172768935	172851600	82665	histone acetyltransferase 1
PA165429013	115106	HAUS1	chr18	43674298	43711299	37001	HAUS augmin-like complex, subunit 1
PA165479051	55142	HAUS2	chr15	42831011	42865192	34181	HAUS augmin-like complex, subunit 2
PA165664132	79441	HAUS3	chr4	2227096	2253860	26764	HAUS augmin-like complex, subunit 3
PA165478984	54930	HAUS4	chr14	23412437	23436352	23915	HAUS augmin-like complex, subunit 4
PA165393415	23354	HAUS5	chr19	36093646	36119251	25605	HAUS augmin-like complex, subunit 5
PA165585815	54801	HAUS6	chr9	19050135	19112940	62805	HAUS augmin-like complex, subunit 6
PA165756645	55559	HAUS7	chrX	152710123	152770983	60860	HAUS augmin-like complex, subunit 7
PA165393466	93323	HAUS8	chr19	17157571	17196428	38857	HAUS augmin-like complex, subunit 8
PA134924567	26762	HAVCR1	chr5	156452989	156496130	43141	hepatitis A virus cellular receptor 1
PA134883425	84868	HAVCR2	chr5	156509843	156546248	36405	hepatitis A virus cellular receptor 2
PA142671700	10456	HAX1	chr1	154235039	154251351	16312	HCLS1 associated protein X-1
PA29198	3039	HBA1	chr16	216679	230520	13841	hemoglobin, alpha 1
PA29199	3040	HBA2	chr16	212846	226709	13863	hemoglobin, alpha 2
PA29202	3043	HBB	chr11	5243696	5258301	14605	hemoglobin, beta
PA29204	3045	HBD	chr11	5251059	5265858	14799	hemoglobin, delta
PA29205	3046	HBE1	chr11	5286580	5301373	14793	hemoglobin, epsilon 1
PA27513	1839	HBEGF	chr5	139709428	139736188	26760	heparin-binding EGF-like growth factor
PA29206	3047	HBG1	chr11	5266502	5281087	14585	hemoglobin, gamma A
PA29207	3048	HBG2	chr11	5271421	5286011	14590	hemoglobin, gamma G
PA29201	3042	HBM	chr16	205973	219767	13794	hemoglobin, mu
PA134901346	26959	HBP1	chr7	106799406	106845974	46568	HMG-box transcription factor 1
PA29208	3049	HBQ1	chr16	220333	234178	13845	hemoglobin, theta 1
PA29209	10767	HBS1L	chr6	135278516	135386036	107520	HBS1-like translational GTPase
PA29212	3050	HBZ	chr16	192854	207504	14650	hemoglobin, zeta
PA28925	27198	HCAR1	chr12	123209153	123225129	15976	hydroxycarboxylic acid receptor 1
PA165961843	338442	HCAR2	chr12	123182840	123204392	21552	hydroxycarboxylic acid receptor 2
PA165512827	8843	HCAR3	chr12	123196303	123211439	15136	hydroxycarboxylic acid receptor 3
PA29214	3052	HCCS	chrX	11119406	11144206	24800	holocytochrome c synthase
PA29215	3054	HCFC1	chrX	153210008	153247284	37276	host cell factor C1
PA134951485	54985	HCFC1R1	chr16	3069626	3084287	14661	host cell factor C1 regulator 1 (XPO1 dependent)
PA134868925	29915	HCFC2	chr12	104448236	104503302	55066	host cell factor C2
PA29216	3055	HCK	chr20	30629991	30692659	62668	HCK proto-oncogene, Src family tyrosine kinase
PA29220	3059	HCLS1	chr3	121347246	121389791	42545	hematopoietic cell-specific Lyn substrate 1
PA77	348980	HCN1	chr5	45252052	45706220	454168	hyperpolarization activated cyclic nucleotide-gated potassium channel 1
PA78	610	HCN2	chr19	579893	620159	40266	hyperpolarization activated cyclic nucleotide-gated potassium channel 2
PA38821	57657	HCN3	chr1	155237218	155262639	25421	hyperpolarization activated cyclic nucleotide-gated potassium channel 3
PA394	10021	HCN4	chr15	73609200	73671605	62405	hyperpolarization activated cyclic nucleotide-gated potassium channel 4
PA29221	3060	HCRT	chr17	40333078	40347470	14392	hypocretin (orexin) neuropeptide precursor
PA29222	3061	HCRTR1	chr1	32073290	32096214	22924	hypocretin (orexin) receptor 1
PA29223	3062	HCRTR2	chr6	55029071	55150538	121467	hypocretin (orexin) receptor 2
PA134956649	10870	HCST	chr19	36383382	36398173	14791	hematopoietic cell signal transducer
PA29226	3065	HDAC1	chr1	32747708	32802227	54519	histone deacetylase 1
PA38297	83933	HDAC10	chr22	50680612	50699834	19222	histone deacetylase 10
PA38793	79885	HDAC11	chr3	13511671	13550924	39253	histone deacetylase 11
PA29227	3066	HDAC2	chr6	114254320	114302359	48039	histone deacetylase 2
PA29228	8841	HDAC3	chr5	140997443	141026423	28980	histone deacetylase 3
PA29229	9759	HDAC4	chr2	239966864	240333346	366482	histone deacetylase 4
PA29230	10014	HDAC5	chr17	42151121	42211014	59893	histone deacetylase 5
PA29231	10013	HDAC6	chrX	48650086	48686408	36322	histone deacetylase 6
PA162390579	51564	HDAC7	chr12	48173505	48223763	50258	histone deacetylase 7
PA37766	55869	HDAC8	chrX	71546366	71802953	256587	histone deacetylase 8
PA38377	9734	HDAC9	chr7	18116572	19042135	925563	histone deacetylase 9
PA29233	3067	HDC	chr15	50531144	50568162	37018	histidine decarboxylase
PA134943525	51020	HDDC2	chr6	125593496	125633287	39791	HD domain containing 2
PA142671696	374659	HDDC3	chr15	91471148	91485792	14644	HD domain containing 3
PA29234	3068	HDGF	chr1	156708899	156732240	23341	hepatoma-derived growth factor
PA134981303	154150	HDGFL1	chr6	22559678	22573750	14072	hepatoma derived growth factor-like 1
PA165756731	8226	HDHD1	chrX	6963961	7076231	112270	haloacid dehalogenase-like hydrolase domain containing 1
PA134952019	84064	HDHD2	chr18	44630781	44686891	56110	haloacid dehalogenase-like hydrolase domain containing 2
PA134868152	81932	HDHD3	chr9	116132698	116149289	16591	haloacid dehalogenase-like hydrolase domain containing 3
PA29235	3069	HDLBP	chr2	242163682	242265116	101434	high density lipoprotein binding protein
PA162390630	139324	HDX	chrX	83569882	83767487	197605	highly divergent homeobox
PA142671697	55127	HEATR1	chr1	236709305	236777841	68536	HEAT repeat containing 1
PA145008229	54919	HEATR2	chr7	756338	829116	72778	HEAT repeat containing 2
PA144596426	55027	HEATR3	chr16	50089881	50142392	52511	HEAT repeat containing 3
PA162390631	399671	HEATR4	chr14	73942189	74035651	93462	HEAT repeat containing 4
PA162390632	25938	HEATR5A	chr14	31757994	31899788	141794	HEAT repeat containing 5A
PA162390697	54497	HEATR5B	chr2	37205153	37321485	116332	HEAT repeat containing 5B
PA162390774	63897	HEATR6	chr17	58115790	58166292	50502	HEAT repeat containing 6
PA142672249	256957	HEATR9	chr17	34178960	34205895	26935	HEAT repeat containing 9
PA29236	50865	HEBP1	chr12	13124798	13163243	38445	heme binding protein 1
PA25935	23593	HEBP2	chr6	138715336	138737582	22246	heme binding protein 2
PA134977625	51696	HECA	chr6	139446249	139504946	58697	headcase homolog (Drosophila)
PA134989284	25831	HECTD1	chr14	31566323	31687266	120943	HECT domain containing E3 ubiquitin protein ligase 1
PA134933711	143279	HECTD2	chr10	93159037	93277586	118549	HECT domain containing E3 ubiquitin protein ligase 2
PA142671698	79654	HECTD3	chr1	45465220	45487027	21807	HECT domain containing E3 ubiquitin protein ligase 3
PA143485380	283450	HECTD4	chr12	112594992	112830113	235121	HECT domain containing E3 ubiquitin protein ligase 4
PA134964191	23072	HECW1	chr7	43142198	43606213	464015	HECT, C2 and WW domain containing E3 ubiquitin protein ligase 1
PA134925001	57520	HECW2	chr2	197060971	197468416	407445	HECT, C2 and WW domain containing E3 ubiquitin protein ligase 2
PA142671699	57493	HEG1	chr3	124681554	124784802	103248	heart development protein with EGF-like domains 1
PA134987279	92797	HELB	chr12	66686335	66740423	54088	helicase (DNA) B
PA35054	3070	HELLS	chr10	96295535	96365628	70093	helicase, lymphoid-specific
PA164720529	113510	HELQ	chr4	84325496	84387162	61666	helicase, POLQ-like
PA162390819	391723	HELT	chr4	185930001	185944958	14957	helt bHLH transcription factor
PA29238	9931	HELZ	chr17	65063554	65251349	187795	helicase with zinc finger
PA38458	55363	HEMGN	chr9	100686073	100717197	31124	hemogen
PA134884011	51409	HEMK1	chr3	50596583	50625422	28839	HemK methyltransferase family member 1
PA128394748	113802	HENMT1	chr1	109187910	109214148	26238	HEN1 methyltransferase homolog 1 (Arabidopsis)
PA162390830	220296	HEPACAM	chr11	124786089	124816308	30219	hepatic and glial cell adhesion molecule
PA162390849	253012	HEPACAM2	chr7	92814899	92865783	50884	HEPACAM family member 2
PA29241	9843	HEPH	chrX	65372433	65490231	117798	hephaestin
PA134873144	341208	HEPHL1	chr11	93744378	93850374	105996	hephaestin-like 1
PA162390850	641654	HEPN1	chr11	124779146	124793573	14427	hepatocellular carcinoma, down-regulated 1
PA29242	8925	HERC1	chr15	63897817	64136148	238331	HECT and RLD domain containing E3 ubiquitin protein ligase family member 1
PA29243	8924	HERC2	chr15	28353183	28577313	224130	HECT and RLD domain containing E3 ubiquitin protein ligase 2
PA29251	8916	HERC3	chr4	89503574	89632693	129119	HECT and RLD domain containing E3 ubiquitin protein ligase 3
PA134949021	26091	HERC4	chr10	69678656	69845103	166447	HECT and RLD domain containing E3 ubiquitin protein ligase 4
PA134973940	51191	HERC5	chr4	89368181	89430334	62153	HECT and RLD domain containing E3 ubiquitin protein ligase 5
PA134894313	55008	HERC6	chr4	89289838	89367249	77411	HECT and RLD domain containing E3 ubiquitin protein ligase family member 6
PA29252	9709	HERPUD1	chr16	56955974	56980793	24819	homocysteine-inducible, endoplasmic reticulum stress-inducible, ubiquitin-like domain member 1
PA144596425	64224	HERPUD2	chr7	35669269	35744772	75503	HERPUD family member 2
PA29465	3280	HES1	chr3	193843931	193859401	15470	hes family bHLH transcription factor 1
PA134958805	54626	HES2	chr1	6472292	6494724	22432	hes family bHLH transcription factor 2
PA142671692	390992	HES3	chr1	6294252	6308638	14386	hes family bHLH transcription factor 3
PA134975318	57801	HES4	chr1	931342	946608	15266	hes family bHLH transcription factor 4
PA134967985	388585	HES5	chr1	2457184	2471684	14500	hes family bHLH transcription factor 5
PA29253	55502	HES6	chr2	239143908	239158681	14773	hes family bHLH transcription factor 6
PA29254	84667	HES7	chr17	8020908	8037410	16502	hes family bHLH transcription factor 7
PA29255	8820	HESX1	chr3	57228866	57271656	42790	HESX homeobox 1
PA29256	3073	HEXA	chr15	72632778	72679474	46696	hexosaminidase A (alpha polypeptide)
PA29257	3074	HEXB	chr5	73925547	74020113	94566	hexosaminidase B (beta polypeptide)
PA142671693	284004	HEXDC	chr17	80366240	80403516	37276	hexosaminidase (glycosyl hydrolase family 20, catalytic domain) containing
PA142671694	10614	HEXIM1	chr17	43214684	43232468	17784	hexamethylene bis-acetamide inducible 1
PA142671695	124790	HEXIM2	chr17	43227502	43250406	22904	hexamethylene bis-acetamide inducible 2
PA29258	23462	HEY1	chr8	80673245	80690098	16853	hes-related family bHLH transcription factor with YRPW motif 1
PA29259	23493	HEY2	chr6	126056211	126085415	29204	hes-related family bHLH transcription factor with YRPW motif 2
PA29260	26508	HEYL	chr1	40086103	40115348	29245	hes-related family bHLH transcription factor with YRPW motif-like
PA29263	3077	HFE	chr6	26077422	26099438	22016	hemochromatosis
PA29264	148738	HFE2	chr1	145403191	145420545	17354	hemochromatosis type 2 (juvenile)
PA142671690	164045	HFM1	chr1	91723323	91880426	157103	HFM1, ATP-dependent DNA helicase homolog (S. cerevisiae)
PA29268	3081	HGD	chr3	120344015	120411418	67403	homogentisate 1,2-dioxygenase
PA29269	3082	HGF	chr7	81328444	81409452	81008	hepatocyte growth factor (hepapoietin A; scatter factor)
PA29270	3083	HGFAC	chr4	3433702	3454214	20512	HGF activator
PA142672348	51236	HGH1	chr8	145182672	145198620	15948	HGH1 homolog (S. cerevisiae)
PA29271	9146	HGS	chr17	79640962	79672151	31189	hepatocyte growth factor-regulated tyrosine kinase substrate
PA162390851	138050	HGSNAT	chr8	42985592	43060970	75378	heparan-alpha-glucosaminide N-acetyltransferase
PA134926499	55733	HHAT	chr1	210491596	210852638	361042	hedgehog acyltransferase
PA162390892	57467	HHATL	chr3	42731155	42754319	23164	hedgehog acyltransferase-like
PA29274	3087	HHEX	chr10	94439681	94458408	18727	hematopoietically expressed homeobox
PA29276	64399	HHIP	chr4	145557148	145665542	108394	hedgehog interacting protein
PA162390893	84439	HHIPL1	chr14	100101480	100146011	44531	HHIP-like 1
PA162390914	79802	HHIPL2	chr1	222692602	222731444	38842	HHIP-like 2
PA29277	10086	HHLA1	chr8	133070733	133127512	56779	HERV-H LTR-associating 1
PA29278	11148	HHLA2	chr3	108005353	108100132	94779	HERV-H LTR-associating 2
PA29279	11147	HHLA3	chr1	70810493	70836706	26213	HERV-H LTR-associating 3
PA134910737	64645	HIAT1	chr1	100493670	100551933	58263	hippocampus abundant transcript 1
PA142671691	84641	HIATL1	chr9	97126833	97226202	99369	hippocampus abundant transcript-like 1
PA29280	11112	HIBADH	chr7	27562059	27712620	150561	3-hydroxyisobutyrate dehydrogenase
PA29281	26275	HIBCH	chr2	191066355	191194771	128416	3-hydroxyisobutyryl-CoA hydrolase
PA29282	3090	HIC1	chr17	1947454	1965981	18527	hypermethylated in cancer 1
PA38357	23119	HIC2	chr22	21761693	21808752	47059	hypermethylated in cancer 2
PA25583	283987	HID1	chr17	72943837	72978900	35063	HID1 domain containing
PA29283	3091	HIF1A	chr14	62152118	62217977	65859	hypoxia inducible factor 1, alpha subunit (basic helix-loop-helix transcription factor)
PA29284	55662	HIF1AN	chr10	102285641	102316681	31040	hypoxia inducible factor 1, alpha subunit inhibitor
PA29285	64344	HIF3A	chr19	46790303	46849690	59387	hypoxia inducible factor 3, alpha subunit
PA142671681	25994	HIGD1A	chr3	42821400	42856027	34627	HIG1 hypoxia inducible domain family, member 1A
PA142671682	51751	HIGD1B	chr17	42913721	42930848	17127	HIG1 hypoxia inducible domain family, member 1B
PA142671683	613227	HIGD1C	chr12	51336200	51367668	31468	HIG1 hypoxia inducible domain family, member 1C
PA142671685	192286	HIGD2A	chr5	175805784	175819751	13967	HIG1 hypoxia inducible domain family, member 2A
PA164717457	29923	HILPDA	chr7	128085884	128101472	15588	hypoxia inducible lipid droplet-associated
PA164720597	25988	HINFP	chr11	118982233	119008765	26532	histone H4 transcription factor
PA29286	3094	HINT1	chr5	130491976	130511041	19065	histidine triad nucleotide binding protein 1
PA29287	84681	HINT2	chr9	35809957	35825481	15524	histidine triad nucleotide binding protein 2
PA29288	135114	HINT3	chr6	126267861	126304390	36529	histidine triad nucleotide binding protein 3
PA29289	3092	HIP1	chr7	75159619	75378290	218671	huntingtin interacting protein 1
PA128394543	9026	HIP1R	chr12	123309045	123350508	41463	huntingtin interacting protein 1 related
PA134897980	204851	HIPK1	chr1	114461819	114523491	61672	homeodomain interacting protein kinase 1
PA29291	28996	HIPK2	chr7	139412730	139487693	74963	homeodomain interacting protein kinase 2
PA29292	10114	HIPK3	chr11	33264406	33381569	117163	homeodomain interacting protein kinase 3
PA134883524	147746	HIPK4	chr19	40882178	40906094	23916	homeodomain interacting protein kinase 4
PA29293	7290	HIRA	chr22	19315221	19429247	114026	histone cell cycle regulator
PA29294	8479	HIRIP3	chr16	30000642	30017417	16775	HIRA interacting protein 3
PA29093	3024	HIST1H1A	chr6	26014260	26028040	13780	histone cluster 1, H1a
PA29097	3009	HIST1H1B	chr6	27831570	27845359	13789	histone cluster 1, H1b
PA29094	3006	HIST1H1C	chr6	26052968	26066699	13731	histone cluster 1, H1c
PA29095	3007	HIST1H1D	chr6	26231440	26245216	13776	histone cluster 1, H1d
PA29096	3008	HIST1H1E	chr6	26146559	26160343	13784	histone cluster 1, H1e
PA29098	3010	HIST1H1T	chr6	26104640	26118364	13724	histone cluster 1, H1t
PA134988774	221613	HIST1H2AA	chr6	25723291	25736790	13499	histone cluster 1, H2aa
PA29111	8335	HIST1H2AB	chr6	26030320	26043796	13476	histone cluster 1, H2ab
PA29110	8334	HIST1H2AC	chr6	26114370	26142337	27967	histone cluster 1, H2ac
PA29106	3013	HIST1H2AD	chr6	26196012	26209521	13509	histone cluster 1, H2ad
PA29100	3012	HIST1H2AE	chr6	26207148	26220711	13563	histone cluster 1, H2ae
PA29114	8969	HIST1H2AG	chr6	27090817	27104314	13497	histone cluster 1, H2ag
PA134913416	85235	HIST1H2AH	chr6	27104861	27118341	13480	histone cluster 1, H2ah
PA29102	8329	HIST1H2AI	chr6	27765977	27779445	13468	histone cluster 1, H2ai
PA29104	8331	HIST1H2AJ	chr6	27779080	27792518	13438	histone cluster 1, H2aj
PA29103	8330	HIST1H2AK	chr6	27802658	27816117	13459	histone cluster 1, H2ak
PA29107	8332	HIST1H2AL	chr6	27823107	27836576	13469	histone cluster 1, H2al
PA29112	8336	HIST1H2AM	chr6	27857477	27870963	13486	histone cluster 1, H2am
PA134937673	255626	HIST1H2BA	chr6	25717137	25730573	13436	histone cluster 1, H2ba
PA29126	3018	HIST1H2BB	chr6	26040455	26053885	13430	histone cluster 1, H2bb
PA29132	8347	HIST1H2BC	chr6	26110389	26134266	23877	histone cluster 1, H2bc
PA29122	3017	HIST1H2BD	chr6	26147419	26174577	27158	histone cluster 1, H2bd
PA29128	8344	HIST1H2BE	chr6	26174024	26187458	13434	histone cluster 1, H2be
PA29127	8343	HIST1H2BF	chr6	26189787	26203216	13429	histone cluster 1, H2bf
PA29121	8339	HIST1H2BG	chr6	26213428	26226872	13444	histone cluster 1, H2bg
PA29130	8345	HIST1H2BH	chr6	26241848	26264783	22935	histone cluster 1, H2bh
PA29131	8346	HIST1H2BI	chr6	26263204	26276640	13436	histone cluster 1, H2bi
PA29136	8970	HIST1H2BJ	chr6	27090912	27110743	19831	histone cluster 1, H2bj
PA134955134	85236	HIST1H2BK	chr6	27103072	27124637	21565	histone cluster 1, H2bk
PA29123	8340	HIST1H2BL	chr6	27772257	27785709	13452	histone cluster 1, H2bl
PA29125	8342	HIST1H2BM	chr6	27772822	27786267	13445	histone cluster 1, H2bm
PA29124	8341	HIST1H2BN	chr6	27795544	27824533	28989	histone cluster 1, H2bn
PA29133	8348	HIST1H2BO	chr6	27851203	27929100	77897	histone cluster 1, H2bo
PA29141	8350	HIST1H3A	chr6	26010718	26024186	13468	histone cluster 1, H3a
PA29151	8358	HIST1H3B	chr6	26028817	26042288	13471	histone cluster 1, H3b
PA29143	8352	HIST1H3C	chr6	26035639	26049097	13458	histone cluster 1, H3c
PA29142	8351	HIST1H3D	chr6	26193982	26209521	15539	histone cluster 1, H3d
PA29144	8353	HIST1H3E	chr6	26214427	26230706	16279	histone cluster 1, H3e
PA29148	8968	HIST1H3F	chr6	26247370	26260835	13465	histone cluster 1, H3f
PA29147	8355	HIST1H3G	chr6	26268146	26281612	13466	histone cluster 1, H3g
PA29150	8357	HIST1H3H	chr6	27767842	27781314	13472	histone cluster 1, H3h
PA29146	8354	HIST1H3I	chr6	27836623	27850099	13476	histone cluster 1, H3i
PA29149	8356	HIST1H3J	chr6	27855093	27868570	13477	histone cluster 1, H3j
PA29156	8359	HIST1H4A	chr6	26011907	26025278	13371	histone cluster 1, H4a
PA29164	8366	HIST1H4B	chr6	26024124	26037480	13356	histone cluster 1, H4b
PA29162	8364	HIST1H4C	chr6	26094176	26107565	13389	histone cluster 1, H4c
PA29157	8360	HIST1H4D	chr6	26185938	26199304	13366	histone cluster 1, H4d
PA29165	8367	HIST1H4E	chr6	26194873	26208249	13376	histone cluster 1, H4e
PA29158	8361	HIST1H4F	chr6	26230654	26244021	13367	histone cluster 1, H4f
PA29167	8369	HIST1H4G	chr6	26243839	26257205	13366	histone cluster 1, H4g
PA29163	8365	HIST1H4H	chr6	26278278	26295844	17566	histone cluster 1, H4h
PA29168	8294	HIST1H4I	chr6	27096924	27111258	14334	histone cluster 1, H4i
PA29160	8363	HIST1H4J	chr6	27781903	27795258	13355	histone cluster 1, H4j
PA29159	8362	HIST1H4K	chr6	27795952	27809305	13353	histone cluster 1, H4k
PA29166	8368	HIST1H4L	chr6	27837926	27851289	13363	histone cluster 1, H4l
PA29113	8337	HIST2H2AA3	chr1	149810785	149824318	13533	histone cluster 2, H2aa3
PA145148721	723790	HIST2H2AA4	chr1	149812628	149826161	13533	histone cluster 2, H2aa4
PA134884141	317772	HIST2H2AB	chr1	149856019	149869466	13447	histone cluster 2, H2ab
PA29115	8338	HIST2H2AC	chr1	149848525	149861961	13436	histone cluster 2, H2ac
PA29135	8349	HIST2H2BE	chr1	149853010	149868232	15222	histone cluster 2, H2be
PA145148722	440689	HIST2H2BF	chr1	149751245	149793965	42720	histone cluster 2, H2bf
PA134926636	333932	HIST2H3A	chr1	149814181	149827687	13506	histone cluster 2, H3a
PA29152	126961	HIST2H3C	chr1	149809259	149822765	13506	histone cluster 2, H3c
PA145148728	653604	HIST2H3D	chr1	149781780	149795236	13456	histone cluster 2, H3d
PA29169	8370	HIST2H4A	chr1	149794170	149809197	15027	histone cluster 2, H4a
PA145148733	554313	HIST2H4B	chr1	149827749	149842776	15027	histone cluster 2, H4b
PA134962147	92815	HIST3H2A	chr1	228642065	228655560	13495	histone cluster 3, H2a
PA134875583	128312	HIST3H2BB	chr1	228635808	228649259	13451	histone cluster 3, H2bb
PA29153	8290	HIST3H3	chr1	228609546	228623026	13480	histone cluster 3, H3
PA134931035	121504	HIST4H4	chr12	14917933	14934093	16160	histone cluster 4, H4
PA29297	3096	HIVEP1	chr6	12002724	12215270	212546	human immunodeficiency virus type I enhancer binding protein 1
PA29298	3097	HIVEP2	chr6	143069604	143277495	207891	human immunodeficiency virus type I enhancer binding protein 2
PA29299	59269	HIVEP3	chr1	41969036	42511596	542560	human immunodeficiency virus type I enhancer binding protein 3
PA162390937	55355	HJURP	chr2	234742486	234773212	30726	Holliday junction recognition protein
PA29300	3098	HK1	chr10	71019740	71164638	144898	hexokinase 1
PA29301	3099	HK2	chr2	75049782	75123481	73699	hexokinase 2
PA29303	3101	HK3	chr5	176304870	176336333	31463	hexokinase 3 (white cell)
PA134866195	80201	HKDC1	chr10	70970059	71030315	60256	hexokinase domain containing 1
PA29306	284459	HKR1	chr19	37815580	37858357	42777	HKR1, GLI-Kruppel zinc finger family member
PA35055	3105	HLA-A	chr6	29900247	29916661	16414	major histocompatibility complex, class I, A
PA35056	3106	HLA-B	chr6	31318649	31334989	16340	major histocompatibility complex, class I, B
PA35057	3107	HLA-C	chr6	31233526	31249913	16387	major histocompatibility complex, class I, C
PA35058	3108	HLA-DMA	chr6	32913391	32930900	17509	major histocompatibility complex, class II, DM alpha
PA35059	3109	HLA-DMB	chr6	32899406	32918847	19441	major histocompatibility complex, class II, DM beta
PA35060	3111	HLA-DOA	chr6	32968959	32987389	18430	major histocompatibility complex, class II, DO alpha
PA35061	3112	HLA-DOB	chr6	32777540	32794825	17285	major histocompatibility complex, class II, DO beta
PA35062	3113	HLA-DPA1	chr6	33029346	33058555	29209	major histocompatibility complex, class II, DP alpha 1
PA35064	3115	HLA-DPB1	chr6	33033703	33060473	26770	major histocompatibility complex, class II, DP beta 1
PA35066	3117	HLA-DQA1	chr6	32595169	32615152	19983	major histocompatibility complex, class II, DQ alpha 1
PA35067	3118	HLA-DQA2	chr6	32699156	32717664	18508	major histocompatibility complex, class II, DQ alpha 2
PA35068	3119	HLA-DQB1	chr6	32624241	32644466	20225	major histocompatibility complex, class II, DQ beta 1
PA35069	3120	HLA-DQB2	chr6	32720837	32741330	20493	major histocompatibility complex, class II, DQ beta 2
PA35071	3122	HLA-DRA	chr6	32397619	32415823	18204	major histocompatibility complex, class II, DR alpha
PA35072	3123	HLA-DRB1	chr6	3781600	3808012	26412	major histocompatibility complex, class II, DR beta 1
PA35074	3125	HLA-DRB3	chr6	3717951	3744018	26067	major histocompatibility complex, class II, DR beta 3
PA35075	3126	HLA-DRB4	chr6	3879321	3907292	27971	major histocompatibility complex, class II, DR beta 4
PA35076	3127	HLA-DRB5	chr6	32482151	32508006	25855	major histocompatibility complex, class II, DR beta 5
PA35081	3133	HLA-E	chr6	30447183	30464982	17799	major histocompatibility complex, class I, E
PA35082	3134	HLA-F	chr6	29681117	29698073	16956	major histocompatibility complex, class I, F
PA35083	3135	HLA-G	chr6	29784756	29801899	17143	major histocompatibility complex, class I, G
PA29310	3141	HLCS	chr21	38120189	38372545	252356	holocarboxylase synthetase (biotin-(proprionyl-CoA-carboxylase (ATP-hydrolysing)) ligase)
PA29311	3131	HLF	chr17	53332321	53405426	73105	hepatic leukemia factor
PA35949	6596	HLTF	chr3	148744904	148814341	69437	helicase-like transcription factor
PA162391017	3142	HLX	chr1	221042743	221061401	18658	H2.0-like homeobox
PA29314	81502	HM13	chr20	30092213	30161178	68965	histocompatibility (minor) 13
PA143485490	79618	HMBOX1	chr8	28737911	28925456	187545	homeobox containing 1
PA29317	3145	HMBS	chr11	118945587	118967259	21672	hydroxymethylbilane synthase
PA142672398	56941	HMCES	chr3	128987684	129027136	39452	5-hydroxymethylcytosine (hmC) binding, ES cell-specific
PA142671679	83872	HMCN1	chr1	185693683	186163085	469402	hemicentin 1
PA29331	10363	HMG20A	chr15	77703018	77780945	77927	high mobility group 20A
PA29332	10362	HMG20B	chr19	3562936	3582081	19145	high mobility group 20B
PA35094	3159	HMGA1	chr6	34194577	34217008	22431	high mobility group AT-hook 1
PA35093	8091	HMGA2	chr12	66208240	66363071	154831	high mobility group AT-hook 2
PA188	3146	HMGB1	chr13	31029877	31201942	172065	high mobility group box 1
PA35091	3148	HMGB2	chr4	174249527	174265595	16068	high mobility group box 2
PA35092	3149	HMGB3	chrX	150139056	150162248	23192	high mobility group box 3
PA142671677	127540	HMGB4	chr1	34316076	34333392	17316	high mobility group box 4
PA29336	3155	HMGCL	chr1	24125367	24175110	49743	3-hydroxymethyl-3-methylglutaryl-CoA lyase
PA134989971	54511	HMGCLL1	chr6	55296171	55454012	157841	3-hydroxymethyl-3-methylglutaryl-CoA lyase-like 1
PA189	3156	HMGCR	chr5	74622159	74660926	38767	3-hydroxy-3-methylglutaryl-CoA reductase
PA29337	3157	HMGCS1	chr5	43284572	43323614	39042	3-hydroxy-3-methylglutaryl-CoA synthase 1 (soluble)
PA29338	3158	HMGCS2	chr1	120287619	120321555	33936	3-hydroxy-3-methylglutaryl-CoA synthase 2 (mitochondrial)
PA35088	3150	HMGN1	chr21	40711241	40731047	19806	high mobility group nucleosome binding domain 1
PA35089	3151	HMGN2	chr1	26788902	26806133	17231	high mobility group nucleosomal binding domain 2
PA36990	9324	HMGN3	chr6	79907962	79954455	46493	high mobility group nucleosomal binding domain 3
PA35090	10473	HMGN4	chr6	26528572	26550165	21593	high mobility group nucleosomal binding domain 4
PA31789	79366	HMGN5	chrX	80366200	80467441	101241	high mobility group nucleosome binding domain 5
PA164720627	22993	HMGXB3	chr5	149370169	149435706	65537	HMG box domain containing 3
PA164720673	10042	HMGXB4	chr22	35643445	35694800	51355	HMG box domain containing 4
PA128394633	23526	HMHA1	chr19	1055922	1089627	33705	histocompatibility (minor) HA-1
PA147357973	57824	HMHB1	chr5	143181726	143203284	21558	histocompatibility (minor) HB-1
PA29340	3161	HMMR	chr5	162877517	162921951	44434	hyaluronan-mediated motility receptor (RHAMM)
PA29341	3162	HMOX1	chr22	35767060	35793207	26147	heme oxygenase (decycling) 1
PA29342	3163	HMOX2	chr16	4514719	4563348	48629	heme oxygenase (decycling) 2
PA162391030	284293	HMSD	chr18	61606588	61630646	24058	histocompatibility (minor) serpin domain containing
PA29344	3166	HMX1	chr4	8844803	8883543	38740	H6 family homeobox 1
PA29345	3167	HMX2	chr10	124892006	124913188	21182	H6 family homeobox 2
PA29346	340784	HMX3	chr10	124885567	124900247	14680	H6 family homeobox 3
PA29347	51155	HN1	chr17	73128343	73160775	32432	hematological and neurological expressed 1
PA162391043	90861	HN1L	chr16	1718201	1755073	36872	hematological and neurological expressed 1-like
PA36380	6927	HNF1A	chr12	121405861	121443315	37454	HNF1 homeobox A
PA162391083	6928	HNF1B	chr17	36043434	36115096	71662	HNF1 homeobox B
PA29349	3172	HNF4A	chr20	42974441	43064485	90044	hepatocyte nuclear factor 4, alpha
PA29351	3174	HNF4G	chr8	76442203	76482069	39866	hepatocyte nuclear factor 4, gamma
PA190	3176	HNMT	chr2	138711808	138776934	65126	histamine N-methyltransferase
PA162391106	10949	HNRNPA0	chr5	137084073	137100039	15966	heterogeneous nuclear ribonucleoprotein A0
PA162391113	3178	HNRNPA1	chr12	54664480	54683871	19391	heterogeneous nuclear ribonucleoprotein A1
PA164720701	144983	HNRNPA1L2	chr13	53163750	53220931	57181	heterogeneous nuclear ribonucleoprotein A1-like 2
PA162391140	3181	HNRNPA2B1	chr7	26226547	26250413	23866	heterogeneous nuclear ribonucleoprotein A2/B1
PA162391169	220988	HNRNPA3	chr2	178066063	178091687	25624	heterogeneous nuclear ribonucleoprotein A3
PA162391196	3182	HNRNPAB	chr5	177621508	177641184	19676	heterogeneous nuclear ribonucleoprotein A/B
PA162391217	3183	HNRNPC	chr14	21674295	21747638	73343	heterogeneous nuclear ribonucleoprotein C (C1/C2)
PA162391240	343069	HNRNPCL1	chr1	12904261	12918578	14317	heterogeneous nuclear ribonucleoprotein C-like 1
PA29361	3184	HNRNPD	chr4	83271467	83305149	33682	heterogeneous nuclear ribonucleoprotein D (AU-rich element RNA binding protein 1, 37kDa)
PA29362	9987	HNRNPDL	chr4	83340717	83361378	20661	heterogeneous nuclear ribonucleoprotein D-like
PA162391271	3185	HNRNPF	chr10	43878065	43914696	36631	heterogeneous nuclear ribonucleoprotein F
PA162391284	3187	HNRNPH1	chr5	179038179	179060722	22543	heterogeneous nuclear ribonucleoprotein H1 (H)
PA162391316	3188	HNRNPH2	chrX	100653121	100672128	19007	heterogeneous nuclear ribonucleoprotein H2 (H')
PA162391325	3189	HNRNPH3	chr10	70081768	70105953	24185	heterogeneous nuclear ribonucleoprotein H3 (2H9)
PA162391350	3190	HNRNPK	chr9	86579998	86605692	25694	heterogeneous nuclear ribonucleoprotein K
PA162391389	3191	HNRNPL	chr19	39324028	39352979	28951	heterogeneous nuclear ribonucleoprotein L
PA134987080	92906	HNRNPLL	chr2	38786120	38840178	54058	heterogeneous nuclear ribonucleoprotein L-like
PA29370	4670	HNRNPM	chr19	8499460	8557002	57542	heterogeneous nuclear ribonucleoprotein M
PA162391459	10236	HNRNPR	chr1	23632953	23681143	48190	heterogeneous nuclear ribonucleoprotein R
PA162391486	3192	HNRNPU	chr1	245010602	245037827	27225	heterogeneous nuclear ribonucleoprotein U (scaffold attachment factor A)
PA162391519	11100	HNRNPUL1	chr19	41758391	41816811	58420	heterogeneous nuclear ribonucleoprotein U-like 1
PA162391554	221092	HNRNPUL2	chr11	62477097	62504857	27760	heterogeneous nuclear ribonucleoprotein U-like 2
PA165548441	112817	HOGA1	chr10	99334102	99375559	41457	4-hydroxy-2-oxoglutarate aldolase 1
PA134972608	9456	HOMER1	chr5	78666647	78819659	153012	homer homolog 1 (Drosophila)
PA134870500	9455	HOMER2	chr15	83514729	83664905	150176	homer homolog 2 (Drosophila)
PA134988320	9454	HOMER3	chr19	19037010	19062041	25031	homer homolog 3 (Drosophila)
PA162391555	57594	HOMEZ	chr14	23739844	23772862	33018	homeobox and leucine zipper encoding
PA134945565	51361	HOOK1	chr1	60270458	60345050	74592	hook microtubule-tethering protein 1
PA134986864	29911	HOOK2	chr19	12870817	12899248	28431	hook microtubule-tethering protein 2
PA134961305	84376	HOOK3	chr8	42742033	42888682	146649	hook microtubule-tethering protein 3
PA162391564	84525	HOPX	chr4	57511154	57557874	46720	HOP homeobox
PA134930374	84072	HORMAD1	chr1	150667535	150703372	35837	HORMA domain containing 1
PA134889862	150280	HORMAD2	chr22	30466453	30576064	109611	HORMA domain containing 2
PA29376	3198	HOXA1	chr7	27129612	27145625	16013	homeobox A1
PA29377	3206	HOXA10	chr7	27207210	27229880	22670	homeobox A10
PA29378	3207	HOXA11	chr7	27217776	27234835	17059	homeobox A11
PA29379	3209	HOXA13	chr7	27233499	27249725	16226	homeobox A13
PA29380	3199	HOXA2	chr7	27136973	27152394	15421	homeobox A2
PA29381	3200	HOXA3	chr7	27142803	27189805	47002	homeobox A3
PA29382	3201	HOXA4	chr7	27165126	27180399	15273	homeobox A4
PA29383	3202	HOXA5	chr7	27177671	27202309	24638	homeobox A5
PA29384	3203	HOXA6	chr7	27182202	27197393	15191	homeobox A6
PA29385	3204	HOXA7	chr7	27190335	27206296	15961	homeobox A7
PA29386	3205	HOXA9	chr7	27199057	27215149	16092	homeobox A9
PA29387	3211	HOXB1	chr17	46603807	46618272	14465	homeobox B1
PA29388	10481	HOXB13	chr17	46799125	46816111	16986	homeobox B13
PA29389	3212	HOXB2	chr17	46617017	46632393	15376	homeobox B2
PA29390	3213	HOXB3	chr17	46623232	46677634	54402	homeobox B3
PA29391	3214	HOXB4	chr17	46649869	46665743	15874	homeobox B4
PA29392	3215	HOXB5	chr17	46665619	46681103	15484	homeobox B5
PA29393	3216	HOXB6	chr17	46670099	46692343	22244	homeobox B6
PA29394	3217	HOXB7	chr17	46681594	46698383	16789	homeobox B7
PA29395	3218	HOXB8	chr17	46686708	46702474	15766	homeobox B8
PA29396	3219	HOXB9	chr17	46695518	46713835	18317	homeobox B9
PA29397	3226	HOXC10	chr12	54364466	54387063	22597	homeobox C10
PA29398	3227	HOXC11	chr12	54356910	54373203	16293	homeobox C11
PA29399	3228	HOXC12	chr12	54338714	54353350	14636	homeobox C12
PA29400	3229	HOXC13	chr12	54322576	54343328	20752	homeobox C13
PA29401	3221	HOXC4	chr12	54378716	54452814	74098	homeobox C4
PA29402	3222	HOXC5	chr12	54400642	54432145	31503	homeobox C5
PA29403	3223	HOXC6	chr12	54400642	54427607	26965	homeobox C6
PA29404	3224	HOXC8	chr12	54392890	54409547	16657	homeobox C8
PA29405	3225	HOXC9	chr12	54383877	54400121	16244	homeobox C9
PA29406	3231	HOXD1	chr2	177043307	177058635	15328	homeobox D1
PA29407	3236	HOXD10	chr2	176971492	176987670	16178	homeobox D10
PA29408	3237	HOXD11	chr2	176961721	176979563	17842	homeobox D11
PA29409	3238	HOXD12	chr2	176954530	176968488	13958	homeobox D12
PA29410	3239	HOXD13	chr2	176947532	176963666	16134	homeobox D13
PA29411	3232	HOXD3	chr2	176991669	177046737	55068	homeobox D3
PA29412	3233	HOXD4	chr2	177005122	177020951	15829	homeobox D4
PA29413	3234	HOXD8	chr2	176984422	177000423	16001	homeobox D8
PA29414	3235	HOXD9	chr2	176977413	176992645	15232	homeobox D9
PA29415	3240	HP	chr16	72078470	72097955	19485	haptoglobin
PA142671673	50809	HP1BP3	chr1	21066170	21123808	57638	heterochromatin protein 1, binding protein 3
PA29417	3208	HPCA	chr1	33341688	33363247	21559	hippocalcin
PA29418	3241	HPCAL1	chr2	10433015	10570743	137728	hippocalcin-like 1
PA134924885	51440	HPCAL4	chr1	40141320	40167382	26062	hippocalcin like 4
PA29420	3242	HPD	chr12	122274433	122336517	62084	4-hydroxyphenylpyruvate dioxygenase
PA162391595	84842	HPDL	chr1	45782545	45797347	14802	4-hydroxyphenylpyruvate dioxygenase-like
PA29424	3248	HPGD	chr4	175408328	175454049	45721	hydroxyprostaglandin dehydrogenase 15-(NAD)
PA165664133	27306	HPGDS	chr4	95216707	95274027	57320	hematopoietic prostaglandin D synthase
PA29425	3249	HPN	chr19	35521410	35560481	39071	hepsin
PA29426	3250	HPR	chr16	72087125	72114145	27020	haptoglobin-related protein
PA29427	3251	HPRT1	chrX	133584175	133637698	53523	hypoxanthine phosphoribosyltransferase 1
PA35101	3257	HPS1	chr10	100172955	100216720	43765	Hermansky-Pudlak syndrome 1
PA29433	84343	HPS3	chr3	148837371	148894305	56934	Hermansky-Pudlak syndrome 3
PA29434	89781	HPS4	chr22	26843848	26889829	45981	Hermansky-Pudlak syndrome 4
PA38432	11234	HPS5	chr11	18297217	18353751	56534	Hermansky-Pudlak syndrome 5
PA134989637	79803	HPS6	chr10	103815124	103830795	15671	Hermansky-Pudlak syndrome 6
PA29435	10855	HPSE	chr4	84210614	84266306	55692	heparanase
PA38533	60495	HPSE2	chr10	100213834	101005632	791798	heparanase 2 (inactive)
PA29441	3263	HPX	chr11	6449268	6472254	22986	hemopexin
PA29443	55806	HR	chr8	21968932	21998566	29634	hair growth associated
PA29444	3265	HRAS	chr11	529242	545561	16319	Harvey rat sarcoma viral oncogene homolog
PA29445	57110	HRASLS	chr3	192938030	193028102	90072	HRAS-like suppressor
PA29446	54979	HRASLS2	chr11	63317242	63340855	23613	HRAS-like suppressor 2
PA142671672	117245	HRASLS5	chr11	63225876	63268680	42804	HRAS-like suppressor family, member 5
PA29452	3270	HRC	chr19	49651455	49668686	17231	histidine rich calcium binding protein
PA164720718	646962	HRCT1	chr9	35896189	35910138	13949	histidine rich carboxyl terminus 1
PA29455	3273	HRG	chr3	186373747	186399023	25276	histidine-rich glycoprotein
PA29456	3269	HRH1	chr3	11168779	11307939	139160	histamine receptor H1
PA29457	3274	HRH2	chr5	175074847	175139239	64392	histamine receptor H2
PA29458	11255	HRH3	chr20	60787017	60805323	18306	histamine receptor H3
PA134982275	59340	HRH4	chr18	22030593	22062921	32328	histamine receptor H4
PA29459	8739	HRK	chr12	117295225	117329232	34007	harakiri, BCL2 interacting protein
PA134936141	388697	HRNR	chr1	152181552	152206672	25120	hornerin
PA134890258	10247	HRSP12	chr8	99111567	99139418	27851	heat-responsive protein 12
PA162391602	64342	HS1BP3	chr2	20814564	20860867	46303	HCLS1 binding protein 3
PA29466	9653	HS2ST1	chr1	87370335	87578681	208346	heparan sulfate 2-O-sulfotransferase 1
PA29467	9957	HS3ST1	chr4	11396988	11441255	44267	heparan sulfate (glucosamine) 3-O-sulfotransferase 1
PA29468	9956	HS3ST2	chr16	22815860	22930659	114799	heparan sulfate (glucosamine) 3-O-sulfotransferase 2
PA29469	9955	HS3ST3A1	chr17	13396006	13515244	119238	heparan sulfate (glucosamine) 3-O-sulfotransferase 3A1
PA29471	9953	HS3ST3B1	chr17	14194367	14255721	61354	heparan sulfate (glucosamine) 3-O-sulfotransferase 3B1
PA29473	9951	HS3ST4	chr16	25693347	26152009	458662	heparan sulfate (glucosamine) 3-O-sulfotransferase 4
PA164741639	222537	HS3ST5	chr6	114373750	114673540	299790	heparan sulfate (glucosamine) 3-O-sulfotransferase 5
PA29474	64711	HS3ST6	chr16	1958464	1978231	19767	heparan sulfate (glucosamine) 3-O-sulfotransferase 6
PA35102	9394	HS6ST1	chr2	129020054	129086171	66117	heparan sulfate 6-O-sulfotransferase 1
PA134950831	90161	HS6ST2	chrX	131757038	132105423	348385	heparan sulfate 6-O-sulfotransferase 2
PA134879312	266722	HS6ST3	chr13	96733093	97494816	761723	heparan sulfate 6-O-sulfotransferase 3
PA29475	3281	HSBP1	chr16	83831508	83849607	18099	heat shock factor binding protein 1
PA165429036	440498	HSBP1L1	chr18	77714582	77733822	19240	heat shock factor binding protein 1-like 1
PA162391621	150274	HSCB	chr22	29128008	29156506	28498	HscB mitochondrial iron-sulfur cluster co-chaperone
PA29476	3290	HSD11B1	chr1	209849525	209911295	61770	hydroxysteroid (11-beta) dehydrogenase 1
PA144596423	374875	HSD11B1L	chr19	5670776	5691534	20758	hydroxysteroid (11-beta) dehydrogenase 1-like
PA29477	3291	HSD11B2	chr16	67455036	67474456	19420	hydroxysteroid (11-beta) dehydrogenase 2
PA29478	3292	HSD17B1	chr17	40693984	40710232	16248	hydroxysteroid (17-beta) dehydrogenase 1
PA162391638	3028	HSD17B10	chrX	53455206	53471323	16117	hydroxysteroid (17-beta) dehydrogenase 10
PA162391655	51170	HSD17B11	chr4	88254691	88322455	67764	hydroxysteroid (17-beta) dehydrogenase 11
PA38618	51144	HSD17B12	chr11	43692108	43881169	189061	hydroxysteroid (17-beta) dehydrogenase 12
PA38634	345275	HSD17B13	chr4	88221941	88254056	32115	hydroxysteroid (17-beta) dehydrogenase 13
PA162391674	51171	HSD17B14	chr19	49313274	49349935	36661	hydroxysteroid (17-beta) dehydrogenase 14
PA29485	643646	HSD17B1P1	chr17	40687797	40703993	16196	hydroxysteroid (17-beta) dehydrogenase 1 pseudogene 1
PA29479	3294	HSD17B2	chr16	82058842	82135139	76297	hydroxysteroid (17-beta) dehydrogenase 2
PA29480	3293	HSD17B3	chr9	98994588	99074662	80074	hydroxysteroid (17-beta) dehydrogenase 3
PA29481	3295	HSD17B4	chr5	118778138	118881030	102892	hydroxysteroid (17-beta) dehydrogenase 4
PA142671671	8630	HSD17B6	chr12	57136237	57184574	48337	hydroxysteroid (17-beta) dehydrogenase 6
PA29483	51478	HSD17B7	chr1	162750496	162785608	35112	hydroxysteroid (17-beta) dehydrogenase 7
PA29484	7923	HSD17B8	chr6	33162414	33177608	15194	hydroxysteroid (17-beta) dehydrogenase 8
PA29486	3283	HSD3B1	chr1	120039826	120060681	20855	hydroxy-delta-5-steroid dehydrogenase, 3 beta- and steroid delta-isomerase 1
PA29487	3284	HSD3B2	chr1	119947554	119968662	21108	hydroxy-delta-5-steroid dehydrogenase, 3 beta- and steroid delta-isomerase 2
PA134940289	80270	HSD3B7	chr16	30985949	31003473	17524	hydroxy-delta-5-steroid dehydrogenase, 3 beta- and steroid delta-isomerase 7
PA134988345	83693	HSDL1	chr16	84152744	84188800	36056	hydroxysteroid dehydrogenase like 1
PA134980105	84263	HSDL2	chr9	115132189	115237685	105496	hydroxysteroid dehydrogenase like 2
PA29493	3297	HSF1	chr8	145505270	145541385	36115	heat shock transcription factor 1
PA29494	3298	HSF2	chr6	122710696	122757264	46568	heat shock transcription factor 2
PA29495	11077	HSF2BP	chr21	44946066	45089380	143314	heat shock transcription factor 2 binding protein
PA29496	3299	HSF4	chr16	67187288	67206848	19560	heat shock transcription factor 4
PA145008204	124535	HSF5	chr17	56494528	56575759	81231	heat shock transcription factor family member 5
PA145008220	100506164	HSFX1	chrX	148845726	148861517	15791	heat shock transcription factor family, X linked 1
PA145008228	100130086	HSFX2	chrX	148671172	148686974	15802	heat shock transcription factor family, X linked 2
PA38580	86614	HSFY1	chrY	20698574	20753849	55275	heat shock transcription factor, Y-linked 1
PA134894795	159119	HSFY2	chrY	20890326	20945621	55295	heat shock transcription factor, Y linked 2
PA134927763	84941	HSH2D	chr19	16234838	16272381	37543	hematopoietic SH2 domain containing
PA29519	3320	HSP90AA1	chr14	102544075	102616086	72011	heat shock protein 90kDa alpha (cytosolic), class A member 1
PA29524	3326	HSP90AB1	chr6	44203903	44224625	20722	heat shock protein 90kDa alpha (cytosolic), class B member 1
PA36705	7184	HSP90B1	chr12	104314112	104344708	30596	heat shock protein 90kDa beta (Grp94), member 1
PA38779	259217	HSPA12A	chr10	118427703	118619693	191990	heat shock 70kDa protein 12A
PA25771	116835	HSPA12B	chr20	3703317	3736758	33441	heat shock 70kD protein 12B
PA162391697	6782	HSPA13	chr21	15740436	15765509	25073	heat shock protein 70kDa family, member 13
PA134979057	51182	HSPA14	chr10	14870159	14916740	46581	heat shock 70kDa protein 14
PA29498	3303	HSPA1A	chr6	31772952	31788719	15767	heat shock 70kDa protein 1A
PA29499	3304	HSPA1B	chr6	31779964	31801032	21068	heat shock 70kDa protein 1B
PA29500	3305	HSPA1L	chr6	31774396	31800093	25697	heat shock 70kDa protein 1-like
PA29501	3306	HSPA2	chr14	64997186	65012955	15769	heat shock 70kDa protein 2
PA29503	3308	HSPA4	chr5	132377662	132443709	66047	heat shock 70kDa protein 4
PA134905749	22824	HSPA4L	chr4	128693453	128758228	64775	heat shock 70kDa protein 4-like
PA29504	3309	HSPA5	chr9	127994127	128013666	19539	heat shock 70kDa protein 5 (glucose-regulated protein, 78kDa)
PA29505	3310	HSPA6	chr1	161484036	161499687	15651	heat shock 70kDa protein 6 (HSP70B')
PA29507	3312	HSPA8	chr11	122925200	122943074	17874	heat shock 70kDa protein 8
PA162391712	3313	HSPA9	chr5	137887571	137921318	33747	heat shock 70kDa protein 9 (mortalin)
PA29511	3315	HSPB1	chr7	75921875	75936614	14739	heat shock 27kDa protein 1
PA162391751	51668	HSPB11	chr1	54384234	54421975	37741	heat shock protein family B (small), member 11
PA29512	3316	HSPB2	chr11	111773460	111787817	14357	heat shock 27kDa protein 2
PA29513	8988	HSPB3	chr5	53741431	53755214	13783	heat shock 27kDa protein 3
PA134983584	126393	HSPB6	chr19	36242467	36257930	15463	heat shock protein, alpha-crystallin-related, B6
PA29514	27129	HSPB7	chr1	16337523	16356084	18561	heat shock 27kDa protein family, member 7 (cardiovascular)
PA134900173	26353	HSPB8	chr12	119606595	119635551	28956	heat shock 22kDa protein 8
PA134875756	94086	HSPB9	chr17	40264756	40278371	13615	heat shock protein, alpha-crystallin-related, B9
PA29515	79663	HSPBAP1	chr3	122455844	122522666	66822	HSPB (heat shock 27kDa) associated protein 1
PA164720725	23640	HSPBP1	chr19	55770591	55801751	31160	HSPA (heat shock 70kDa) binding protein, cytoplasmic cochaperone 1
PA29527	3329	HSPD1	chr2	198348308	198374998	26690	heat shock 60kDa protein 1 (chaperonin)
PA29535	3336	HSPE1	chr2	198354721	198371187	16466	heat shock 10kDa protein 1
PA29537	3339	HSPG2	chr1	22145737	22273750	128013	heparan sulfate proteoglycan 2
PA134869917	10808	HSPH1	chr13	31707762	31747246	39484	heat shock 105kDa/110kDa protein 1
PA29539	10553	HTATIP2	chr11	20375231	20408329	33098	HIV-1 Tat interactive protein 2, 30kDa
PA29540	27336	HTATSF1	chrX	135569238	135597505	28267	HIV-1 Tat specific factor 1
PA29546	3346	HTN1	chr4	70906159	70927559	21400	histatin 1
PA29547	3347	HTN3	chr4	70884130	70905255	21125	histatin 3
PA192	3350	HTR1A	chr5	63252875	63268119	15244	5-hydroxytryptamine (serotonin) receptor 1A, G protein-coupled
PA29549	3351	HTR1B	chr6	78168948	78183120	14172	5-hydroxytryptamine (serotonin) receptor 1B, G protein-coupled
PA29550	3352	HTR1D	chr1	23515388	23531222	15834	5-hydroxytryptamine (serotonin) receptor 1D, G protein-coupled
PA29552	3354	HTR1E	chr6	87637024	87729397	92373	5-hydroxytryptamine (serotonin) receptor 1E, G protein-coupled
PA29553	3355	HTR1F	chr3	87831929	88046964	215035	5-hydroxytryptamine (serotonin) receptor 1F, G protein-coupled
PA193	3356	HTR2A	chr13	47402677	47481211	78534	5-hydroxytryptamine (serotonin) receptor 2A, G protein-coupled
PA29554	3357	HTR2B	chr2	231969944	231999926	29982	5-hydroxytryptamine (serotonin) receptor 2B, G protein-coupled
PA194	3358	HTR2C	chrX	113808551	114147624	339073	5-hydroxytryptamine (serotonin) receptor 2C, G protein-coupled
PA29555	3359	HTR3A	chr11	113835797	113864035	28238	5-hydroxytryptamine (serotonin) receptor 3A, ionotropic
PA29556	9177	HTR3B	chr11	113765518	113820283	54765	5-hydroxytryptamine (serotonin) receptor 3B, ionotropic
PA134925741	170572	HTR3C	chr3	183760835	183781461	20626	5-hydroxytryptamine (serotonin) receptor 3C, ionotropic
PA134866755	200909	HTR3D	chr3	183739332	183760157	20825	5-hydroxytryptamine (serotonin) receptor 3D, ionotropic
PA134900226	285242	HTR3E	chr3	183804852	183827783	22931	5-hydroxytryptamine (serotonin) receptor 3E, ionotropic
PA29557	3360	HTR4	chr5	147827595	148044090	216495	5-hydroxytryptamine (serotonin) receptor 4, G protein-coupled
PA29558	3361	HTR5A	chr7	154852034	154882102	30068	5-hydroxytryptamine (serotonin) receptor 5A, G protein-coupled
PA29560	3362	HTR6	chr1	19981780	20009055	27275	5-hydroxytryptamine (serotonin) receptor 6, G protein-coupled
PA29561	3363	HTR7	chr10	92497575	92627671	130096	5-hydroxytryptamine (serotonin) receptor 7, adenylate cyclase-coupled
PA33829	5654	HTRA1	chr10	124211041	124277424	66383	HtrA serine peptidase 1
PA33836	27429	HTRA2	chr2	74746532	74763683	17151	HtrA serine peptidase 2
PA134908281	94031	HTRA3	chr4	8261487	8311838	50351	HtrA serine peptidase 3
PA134862039	203100	HTRA4	chr8	38821668	38849181	27513	HtrA serine peptidase 4
PA164741646	3064	HTT	chr4	3066408	3248687	182279	huntingtin
PA29563	30811	HUNK	chr21	33235628	33379377	143749	hormonally up-regulated Neu-associated kinase
PA29564	3364	HUS1	chr7	47999885	48029222	29337	HUS1 checkpoint homolog (S. pombe)
PA134939889	135458	HUS1B	chr6	652939	666964	14025	HUS1 checkpoint homolog b (S. pombe)
PA128394567	10075	HUWE1	chrX	53556057	53723697	167640	HECT, UBA and WWE domain containing 1, E3 ubiquitin protein ligase
PA144596422	84329	HVCN1	chr12	111083491	111140276	56785	hydrogen voltage-gated channel 1
PA29571	3373	HYAL1	chr3	50334320	50359812	25492	hyaluronoglucosaminidase 1
PA29572	8692	HYAL2	chr3	50352221	50370281	18060	hyaluronoglucosaminidase 2
PA29573	8372	HYAL3	chr3	50327259	50346899	19640	hyaluronoglucosaminidase 3
PA29574	23553	HYAL4	chr7	123475220	123520532	45312	hyaluronoglucosaminidase 4
PA134866950	54768	HYDIN	chr16	70838287	71274625	436338	HYDIN, axonemal central pair apparatus protein
PA142671668	81888	HYI	chr1	43913674	43929938	16264	hydroxypyruvate isomerase (putative)
PA165478483	123688	HYKK	chr15	78789906	78832715	42809	hydroxylysine kinase
PA142671669	219844	HYLS1	chr11	125743509	125773541	30032	hydrolethalus syndrome 1
PA38427	10525	HYOU1	chr11	118911896	118937951	26055	hypoxia up-regulated 1
PA165478509	25764	HYPK	chr15	44082619	44097787	15168	huntingtin interacting protein K
PA134943086	25763	HYPM	chrX	37840070	37853570	13500	huntingtin interacting protein M
PA162391893	285148	IAH1	chr2	9604670	9631604	26934	isoamyl acetate-hydrolyzing esterase 1 homolog (S. cerevisiae)
PA29579	3375	IAPP	chr12	21515802	21535914	20112	islet amyloid polypeptide
PA29580	3376	IARS	chr9	94969489	95066038	96549	isoleucyl-tRNA synthetase
PA142671670	55699	IARS2	chr1	220257455	220324383	66928	isoleucyl-tRNA synthetase 2, mitochondrial
PA142672519	200205	IBA57	chr1	228343429	228372958	29529	IBA57, iron-sulfur cluster assembly homolog (S. cerevisiae)
PA29590	3381	IBSP	chr4	88710702	88736601	25899	integrin-binding sialoprotein
PA134898277	25998	IBTK	chr6	82876956	82967448	90492	inhibitor of Bruton agammaglobulinemia tyrosine kinase
PA29591	3382	ICA1	chr7	8149814	8312242	162428	islet cell autoantigen 1, 69kDa
PA24738	130026	ICA1L	chr2	203634873	203746708	111835	islet cell autoantigen 1,69kDa-like
PA29592	3383	ICAM1	chr19	10370707	10400291	29584	intercellular adhesion molecule 1
PA29593	3384	ICAM2	chr17	62076955	62107994	31039	intercellular adhesion molecule 2
PA29594	3385	ICAM3	chr19	10441452	10460345	18893	intercellular adhesion molecule 3
PA29595	3386	ICAM4	chr19	10387643	10402260	14617	intercellular adhesion molecule 4 (Landsteiner-Wiener blood group)
PA29596	7087	ICAM5	chr19	10390655	10410454	19799	intercellular adhesion molecule 5, telencephalin
PA162411094	23379	ICE1	chr5	5412807	5493338	80531	interactor of little elongation complex ELL subunit 1
PA134960292	79664	ICE2	chr15	60708808	60781344	72536	interactor of little elongation complex ELL subunit 2
PA134894544	22858	ICK	chr6	52863097	52936676	73579	intestinal cell (MAK-like) kinase
PA29598	23463	ICMT	chr1	6278253	6306044	27791	isoprenylcysteine carboxyl methyltransferase
PA29599	29851	ICOS	chr2	204791454	204829302	37848	inducible T-cell co-stimulator
PA134977297	23308	ICOSLG	chr21	45639874	45670881	31007	inducible T-cell co-stimulator ligand
PA29607	3396	ICT1	chr17	72998760	73020356	21596	immature colon carcinoma transcript 1
PA29608	3397	ID1	chr20	30183086	30197318	14232	inhibitor of DNA binding 1, dominant negative helix-loop-helix protein
PA29609	3398	ID2	chr2	8812113	8827583	15470	inhibitor of DNA binding 2, dominant negative helix-loop-helix protein
PA29610	3399	ID3	chr1	23881421	23896285	14864	inhibitor of DNA binding 3, dominant negative helix-loop-helix protein
PA29611	3400	ID4	chr6	19827579	19845431	17852	inhibitor of DNA binding 4, dominant negative helix-loop-helix protein
PA29629	3416	IDE	chr10	94208441	94343852	135411	insulin-degrading enzyme
PA29630	3417	IDH1	chr2	209097951	209130478	32527	isocitrate dehydrogenase 1 (NADP+), soluble
PA29631	3418	IDH2	chr15	90623283	90655730	32447	isocitrate dehydrogenase 2 (NADP+), mitochondrial
PA29632	3419	IDH3A	chr15	78431698	78465884	34186	isocitrate dehydrogenase 3 (NAD+) alpha
PA29633	3420	IDH3B	chr20	2636041	2654865	18824	isocitrate dehydrogenase 3 (NAD+) beta
PA29634	3421	IDH3G	chrX	153048221	153069978	21757	isocitrate dehydrogenase 3 (NAD+) gamma
PA29635	3422	IDI1	chr10	1082963	1105061	22098	isopentenyl-diphosphate delta isomerase 1
PA134935136	91734	IDI2	chr10	1061847	1081799	19952	isopentenyl-diphosphate delta isomerase 2
PA134880846	414328	IDNK	chr9	86227964	86262045	34081	idnK, gluconokinase homolog (E. coli)
PA29869	3620	IDO1	chr8	39761328	39789309	27981	indoleamine 2,3-dioxygenase 1
PA164720782	169355	IDO2	chr8	39782474	39876910	94436	indoleamine 2,3-dioxygenase 2
PA29636	3423	IDS	chrX	148557295	148596884	39589	iduronate 2-sulfatase
PA29638	3425	IDUA	chr4	970785	1001317	30532	iduronidase, alpha-L-
PA134982230	9592	IER2	chr19	13251282	13268722	17440	immediate early response 2
PA29639	8870	IER3	chr6	30707976	30722327	14351	immediate early response 3
PA134899219	51124	IER3IP1	chr18	44678390	44712745	34355	immediate early response 3 interacting protein 1
PA29640	51278	IER5	chr1	181047638	181062979	15341	immediate early response 5
PA134879111	389792	IER5L	chr9	131934831	131950540	15709	immediate early response 5-like
PA164720809	25900	IFFO1	chr12	6645694	6675249	29555	intermediate filament family orphan 1
PA164720824	126917	IFFO2	chr1	19227774	19292826	65052	intermediate filament family orphan 2
PA29642	3428	IFI16	chr1	158969682	159027945	58263	interferon, gamma-inducible protein 16
PA29643	3429	IFI27	chr14	94567079	94586033	18954	interferon, alpha-inducible protein 27
PA164720846	122509	IFI27L1	chr14	94537639	94572060	34421	interferon, alpha-inducible protein 27-like 1
PA164720861	83982	IFI27L2	chr14	94591118	94605957	14839	interferon, alpha-inducible protein 27-like 2
PA29644	10437	IFI30	chr19	18274590	18291934	17344	interferon, gamma-inducible protein 30
PA29645	3430	IFI35	chr17	41148742	41169476	20734	interferon-induced protein 35
PA29647	10561	IFI44	chr1	79105477	79132763	27286	interferon-induced protein 44
PA25615	10964	IFI44L	chr1	79076067	79114830	38763	interferon-induced protein 44-like
PA28466	2537	IFI6	chr1	27989572	28008724	19152	interferon, alpha-inducible protein 6
PA134889215	64135	IFIH1	chr2	163120589	163185218	64629	interferon induced with helicase C domain 1
PA29648	3434	IFIT1	chr10	91142303	91169244	26941	interferon-induced protein with tetratricopeptide repeats 1
PA165548753	439996	IFIT1B	chr10	91127813	91147962	20149	interferon-induced protein with tetratricopeptide repeats 1B
PA29650	3433	IFIT2	chr10	91051706	91072033	20327	interferon-induced protein with tetratricopeptide repeats 2
PA29651	3437	IFIT3	chr10	91077602	91103725	26123	interferon-induced protein with tetratricopeptide repeats 3
PA134988392	24138	IFIT5	chr10	91164031	91183759	19728	interferon-induced protein with tetratricopeptide repeats 5
PA29653	8519	IFITM1	chr11	303991	318272	14281	interferon induced transmembrane protein 1
PA29654	10581	IFITM2	chr11	298095	312410	14315	interferon induced transmembrane protein 2
PA29655	10410	IFITM3	chr11	316673	330914	14241	interferon induced transmembrane protein 3
PA162391894	387733	IFITM5	chr11	295200	309526	14326	interferon induced transmembrane protein 5
PA29656	3439	IFNA1	chr9	21430453	21444315	13862	interferon, alpha 1
PA29657	3446	IFNA10	chr9	21203180	21217142	13962	interferon, alpha 10
PA29658	3447	IFNA13	chr9	21364371	21378075	13704	interferon, alpha 13
PA29659	3448	IFNA14	chr9	21236201	21249978	13777	interferon, alpha 14
PA29660	3449	IFNA16	chr9	21213372	21227310	13938	interferon, alpha 16
PA29661	3451	IFNA17	chr9	21224242	21238221	13979	interferon, alpha 17
PA29662	3440	IFNA2	chr9	21381254	21395396	14142	interferon, alpha 2
PA29663	3452	IFNA21	chr9	21162636	21176659	14023	interferon, alpha 21
PA29664	3441	IFNA4	chr9	21183617	21197598	13981	interferon, alpha 4
PA29665	3442	IFNA5	chr9	21301613	21315312	13699	interferon, alpha 5
PA29666	3443	IFNA6	chr9	21347317	21360886	13569	interferon, alpha 6
PA29667	3444	IFNA7	chr9	21198468	21212204	13736	interferon, alpha 7
PA29668	3445	IFNA8	chr9	21399146	21413184	14038	interferon, alpha 8
PA29670	3454	IFNAR1	chr21	34686748	34735129	48381	interferon (alpha, beta and omega) receptor 1
PA29671	3455	IFNAR2	chr21	34592231	34639831	47600	interferon (alpha, beta and omega) receptor 2
PA29672	3456	IFNB1	chr9	21074104	21087943	13839	interferon, beta 1, fibroblast
PA164720874	338376	IFNE	chr9	21477838	21492312	14474	interferon, epsilon
PA29674	3458	IFNG	chr12	68545550	68563521	17971	interferon, gamma
PA29675	3459	IFNGR1	chr6	137515621	137550981	35360	interferon gamma receptor 1
PA29676	3460	IFNGR2	chr21	34765202	34812828	47626	interferon gamma receptor 2 (interferon gamma transducer 1)
PA134970126	56832	IFNK	chr9	27514312	27529496	15184	interferon, kappa
PA134899000	282618	IFNL1	chr19	39776965	39792312	15347	interferon, lambda 1
PA134934396	282616	IFNL2	chr19	39749157	39763732	14575	interferon, lambda 2
PA134952671	282617	IFNL3	chr19	39731272	39745916	14644	interferon, lambda 3
PA134984880	163702	IFNLR1	chr1	24477647	24523765	46118	interferon, lambda receptor 1
PA29683	3467	IFNW1	chr9	21137631	21152144	14513	interferon, omega 1
PA29691	3475	IFRD1	chr7	112053199	112120258	67059	interferon-related developmental regulator 1
PA29692	7866	IFRD2	chr3	50322163	50340648	18485	interferon-related developmental regulator 2
PA37798	55764	IFT122	chr3	129148671	129242350	93679	intraflagellar transport 122
PA142671665	9742	IFT140	chr16	1557428	1672109	114681	intraflagellar transport 140
PA142671666	26160	IFT172	chr2	27664240	27722575	58335	intraflagellar transport 172
PA142671663	90410	IFT20	chr17	26652351	26672515	20164	intraflagellar transport 20
PA134871769	64792	IFT22	chr7	100953648	100975093	21445	intraflagellar transport 22
PA38609	11020	IFT27	chr22	37151246	37182177	30931	intraflagellar transport 27
PA145149677	112752	IFT43	chr14	76442096	76553416	111320	intraflagellar transport 43
PA165543409	56912	IFT46	chr11	118412243	118446791	34548	intraflagellar transport 46
PA25796	51098	IFT52	chr20	42209574	42278862	69288	intraflagellar transport 52
PA27890	55081	IFT57	chr3	107876659	107951417	74758	intraflagellar transport 57
PA134976961	80173	IFT74	chr9	26937037	27065931	128894	intraflagellar transport 74
PA142671664	57560	IFT80	chr3	159971774	160128028	156254	intraflagellar transport 80
PA26349	28981	IFT81	chr12	110552140	110659600	107460	intraflagellar transport 81
PA134991804	8100	IFT88	chr13	21130585	21268576	137991	intraflagellar transport 88
PA29694	3476	IGBP1	chrX	69343318	69389174	45856	immunoglobulin (CD79A) binding protein 1
PA164720881	9543	IGDCC3	chr15	65616465	65680378	63913	immunoglobulin superfamily, DCC subclass, member 3
PA164720914	57722	IGDCC4	chr15	65670825	65725410	54585	immunoglobulin superfamily, DCC subclass, member 4
PA29697	3479	IGF1	chr12	102786645	102885563	98918	insulin-like growth factor 1 (somatomedin C)
PA29698	3480	IGF1R	chr15	99182272	99510759	328487	insulin-like growth factor 1 receptor
PA29699	3481	IGF2	chr11	2147346	2189611	42265	insulin-like growth factor 2
PA143485501	10642	IGF2BP1	chr17	47064774	47136507	71733	insulin-like growth factor 2 mRNA binding protein 1
PA128394577	10644	IGF2BP2	chr3	185358527	185552827	194300	insulin-like growth factor 2 mRNA binding protein 2
PA128394576	10643	IGF2BP3	chr7	23346828	23519995	173167	insulin-like growth factor 2 mRNA binding protein 3
PA29701	3482	IGF2R	chr6	160380131	160530583	150452	insulin-like growth factor 2 receptor
PA29702	3483	IGFALS	chr16	1837414	1854909	17495	insulin-like growth factor binding protein, acid labile subunit
PA29703	3484	IGFBP1	chr7	45917959	45936267	18308	insulin-like growth factor binding protein 1
PA29704	3485	IGFBP2	chr2	217488127	217532159	44032	insulin-like growth factor binding protein 2, 36kDa
PA29705	3486	IGFBP3	chr7	45948844	45970871	22027	insulin-like growth factor binding protein 3
PA29706	3487	IGFBP4	chr17	38589676	38616982	27306	insulin-like growth factor binding protein 4
PA29707	3488	IGFBP5	chr2	217533828	217570272	36444	insulin-like growth factor binding protein 5
PA29708	3489	IGFBP6	chr12	53481436	53499128	17692	insulin-like growth factor binding protein 6
PA29709	3490	IGFBP7	chr4	57894237	57986551	92314	insulin-like growth factor binding protein 7
PA134937275	347252	IGFBPL1	chr9	38403525	38434444	30919	insulin-like growth factor binding protein-like 1
PA147357921	374918	IGFL1	chr19	46723009	46737500	14491	IGF-like family member 1
PA147357935	147920	IGFL2	chr19	46641039	46667561	26522	IGF-like family member 2
PA147357949	388555	IGFL3	chr19	46620328	46637931	17603	IGF-like family member 3
PA147357961	444882	IGFL4	chr19	46540006	46554274	14268	IGF-like family member 4
PA134884390	79713	IGFLR1	chr19	36226957	36244075	17118	IGF-like family receptor 1
PA162391896	91156	IGFN1	chr1	201149952	201201080	51128	immunoglobulin-like and fibronectin type III domain containing 1
PA29731	3508	IGHMBP2	chr11	68661319	68711070	49751	immunoglobulin mu binding protein 2
PA164717341	492311	IGIP	chr5	139495521	139511391	15870	IgA-inducing protein
PA29733	3512	IGJ	chr4	71518258	71542348	24090	immunoglobulin J polypeptide, linker protein for immunoglobulin alpha and mu polypeptides
PA29756	3543	IGLL1	chr22	23912312	23932619	20307	immunoglobulin lambda-like polypeptide 1
PA165378341	100423062	IGLL5	chr22	23219960	23241014	21054	immunoglobulin lambda-like polypeptide 5
PA164720915	402665	IGLON5	chr19	51805102	51837102	32000	IgLON family member 5
PA29761	3547	IGSF1	chrX	130404480	130433403	28923	immunoglobulin superfamily, member 1
PA134900760	285313	IGSF10	chr3	151150778	151189272	38494	immunoglobulin superfamily, member 10
PA134939253	152404	IGSF11	chr3	118616477	118874915	258438	immunoglobulin superfamily, member 11
PA142671661	84966	IGSF21	chr1	18424240	18707977	283737	immunoglobin superfamily, member 21
PA142671662	283284	IGSF22	chr11	18722852	18757777	34925	immunoglobulin superfamily, member 22
PA29763	3321	IGSF3	chr1	117114020	117220377	106357	immunoglobulin superfamily, member 3
PA29765	150084	IGSF5	chr21	41107334	41177023	69689	immunoglobulin superfamily, member 5
PA29766	10261	IGSF6	chr16	21649605	21673987	24382	immunoglobulin superfamily, member 6
PA29767	93185	IGSF8	chr1	160058129	160078650	20521	immunoglobulin superfamily, member 8
PA38508	57549	IGSF9	chr1	159893829	159925386	31557	immunoglobulin superfamily, member 9
PA142671660	22997	IGSF9B	chr11	133775520	133836649	61129	immunoglobulin superfamily, member 9B
PA29769	3549	IHH	chr2	219916142	219935238	19096	indian hedgehog
PA29774	3550	IK	chr5	140017384	140045065	27681	IK cytokine, down-regulator of HLA II
PA165512948	121457	IKBIP	chr12	99004182	99048829	44647	IKBKB interacting protein
PA29775	8518	IKBKAP	chr9	111626800	111706608	79808	inhibitor of kappa light polypeptide gene enhancer in B-cells, kinase complex-associated protein
PA29776	3551	IKBKB	chr8	42118820	42193171	74351	inhibitor of kappa light polypeptide gene enhancer in B-cells, kinase beta
PA134962294	9641	IKBKE	chr1	206633586	206673223	39637	inhibitor of kappa light polypeptide gene enhancer in B-cells, kinase epsilon
PA29777	8517	IKBKG	chrX	153759419	153799804	40385	inhibitor of kappa light polypeptide gene enhancer in B-cells, kinase gamma
PA37748	10320	IKZF1	chr7	50434231	50475799	41568	IKAROS family zinc finger 1 (Ikaros)
PA162391927	22807	IKZF2	chr2	213861408	214026379	164971	IKAROS family zinc finger 2 (Helios)
PA37750	22806	IKZF3	chr17	37910968	38030441	119473	IKAROS family zinc finger 3 (Aiolos)
PA162391948	64375	IKZF4	chr12	56391268	56435219	43951	IKAROS family zinc finger 4 (Eos)
PA162391969	64376	IKZF5	chr10	124747322	124778366	31044	IKAROS family zinc finger 5 (Pegasus)
PA29778	3586	IL10	chr1	206937948	206955839	17891	interleukin 10
PA29779	3587	IL10RA	chr11	117847106	117875198	28092	interleukin 10 receptor, alpha
PA29780	3588	IL10RB	chr21	34628665	34672539	43874	interleukin 10 receptor, beta
PA29781	3589	IL11	chr19	55872750	55891831	19081	interleukin 11
PA29782	3590	IL11RA	chr9	34642182	34664899	22717	interleukin 11 receptor, alpha
PA29784	3592	IL12A	chr3	159696623	159716806	20183	interleukin 12A
PA29785	3593	IL12B	chr5	158738791	158767481	28690	interleukin 12B
PA29786	3594	IL12RB1	chr19	18167371	18207806	40435	interleukin 12 receptor, beta 1
PA29787	3595	IL12RB2	chr1	67763047	67865583	102536	interleukin 12 receptor, beta 2
PA199	3596	IL13	chr5	131983865	131999801	15936	interleukin 13
PA200	3597	IL13RA1	chrX	117851514	117931496	79982	interleukin 13 receptor, alpha 1
PA29788	3598	IL13RA2	chrX	114235538	114262207	26669	interleukin 13 receptor, alpha 2
PA29790	3600	IL15	chr4	142547749	142658140	110391	interleukin 15
PA29791	3601	IL15RA	chr10	5991334	6030150	38816	interleukin 15 receptor, alpha
PA29793	3603	IL16	chr15	81464941	81608104	143163	interleukin 16
PA29794	3605	IL17A	chr6	52041185	52058436	17251	interleukin 17A
PA29795	27190	IL17B	chr5	148750830	148770848	20018	interleukin 17B
PA29797	27189	IL17C	chr16	88695001	88709882	14881	interleukin 17C
PA29798	53342	IL17D	chr13	21266222	21300239	34017	interleukin 17D
PA29800	112744	IL17F	chr6	52098484	52119298	20814	interleukin 17F
PA29801	23765	IL17RA	chr22	17555849	17599584	43735	interleukin 17 receptor A
PA29796	55540	IL17RB	chr3	53870577	53902827	32250	interleukin 17 receptor B
PA134986616	84818	IL17RC	chr3	9948758	9978305	29547	interleukin 17 receptor C
PA134993407	54756	IL17RD	chr3	57121010	57214345	93335	interleukin 17 receptor D
PA134896136	132014	IL17RE	chr3	9934296	9961086	26790	interleukin 17 receptor E
PA162391970	400935	IL17REL	chr22	50429942	50461055	31113	interleukin 17 receptor E-like
PA29802	3606	IL18	chr11	112010974	112044840	33866	interleukin 18
PA29803	10068	IL18BP	chr11	71699955	71716965	17010	interleukin 18 binding protein
PA29804	8809	IL18R1	chr2	102969093	103018230	49137	interleukin 18 receptor 1
PA29805	8807	IL18RAP	chr2	103025254	103072025	46771	interleukin 18 receptor accessory protein
PA29806	29949	IL19	chr1	206962215	207019326	57111	interleukin 19
PA29807	3552	IL1A	chr2	113528492	113552971	24479	interleukin 1, alpha
PA29808	3553	IL1B	chr2	113584337	113604356	20019	interleukin 1, beta
PA38387	84639	IL1F10	chr2	113815547	113836427	20880	interleukin 1 family, member 10 (theta)
PA29809	3554	IL1R1	chr2	102676836	102799334	122498	interleukin 1 receptor, type I
PA29810	7850	IL1R2	chr2	102598306	102647885	49579	interleukin 1 receptor, type II
PA29811	3556	IL1RAP	chr3	190221840	190381856	160016	interleukin 1 receptor accessory protein
PA29812	11141	IL1RAPL1	chrX	28595681	29977467	1381786	interleukin 1 receptor accessory protein-like 1
PA29813	26280	IL1RAPL2	chrX	103800996	105014822	1213826	interleukin 1 receptor accessory protein-like 2
PA29814	9173	IL1RL1	chr2	102917962	102971497	53535	interleukin 1 receptor-like 1
PA29815	8808	IL1RL2	chr2	102793433	102859462	66029	interleukin 1 receptor-like 2
PA29816	3557	IL1RN	chr2	113858693	113894593	35900	interleukin 1 receptor antagonist
PA195	3558	IL2	chr4	123369625	123387650	18025	interleukin 2
PA29817	50604	IL20	chr1	207028699	207045568	16869	interleukin 20
PA29818	53832	IL20RA	chr6	137318108	137376317	58209	interleukin 20 receptor, alpha
PA29819	53833	IL20RB	chr3	136666707	136732927	66220	interleukin 20 receptor beta
PA29820	59067	IL21	chr4	123530783	123552212	21429	interleukin 21
PA29821	50615	IL21R	chr16	27403483	27466363	62880	interleukin 21 receptor
PA29822	50616	IL22	chr12	68639025	68657379	18354	interleukin 22
PA29823	58985	IL22RA1	chr1	24443261	24479783	36522	interleukin 22 receptor, alpha 1
PA134983729	116379	IL22RA2	chr6	137461957	137504785	42828	interleukin 22 receptor, alpha 2
PA29824	51561	IL23A	chr12	56722663	56737194	14531	interleukin 23, alpha subunit p19
PA134935109	149233	IL23R	chr1	67594590	67728662	134072	interleukin 23 receptor
PA29825	11009	IL24	chr1	207060630	207080484	19854	interleukin 24
PA29799	64806	IL25	chr14	23832018	23848612	16594	interleukin 25
PA29826	55801	IL26	chr12	68592129	68629571	37442	interleukin 26
PA134870478	246778	IL27	chr16	28507683	28528155	20472	interleukin 27
PA134891276	9466	IL27RA	chr19	14132552	14166731	34179	interleukin 27 receptor, alpha
PA29828	3559	IL2RA	chr10	6049657	6114333	64676	interleukin 2 receptor, alpha
PA29829	3560	IL2RB	chr22	37518878	37562414	43536	interleukin 2 receptor, beta
PA196	3561	IL2RG	chrX	70324254	70341481	17227	interleukin 2 receptor, gamma
PA29830	3562	IL3	chr5	131386347	131401896	15549	interleukin 3
PA134957950	386653	IL31	chr12	122653577	122668746	15169	interleukin 31
PA134952624	133396	IL31RA	chr5	55137207	55221682	84475	interleukin 31 receptor A
PA128395754	9235	IL32	chr16	3105313	3122668	17355	interleukin 32
PA162392005	90865	IL33	chr9	6205149	6260983	55834	interleukin 33
PA162392024	146433	IL34	chr16	70603798	70697585	93787	interleukin 34
PA38389	27179	IL36A	chr2	113753038	113769221	16183	interleukin 36, alpha
PA38391	27177	IL36B	chr2	113776668	113820444	43776	interleukin 36, beta
PA38395	56300	IL36G	chr2	113725596	113746249	20653	interleukin 36, gamma
PA38388	26525	IL36RN	chr2	113806215	113825321	19106	interleukin 36 receptor antagonist
PA38390	27178	IL37	chr2	113660548	113679459	18911	interleukin 37
PA29831	3563	IL3RA	chrY	1395488	1454582	59094	interleukin 3 receptor, alpha (low affinity)
PA197	3565	IL4	chr5	131999678	132021370	21692	interleukin 4
PA38795	259307	IL4I1	chr19	50389911	50442796	52885	interleukin 4 induced 1
PA29832	3566	IL4R	chr16	27315161	27379099	63938	interleukin 4 receptor
PA29833	3567	IL5	chr5	131874136	131902555	28419	interleukin 5
PA29834	3568	IL5RA	chr3	3105008	3162058	57050	interleukin 5 receptor, alpha
PA198	3569	IL6	chr7	22756766	22774621	17855	interleukin 6
PA29835	3570	IL6R	chr1	154367669	154444926	77257	interleukin 6 receptor
PA29837	3572	IL6ST	chr5	55227923	55300821	72898	interleukin 6 signal transducer
PA29839	3574	IL7	chr8	79642007	79727758	85751	interleukin 7
PA29840	3575	IL7R	chr5	35846977	35882705	35728	interleukin 7 receptor
PA29845	3578	IL9	chr5	135224935	135241516	16581	interleukin 9
PA29846	3581	IL9R	chrY	59320252	59346488	26236	interleukin 9 receptor
PA134883110	286676	ILDR1	chr3	121703170	121751127	47957	immunoglobulin-like domain containing receptor 1
PA164720916	387597	ILDR2	chr1	166879441	166954576	75135	immunoglobulin-like domain containing receptor 2
PA29852	3608	ILF2	chr1	153631264	153653504	22240	interleukin enhancer binding factor 2
PA29853	3609	ILF3	chr19	10754937	10806095	51158	interleukin enhancer binding factor 3, 90kDa
PA29855	3611	ILK	chr11	6614938	6635105	20167	integrin-linked kinase
PA29856	80895	ILKAP	chr2	239076043	239122343	46300	integrin-linked kinase-associated serine/threonine phosphatase
PA29857	10994	ILVBL	chr19	15222785	15246610	23825	ilvB (bacterial acetolactate synthase)-like
PA142671655	196294	IMMP1L	chr11	31450948	31541169	90221	IMP1 inner mitochondrial membrane peptidase-like (S. cerevisiae)
PA134887258	83943	IMMP2L	chr7	110300106	111212588	912482	IMP2 inner mitochondrial membrane peptidase-like (S. cerevisiae)
PA29858	10989	IMMT	chr2	86368055	86433264	65209	inner membrane protein, mitochondrial
PA25517	55272	IMP3	chr15	75928426	75951047	22621	IMP3, U3 small nucleolar ribonucleoprotein
PA142671656	92856	IMP4	chr2	131090470	131107197	16727	IMP4, U3 small nucleolar ribonucleoprotein
PA29860	3612	IMPA1	chr8	82566151	82609029	42878	inositol(myo)-1(or 4)-monophosphatase 1
PA29861	3613	IMPA2	chr18	11971427	12033885	62458	inositol(myo)-1(or 4)-monophosphatase 2
PA143485502	55364	IMPACT	chr18	21996609	22036499	39890	impact RWD domain protein
PA142671657	54928	IMPAD1	chr8	57867488	57916430	48942	inositol monophosphatase domain containing 1
PA29862	3614	IMPDH1	chr7	128029331	128060045	30714	IMP (inosine 5'-monophosphate) dehydrogenase 1
PA29863	3615	IMPDH2	chr3	49058758	49076875	18117	IMP (inosine 5'-monophosphate) dehydrogenase 2
PA29865	3617	IMPG1	chr6	76628062	76792335	164273	interphotoreceptor matrix proteoglycan 1
PA29866	50939	IMPG2	chr3	100938390	101049419	111029	interphotoreceptor matrix proteoglycan 2
PA29867	9118	INA	chr10	105026919	105053108	26189	internexin neuronal intermediate filament protein, alpha
PA134919267	10207	INADL	chr1	62198149	62632592	434443	InaD-like (Drosophila)
PA165394234	255783	INAFM1	chr19	47767659	47781980	14321	InaF-motif containing 1
PA165431930	388324	INCA1	chr17	4888425	4911214	22789	inhibitor of CDK, cyclin A1 interacting protein 1
PA29868	3619	INCENP	chr11	61881445	61923635	42190	inner centromere protein antigens 135/155kDa
PA162392025	64423	INF2	chr14	105137902	105188947	51045	inverted formin, FH2 and WH2 domain containing
PA29872	3621	ING1	chr13	111354970	111376421	21451	inhibitor of growth family, member 1
PA29873	3622	ING2	chr4	184416220	184436422	20202	inhibitor of growth family, member 2
PA29875	54556	ING3	chr7	120580817	120618711	37894	inhibitor of growth family, member 3
PA134976283	51147	ING4	chr12	6756704	6782311	25607	inhibitor of growth family, member 4
PA134935441	84289	ING5	chr2	242631456	242671896	40440	inhibitor of growth family, member 5
PA29876	3623	INHA	chr2	220426954	220443435	16481	inhibin, alpha
PA29877	3624	INHBA	chr7	41725601	41752706	27105	inhibin, beta A
PA29878	3625	INHBB	chr2	121093719	121112383	18664	inhibin, beta B
PA29879	3626	INHBC	chr12	57818543	57847609	29066	inhibin, beta C
PA134898991	83729	INHBE	chr12	57839096	57854791	15695	inhibin, beta E
PA134992982	58493	INIP	chr9	115445786	115490387	44601	INTS3 and NABP interacting protein
PA403	11185	INMT	chr7	30781689	30809152	27463	indolethylamine N-methyltransferase
PA162392040	54617	INO80	chr15	41268078	41418340	150262	INO80 complex subunit
PA162392117	83444	INO80B	chr2	74672150	74688087	15937	INO80 complex subunit B
PA162392132	125476	INO80C	chr18	33029194	33088110	58916	INO80 complex subunit C
PA162392147	54891	INO80D	chr2	206855445	206960906	105461	INO80 complex subunit D
PA162392174	283899	INO80E	chr16	29997485	30020112	22627	INO80 complex subunit E
PA29880	3628	INPP1	chr2	191198196	191239391	41195	inositol polyphosphate-1-phosphatase
PA29882	3631	INPP4A	chr2	99051321	99210496	159175	inositol polyphosphate-4-phosphatase, type I, 107kDa
PA29883	8821	INPP4B	chr4	142946181	143777604	831423	inositol polyphosphate-4-phosphatase, type II, 105kDa
PA29884	3632	INPP5A	chr10	134341283	134599984	258701	inositol polyphosphate-5-phosphatase, 40kDa
PA29885	3633	INPP5B	chr1	38323369	38422729	99360	inositol polyphosphate-5-phosphatase, 75kDa
PA29887	3635	INPP5D	chr2	234044795	234119549	74754	inositol polyphosphate-5-phosphatase, 145kDa
PA164741785	56623	INPP5E	chr9	139320067	139344305	24238	inositol polyphosphate-5-phosphatase, 72 kDa
PA134927878	22876	INPP5F	chr10	121475559	121591663	116104	inositol polyphosphate-5-phosphatase F
PA164720918	27124	INPP5J	chr22	31508893	31533683	24790	inositol polyphosphate-5-phosphatase J
PA164720951	51763	INPP5K	chr17	1394869	1430182	35313	inositol polyphosphate-5-phosphatase K
PA29888	3636	INPPL1	chr11	71924916	71953191	28275	inositol polyphosphate phosphatase-like 1
PA201	3630	INS	chr11	2178009	2192439	14430	insulin
PA162392175	723961	INS-IGF2	chr11	2147342	2192439	45097	INS-IGF2 readthrough
PA162392191	387755	INSC	chr11	15123970	15271754	147784	inscuteable homolog (Drosophila)
PA29890	3638	INSIG1	chr7	155079486	155104945	25459	insulin induced gene 1
PA134890284	51141	INSIG2	chr2	118836033	118870604	34571	insulin induced gene 2
PA29893	3640	INSL3	chr19	17924322	17942383	18061	insulin-like 3 (Leydig cell)
PA29894	3641	INSL4	chr9	5221419	5236967	15548	insulin-like 4 (placenta)
PA29895	10022	INSL5	chr1	67260424	67276942	16518	insulin-like 5
PA29896	11172	INSL6	chr9	5160863	5195618	34755	insulin-like 6
PA29897	3642	INSM1	chr20	20338765	20354593	15828	insulinoma-associated 1
PA134899231	84684	INSM2	chr14	35993248	36009260	16012	insulinoma-associated 2
PA202	3643	INSR	chr19	7109266	7304011	194745	insulin receptor
PA29899	3645	INSRR	chr1	156807665	156838712	31047	insulin receptor-related receptor
PA144596420	26173	INTS1	chr7	1506913	1554018	47105	integrator complex subunit 1
PA142672354	55174	INTS10	chr8	19664876	19712589	47713	integrator complex subunit 10
PA142671177	57117	INTS12	chr4	106600784	106639881	39097	integrator complex subunit 12
PA142671605	57508	INTS2	chr17	59939728	60015377	75649	integrator complex subunit 2
PA142672510	65123	INTS3	chr1	153690526	153749555	59029	integrator complex subunit 3
PA144596421	92105	INTS4	chr11	77586766	77715771	129005	integrator complex subunit 4
PA142671596	80789	INTS5	chr11	62411320	62430774	19454	integrator complex subunit 5
PA27212	26512	INTS6	chr13	51924678	52037275	112597	integrator complex subunit 6
PA142672522	25896	INTS7	chr1	212110741	212219002	108261	integrator complex subunit 7
PA142672371	55656	INTS8	chr8	95825518	95895721	70203	integrator complex subunit 8
PA162392192	55756	INTS9	chr8	28622175	28757698	135523	integrator complex subunit 9
PA162392193	27152	INTU	chr4	128544087	128640934	96847	inturned planar cell polarity protein
PA38472	27130	INVS	chr9	102851467	103066908	215441	inversin
PA164720982	9807	IP6K1	chr3	49758728	49833973	75245	inositol hexakisphosphate kinase 1
PA164720999	51447	IP6K2	chr3	48722436	48764711	42275	inositol hexakisphosphate kinase 2
PA164721016	117283	IP6K3	chr6	33686415	33724762	38347	inositol hexakisphosphate kinase 3
PA164721033	26034	IPCEF1	chr6	154472618	154687900	215282	interaction protein for cytohesin exchange factors 1
PA134903369	253430	IPMK	chr10	59948278	60037694	89416	inositol polyphosphate multikinase
PA134936197	51194	IPO11	chr5	61689522	61927416	237894	importin 11
PA134981096	9670	IPO13	chr1	44402478	44436694	34216	importin 13
PA134968932	79711	IPO4	chr14	24646425	24668124	21699	importin 4
PA30193	3843	IPO5	chr13	98595914	98679550	83636	importin 5
PA34213	10527	IPO7	chr11	9396169	9472674	76505	importin 7
PA34214	10526	IPO8	chr12	30778915	30858929	80014	importin 8
PA134930111	55705	IPO9	chr1	201788288	201856422	68134	importin 9
PA29908	3652	IPP	chr1	46156996	46226485	69489	intracisternal A particle-promoted polypeptide
PA25970	64768	IPPK	chr9	95372466	95442547	70081	inositol 1,3,4,5,6-pentakisphosphate 2-kinase
PA162392257	79781	IQCA1	chr2	237229790	237426178	196388	IQ motif containing with AAA domain 1
PA134869761	9657	IQCB1	chr3	121485608	121563926	78318	IQ motif containing B1
PA134868161	55721	IQCC	chr1	32661236	32677288	16052	IQ motif containing C
PA134901058	115811	IQCD	chr12	113630246	113669086	38840	IQ motif containing D
PA134894706	23288	IQCE	chr7	2588617	2657368	68751	IQ motif containing E
PA134895829	132141	IQCF1	chr3	51925892	51947386	21494	IQ motif containing F1
PA134900355	389123	IQCF2	chr3	51885645	51900440	14795	IQ motif containing F2
PA134884625	401067	IQCF3	chr3	51850899	51867874	16975	IQ motif containing F3
PA164721062	389124	IQCF5	chr3	51904737	51919600	14863	IQ motif containing F5
PA164721071	440956	IQCF6	chr3	51809577	51823256	13679	IQ motif containing F6
PA134919040	84223	IQCG	chr3	197612946	197696982	84036	IQ motif containing G
PA142671654	64799	IQCH	chr15	67537138	67797142	260004	IQ motif containing H
PA143485504	654502	IQCJ	chr3	158777041	158987096	210055	IQ motif containing J
PA145148697	124152	IQCK	chr16	19717778	19872087	154309	IQ motif containing K
PA29910	8826	IQGAP1	chr15	90921473	91048475	127002	IQ motif containing GTPase activating protein 1
PA29911	10788	IQGAP2	chr5	75689131	76006957	317826	IQ motif containing GTPase activating protein 2
PA134954177	128239	IQGAP3	chr1	156492197	156552396	60199	IQ motif containing GTPase activating protein 3
PA128394566	9922	IQSEC1	chr3	12935542	13124652	189110	IQ motif and Sec7 domain 1
PA134870898	23096	IQSEC2	chrX	53259058	53360522	101464	IQ motif and Sec7 domain 2
PA134990290	440073	IQSEC3	chr12	166049	290626	124577	IQ motif and Sec7 domain 3
PA162392258	154865	IQUB	chr7	123088993	123184718	95725	IQ motif and ubiquitin domain containing
PA29912	3654	IRAK1	chrX	153272957	153295342	22385	interleukin-1 receptor-associated kinase 1
PA134919096	134728	IRAK1BP1	chr6	79567261	79717545	150284	interleukin-1 receptor-associated kinase 1 binding protein 1
PA29913	3656	IRAK2	chr3	10196561	10288427	91866	interleukin-1 receptor-associated kinase 2
PA38431	11213	IRAK3	chr12	66572978	66651402	78424	interleukin-1 receptor-associated kinase 3
PA134914577	51135	IRAK4	chr12	44142747	44186346	43599	interleukin-1 receptor-associated kinase 4
PA29914	3658	IREB2	chr15	78720518	78796798	76280	iron-responsive element binding protein 2
PA29915	3659	IRF1	chr5	131814301	131836465	22164	interferon regulatory factor 1
PA29916	3660	IRF2	chr4	185305867	185405734	99867	interferon regulatory factor 2
PA134987893	26145	IRF2BP1	chr19	46383866	46399376	15510	interferon regulatory factor 2 binding protein 1
PA134947294	359948	IRF2BP2	chr1	234737015	234755271	18256	interferon regulatory factor 2 binding protein 2
PA25516	64207	IRF2BPL	chr14	77487886	77505042	17156	interferon regulatory factor 2 binding protein-like
PA29917	3661	IRF3	chr19	50159826	50179132	19306	interferon regulatory factor 3
PA29918	3662	IRF4	chr6	381739	414443	32704	interferon regulatory factor 4
PA29919	3663	IRF5	chr7	128567976	128593089	25113	interferon regulatory factor 5
PA29920	3664	IRF6	chr1	209955968	209989520	33552	interferon regulatory factor 6
PA29921	3665	IRF7	chr11	609555	625999	16444	interferon regulatory factor 7
PA29606	3394	IRF8	chr16	85922774	85959212	36438	interferon regulatory factor 8
PA162392259	10379	IRF9	chr14	24620422	24638774	18352	interferon regulatory factor 9
PA162392282	730249	IRG1	chr13	77512694	77535777	23083	immunoresponsive 1 homolog (mouse)
PA142671651	56269	IRGC	chr19	44210214	44227173	16959	immunity-related GTPase family, cinema
PA142671652	345611	IRGM	chr5	150216085	150231231	15146	immunity-related GTPase family, M
PA142671653	126298	IRGQ	chr19	44085519	44110287	24768	immunity-related GTPase family, Q
PA203	3667	IRS1	chr2	227593033	227674545	81512	insulin receptor substrate 1
PA375	8660	IRS2	chr13	110403184	110448914	45730	insulin receptor substrate 2
PA29923	8471	IRS4	chrX	107960179	107989643	29464	insulin receptor substrate 4
PA29924	79192	IRX1	chr5	3586168	3604517	18349	iroquois homeobox 1
PA29925	153572	IRX2	chr5	2743279	2761769	18490	iroquois homeobox 2
PA29926	79191	IRX3	chr16	54314212	54330724	16512	iroquois homeobox 3
PA29927	50805	IRX4	chr5	1874541	1897293	22752	iroquois homeobox 4
PA29928	10265	IRX5	chr16	54955111	54971397	16286	iroquois homeobox 5
PA29929	79190	IRX6	chr16	55348406	55367672	19266	iroquois homeobox 6
PA162392301	81689	ISCA1	chr9	88876461	88907676	31215	iron-sulfur cluster assembly 1
PA162392314	389293	ISCA1P1	chr5	62068203	62083171	14968	iron-sulfur cluster assembly 1 homolog (S. cerevisiae) pseudogene 1
PA162392315	122961	ISCA2	chr14	74950423	74965271	14848	iron-sulfur cluster assembly 2
PA162392328	23479	ISCU	chr12	108945239	108966160	20921	iron-sulfur cluster assembly enzyme
PA28465	9636	ISG15	chr1	938847	952920	14073	ISG15 ubiquitin-like modifier
PA29930	3669	ISG20	chr15	89168904	89201881	32977	interferon stimulated exonuclease gene 20kDa
PA142671650	81875	ISG20L2	chr1	156688687	156708577	19890	interferon stimulated exonuclease gene 20kDa-like 2
PA29932	3670	ISL1	chr5	50668958	50693564	24606	ISL LIM homeobox 1
PA38566	64843	ISL2	chr15	76619065	76637817	18752	ISL LIM homeobox 2
PA29933	3671	ISLR	chr15	74456087	74472212	16125	immunoglobulin superfamily containing leucine-rich repeat
PA143485505	57611	ISLR2	chr15	74410544	74432143	21599	immunoglobulin superfamily containing leucine-rich repeat 2
PA164721080	140862	ISM1	chr20	13192418	13284297	91879	isthmin 1, angiogenesis inhibitor
PA164721097	145501	ISM2	chr14	77937737	77975210	37473	isthmin 2
PA134973470	51015	ISOC1	chr5	128420442	128452721	32279	isochorismatase domain containing 1
PA134981722	79763	ISOC2	chr19	55961345	55983070	21725	isochorismatase domain containing 2
PA165618128	729920	ISPD	chr7	16124152	16470947	346795	isoprenoid synthase domain containing
PA147357909	91464	ISX	chr22	35452130	35486380	34250	intestine-specific homeobox
PA162392343	57461	ISY1	chr3	128843259	128890409	47150	ISY1 splicing factor homolog (S. cerevisiae)
PA164721116	51477	ISYNA1	chr19	18542198	18559111	16913	inositol-3-phosphate synthase 1
PA29934	83737	ITCH	chr20	32941041	33102198	161157	itchy E3 ubiquitin protein ligase
PA143485506	81533	ITFG1	chr16	47185302	47505018	319716	integrin alpha FG-GAP repeat containing 1
PA143485507	55846	ITFG2	chr12	2911716	2937237	25521	integrin alpha FG-GAP repeat containing 2
PA25564	83986	ITFG3	chr16	274758	321960	47202	integrin alpha FG-GAP repeat containing 3
PA29935	3672	ITGA1	chr5	52074136	52252485	178349	integrin, alpha 1
PA29936	8515	ITGA10	chr1	145514709	145546868	32159	integrin, alpha 10
PA29937	22801	ITGA11	chr15	68588128	68734502	146374	integrin, alpha 11
PA204	3673	ITGA2	chr5	52275156	52393609	118453	integrin, alpha 2 (CD49B, alpha 2 subunit of VLA-2 receptor)
PA29938	3674	ITGA2B	chr17	42446550	42476873	30323	integrin, alpha 2b (platelet glycoprotein IIb of IIb/IIIa complex, antigen CD41)
PA29939	3675	ITGA3	chr17	48123340	48170849	47509	integrin, alpha 3 (antigen CD49C, alpha 3 subunit of VLA-3 receptor)
PA29940	3676	ITGA4	chr2	182311619	182405474	93855	integrin, alpha 4 (antigen CD49D, alpha 4 subunit of VLA-4 receptor)
PA29941	3678	ITGA5	chr12	54786045	54823050	37005	integrin, alpha 5 (fibronectin receptor, alpha polypeptide)
PA29942	3655	ITGA6	chr2	173281954	173374181	92227	integrin, alpha 6
PA29943	3679	ITGA7	chr12	56075352	56119821	44469	integrin, alpha 7
PA29944	8516	ITGA8	chr10	15554711	15772328	217617	integrin, alpha 8
PA29945	3680	ITGA9	chr3	37483813	37864281	380468	integrin, alpha 9
PA29946	3681	ITGAD	chr16	31394633	31440826	46193	integrin, alpha D
PA29947	3682	ITGAE	chr17	3614919	3714537	99618	integrin, alpha E (antigen CD103, human mucosal lymphocyte antigen 1; alpha polypeptide)
PA29948	3683	ITGAL	chr16	30473983	30537506	63523	integrin, alpha L (antigen CD11A (p180), lymphocyte function-associated antigen 1; alpha polypeptide)
PA29949	3684	ITGAM	chr16	31261288	31347213	85925	integrin, alpha M (complement component 3 receptor 3 subunit)
PA37336	3685	ITGAV	chr2	187444058	187548629	104571	integrin, alpha V
PA29952	3687	ITGAX	chr16	31356488	31397320	40832	integrin, alpha X (complement component 3 receptor 4 subunit)
PA29953	3688	ITGB1	chr10	33186246	33257293	71047	integrin, beta 1 (fibronectin receptor, beta polypeptide, antigen CD29 includes MDF2, MSK12)
PA134913590	9270	ITGB1BP1	chr2	9542810	9573698	30888	integrin beta 1 binding protein 1
PA29954	26548	ITGB1BP2	chrX	70511581	70528221	16640	integrin beta 1 binding protein (melusin) 2
PA29955	3689	ITGB2	chr21	46302864	46358753	55889	integrin, beta 2 (complement component 3 receptor 3 and 4 subunit)
PA205	3690	ITGB3	chr17	45321208	45393077	71869	integrin, beta 3 (platelet glycoprotein IIIa, antigen CD61)
PA29956	23421	ITGB3BP	chr1	63903441	63998944	95503	integrin beta 3 binding protein (beta3-endonexin)
PA29957	3691	ITGB4	chr17	73707516	73756899	49383	integrin, beta 4
PA29959	3693	ITGB5	chr3	124477795	124616500	138705	integrin, beta 5
PA29960	3694	ITGB6	chr2	160953182	161120349	167167	integrin, beta 6
PA29961	3695	ITGB7	chr12	53582102	53611065	28963	integrin, beta 7
PA29962	3696	ITGB8	chr7	20360345	20458382	98037	integrin, beta 8
PA29963	9358	ITGBL1	chr13	102094944	102376207	281263	integrin, beta-like 1 (with EGF-like repeat domains)
PA29964	3697	ITIH1	chr3	52801602	52829084	27482	inter-alpha-trypsin inhibitor heavy chain 1
PA29965	3698	ITIH2	chr10	7735236	7794483	59247	inter-alpha-trypsin inhibitor heavy chain 2
PA29966	3699	ITIH3	chr3	52818784	52846025	27241	inter-alpha-trypsin inhibitor heavy chain 3
PA29967	3700	ITIH4	chr3	52844006	52874717	30711	inter-alpha-trypsin inhibitor heavy chain family, member 4
PA134899668	80760	ITIH5	chr10	7598232	7718961	120729	inter-alpha-trypsin inhibitor heavy chain family, member 5
PA134930661	347365	ITIH6	chrX	54772332	54834673	62341	inter-alpha-trypsin inhibitor heavy chain family, member 6
PA29968	3702	ITK	chr5	156597907	156685109	87202	IL2-inducible T-cell kinase
PA134870726	55600	ITLN1	chr1	160843330	160864960	21630	intelectin 1 (galactofuranose binding)
PA134879128	142683	ITLN2	chr1	160911810	160934589	22779	intelectin 2
PA29970	9452	ITM2A	chrX	78612881	78633164	20283	integral membrane protein 2A
PA29971	9445	ITM2B	chr13	48797274	48839232	41958	integral membrane protein 2B
PA29972	81618	ITM2C	chr2	231719546	231746963	27417	integral membrane protein 2C
PA29973	3704	ITPA	chr20	3179514	3207516	28002	inosine triphosphatase (nucleoside triphosphate pyrophosphatase)
PA29974	3705	ITPK1	chr14	93400259	93592263	192004	inositol-tetrakisphosphate 1-kinase
PA29975	3706	ITPKA	chr15	41776056	41798757	22701	inositol-trisphosphate 3-kinase A
PA29976	3707	ITPKB	chr1	226816391	226937028	120637	inositol-trisphosphate 3-kinase B
PA29977	80271	ITPKC	chr19	41212885	41249765	36880	inositol-trisphosphate 3-kinase C
PA29978	3708	ITPR1	chr3	4525032	4892524	367492	inositol 1,4,5-trisphosphate receptor, type 1
PA29979	3709	ITPR2	chr12	26485285	26996131	510846	inositol 1,4,5-trisphosphate receptor, type 2
PA29980	3710	ITPR3	chr6	33577951	33667351	89400	inositol 1,4,5-trisphosphate receptor, type 3
PA162392344	85450	ITPRIP	chr10	106066454	106108251	41797	inositol 1,4,5-trisphosphate receptor interacting protein
PA162392345	150771	ITPRIPL1	chr2	96981062	96997091	16029	inositol 1,4,5-trisphosphate receptor interacting protein-like 1
PA164721117	162073	ITPRIPL2	chr16	19115254	19135952	20698	inositol 1,4,5-trisphosphate receptor interacting protein-like 2
PA29981	6453	ITSN1	chr21	35004706	35264609	259903	intersectin 1 (SH3 domain protein)
PA29982	50618	ITSN2	chr2	24422733	24593647	170914	intersectin 2
PA29984	3712	IVD	chr15	40687686	40731146	43460	isovaleryl-CoA dehydrogenase
PA29985	3713	IVL	chr1	152871039	152887362	16323	involucrin
PA134875300	10625	IVNS1ABP	chr1	185262520	185296461	33941	influenza virus NS1A binding protein
PA144596419	55677	IWS1	chr2	128235383	128294462	59079	IWS1 homolog (S. cerevisiae)
PA162392352	389434	IYD	chr6	150679987	150728765	48778	iodotyrosine deiodinase
PA142671647	284359	IZUMO1	chr19	49241073	49260831	19758	izumo sperm-egg fusion 1
PA164720096	390243	IZUMO1R	chr11	94028803	94043858	15055	IZUMO1 receptor, JUNO
PA165393535	126123	IZUMO2	chr19	50652805	50676538	23733	IZUMO family member 2
PA165585816	100129669	IZUMO3	chr9	24540193	24555889	15696	IZUMO family member 3
PA165393578	113177	IZUMO4	chr19	2086422	2102586	16164	IZUMO family member 4
PA134925124	79960	JADE1	chr4	129720779	129799379	78600	jade family PHD finger 1
PA128394627	23338	JADE2	chr5	133851798	133921918	70120	jade family PHD finger 2
PA134993233	9767	JADE3	chrX	46761736	46923641	161905	jade family PHD finger 3
PA29986	182	JAG1	chr20	10615332	10664694	49362	jagged 1
PA29987	3714	JAG2	chr14	105604318	105645161	40843	jagged 2
PA134954931	84522	JAGN1	chr3	9922271	9939033	16762	jagunal homolog 1 (Drosophila)
PA29988	3716	JAK1	chr1	65295906	65442593	146687	Janus kinase 1
PA29989	3717	JAK2	chr9	4975245	5132948	157703	Janus kinase 2
PA29990	3718	JAK3	chr19	17932591	17968880	36289	Janus kinase 3
PA143485508	152789	JAKMIP1	chr4	6023661	6212318	188657	janus kinase and microtubule interacting protein 1
PA143485509	9832	JAKMIP2	chr5	146962002	147172411	210409	janus kinase and microtubule interacting protein 2
PA162392367	282973	JAKMIP3	chr10	133869367	134001482	132115	Janus kinase and microtubule interacting protein 3
PA29992	58494	JAM2	chr21	27001594	27092874	91280	junctional adhesion molecule 2
PA29993	83700	JAM3	chr11	133928820	134024652	95832	junctional adhesion molecule 3
PA29995	3720	JARID2	chr6	15236206	15525273	289067	jumonji, AT rich interactive domain 2
PA162392484	221895	JAZF1	chr7	27867192	28230437	363245	JAZF zinc finger 1
PA162392499	122953	JDP2	chr14	75884509	75942404	57895	Jun dimerization protein 2
PA165479069	51528	JKAMP	chr14	59941161	59975081	33920	JNK1/MAPK8-associated membrane protein
PA128394767	221037	JMJD1C	chr10	64923983	65235880	311897	jumonji domain containing 1C
PA142671643	65094	JMJD4	chr1	227915890	227933284	17394	jumonji domain containing 4
PA162392513	23210	JMJD6	chr17	74705914	74732881	26967	jumonji domain containing 6
PA162392530	100137047	JMJD7	chr15	42110283	42132785	22502	jumonji domain containing 7
PA165479070	8681	JMJD7-PLA2G4B	chr15	42110283	42143346	33063	JMJD7-PLA2G4B readthrough
PA162392531	339123	JMJD8	chr16	728667	744440	15773	jumonji domain containing 8
PA164721124	133746	JMY	chr5	78521925	78626038	104113	junction mediating and regulatory protein, p53 cofactor
PA142671644	9929	JOSD1	chr22	39078548	39107423	28875	Josephin domain containing 1
PA142671645	126119	JOSD2	chr19	51006254	51024612	18358	Josephin domain containing 2
PA29998	56704	JPH1	chr8	75143935	75243721	99786	junctophilin 1
PA29999	57158	JPH2	chr20	42737337	42826218	88881	junctophilin 2
PA30000	57338	JPH3	chr16	87625441	87734762	109321	junctophilin 3
PA134897649	84502	JPH4	chr14	24034244	24058009	23765	junctophilin 4
PA30002	8690	JRKL	chr11	96113158	96129727	16569	JRK-like
PA143485511	126306	JSRP1	chr19	2249250	2266422	17172	junctional sarcoplasmic reticulum protein 1
PA30003	10899	JTB	chr1	153943745	153961096	17351	jumping translocation breakpoint
PA30006	3725	JUN	chr1	59243463	59259785	16322	jun proto-oncogene
PA30007	3726	JUNB	chr19	12892310	12907125	14815	jun B proto-oncogene
PA30008	3727	JUND	chr19	18387563	18402432	14869	jun D proto-oncogene
PA30009	3728	JUP	chr17	39907859	39952964	45105	junction plakoglobin
PA134915618	353219	KAAG1	chr6	24347131	24361512	14381	kidney associated antigen 1
PA30012	3730	KAL1	chrX	8493915	8710227	216312	Kallmann syndrome 1 sequence
PA29189	8997	KALRN	chr3	123803558	124443036	639478	kalirin, RhoGEF kinase
PA162392554	23189	KANK1	chr9	460294	749106	288812	KN motif and ankyrin repeat domains 1
PA162392581	25959	KANK2	chr19	11271943	11318243	46300	KN motif and ankyrin repeat domains 2
PA162392612	256949	KANK3	chr19	8384468	8418146	33678	KN motif and ankyrin repeat domains 3
PA162392639	163782	KANK4	chr1	62698837	62795083	96246	KN motif and ankyrin repeat domains 4
PA142671604	284058	KANSL1	chr17	44104282	44312740	208458	KAT8 regulatory NSL complex subunit 1
PA162379439	151050	KANSL1L	chr2	210882435	211046068	163633	KAT8 regulatory NSL complex subunit 1-like
PA143485371	54934	KANSL2	chr12	49043994	49086035	42041	KAT8 regulatory NSL complex subunit 2
PA162393058	55683	KANSL3	chr2	97255892	97314116	58224	KAT8 regulatory NSL complex subunit 3
PA30016	3735	KARS	chr16	75658622	75691585	32963	lysyl-tRNA synthetase
PA162392664	2648	KAT2A	chr17	40262129	40283382	21253	K(lysine) acetyltransferase 2A
PA162392705	8850	KAT2B	chr3	20071524	20198896	127372	K(lysine) acetyltransferase 2B
PA162392746	10524	KAT5	chr11	65469473	65490077	20604	K(lysine) acetyltransferase 5
PA37592	7994	KAT6A	chr8	41783997	41919506	135509	K(lysine) acetyltransferase 6A
PA134880712	23522	KAT6B	chr10	76574685	76795380	220695	K(lysine) acetyltransferase 6B
PA134886407	11143	KAT7	chr17	47855922	47909458	53536	K(lysine) acetyltransferase 7
PA38476	84148	KAT8	chr16	31118985	31145714	26729	K(lysine) acetyltransferase 8
PA30017	11104	KATNA1	chr6	149913009	149980154	67145	katanin p60 (ATPase containing) subunit A 1
PA134951885	84056	KATNAL1	chr13	30773767	30891624	117857	katanin p60 subunit A-like 1
PA134921461	83473	KATNAL2	chr18	44487565	44631614	144049	katanin p60 subunit A-like 2
PA30018	10300	KATNB1	chr16	57759623	57794162	34539	katanin p80 (WD repeat containing) subunit B 1
PA134985944	79768	KATNBL1	chr15	34429875	34512297	82422	katanin p80 subunit B-like 1
PA134953983	81621	KAZALD1	chr10	102810999	102830888	19889	Kazal-type serine peptidase inhibitor domain 1
PA142671642	9920	KBTBD11	chr8	1911949	1958109	46160	kelch repeat and BTB (POZ) domain containing 11
PA165697420	166348	KBTBD12	chr3	127624075	127709514	85439	kelch repeat and BTB (POZ) domain containing 12
PA165479144	390594	KBTBD13	chr15	65359154	65375276	16122	kelch repeat and BTB (POZ) domain containing 13
PA134892896	25948	KBTBD2	chr7	32904778	32941468	36690	kelch repeat and BTB (POZ) domain containing 2
PA134920598	143879	KBTBD3	chr11	105918825	105958465	39640	kelch repeat and BTB (POZ) domain containing 3
PA134883813	55709	KBTBD4	chr11	47590749	47610567	19818	kelch repeat and BTB (POZ) domain containing 4
PA134955690	89890	KBTBD6	chr13	41698709	41716936	18227	kelch repeat and BTB (POZ) domain containing 6
PA134934036	84078	KBTBD7	chr13	41762711	41778702	15991	kelch repeat and BTB (POZ) domain containing 7
PA142671641	84541	KBTBD8	chr3	67038727	67064634	25907	kelch repeat and BTB (POZ) domain containing 8
PA134967694	56888	KCMF1	chr2	85188231	85289595	101364	potassium channel modulatory factor 1
PA30019	3736	KCNA1	chr12	5009073	5030422	21349	potassium voltage-gated channel, shaker-related subfamily, member 1 (episodic ataxia with myokymia)
PA30020	3744	KCNA10	chr1	111056839	111071797	14958	potassium voltage-gated channel, shaker-related subfamily, member 10
PA206	3737	KCNA2	chr1	111133202	111184096	50894	potassium voltage-gated channel, shaker-related subfamily, member 2
PA30021	3738	KCNA3	chr1	111193182	111227655	34473	potassium voltage-gated channel, shaker-related subfamily, member 3
PA207	3739	KCNA4	chr11	30028288	30048577	20289	potassium voltage-gated channel, shaker-related subfamily, member 4
PA208	3741	KCNA5	chr12	5143085	5158954	15869	potassium voltage-gated channel, shaker-related subfamily, member 5
PA30022	3742	KCNA6	chr12	4908342	4964093	55751	potassium voltage-gated channel, shaker-related subfamily, member 6
PA30023	3743	KCNA7	chr19	49567675	49586198	18523	potassium voltage-gated channel, shaker-related subfamily, member 7
PA370	7881	KCNAB1	chr3	155828337	156259927	431590	potassium voltage-gated channel, shaker-related subfamily, beta member 1
PA373	8514	KCNAB2	chr1	6042358	6164253	121895	potassium voltage-gated channel, shaker-related subfamily, beta member 2
PA30024	9196	KCNAB3	chr17	7822177	7843180	21003	potassium voltage-gated channel, shaker-related subfamily, beta member 3
PA209	3745	KCNB1	chr20	47985505	48109181	123676	potassium voltage-gated channel, Shab-related subfamily, member 1
PA30025	9312	KCNB2	chr8	73439626	73853584	413958	potassium voltage-gated channel, Shab-related subfamily, member 2
PA30026	3746	KCNC1	chr11	17747495	17807602	60107	potassium voltage-gated channel, Shaw-related subfamily, member 1
PA35490	3747	KCNC2	chr12	75430858	75613584	182726	potassium voltage-gated channel, Shaw-related subfamily, member 2
PA30027	3748	KCNC3	chr19	50815765	50842634	26869	potassium voltage-gated channel, Shaw-related subfamily, member 3
PA30028	3749	KCNC4	chr1	110743336	110779674	36338	potassium voltage-gated channel, Shaw-related subfamily, member 4
PA30029	3750	KCND1	chrX	48815639	48838251	22612	potassium voltage-gated channel, Shal-related subfamily, member 1
PA30030	3751	KCND2	chr7	119903689	120393387	489698	potassium voltage-gated channel, Shal-related subfamily, member 2
PA210	3752	KCND3	chr1	112315444	112542147	226703	potassium voltage-gated channel, Shal-related subfamily, member 3
PA211	3753	KCNE1	chr21	35787910	35894573	106663	potassium voltage-gated channel, Isk-related family, member 1
PA30031	23630	KCNE1L	chrX	108863929	108878393	14464	KCNE1-like
PA392	9992	KCNE2	chr21	35726323	35746440	20117	potassium voltage-gated channel, Isk-related family, member 2
PA393	10008	KCNE3	chr11	74162886	74188600	25714	potassium voltage-gated channel, Isk-related family, member 3
PA30032	23704	KCNE4	chr2	223906648	223923355	16707	potassium voltage-gated channel, Isk-related family, member 4
PA30033	3754	KCNF1	chr2	11042063	11057351	15288	potassium voltage-gated channel, subfamily F, member 1
PA30034	3755	KCNG1	chr20	49617193	49649675	32482	potassium voltage-gated channel, subfamily G, member 1
PA30035	26251	KCNG2	chr18	77613668	77662816	49148	potassium voltage-gated channel, subfamily G, member 2
PA30036	170850	KCNG3	chr2	42666157	42731237	65080	potassium voltage-gated channel, subfamily G, member 3
PA134989953	93107	KCNG4	chr16	84251741	84283356	31615	potassium voltage-gated channel, subfamily G, member 4
PA30037	3756	KCNH1	chr1	210848657	211317457	468800	potassium voltage-gated channel, subfamily H (eag-related), member 1
PA212	3757	KCNH2	chr7	150639044	150685402	46358	potassium voltage-gated channel, subfamily H (eag-related), member 2
PA30038	23416	KCNH3	chr12	49922834	49955091	32257	potassium voltage-gated channel, subfamily H (eag-related), member 3
PA30039	23415	KCNH4	chr17	40305910	40343296	37386	potassium voltage-gated channel, subfamily H (eag-related), member 4
PA30040	27133	KCNH5	chr14	63170291	63521956	351665	potassium voltage-gated channel, subfamily H (eag-related), member 5
PA38722	81033	KCNH6	chr17	61590695	61629338	38643	potassium voltage-gated channel, subfamily H (eag-related), member 6
PA38723	90134	KCNH7	chr2	163224917	163705257	480340	potassium voltage-gated channel, subfamily H (eag-related), member 7
PA38724	131096	KCNH8	chr3	19179946	19580135	400189	potassium voltage-gated channel, subfamily H (eag-related), member 8
PA30041	30820	KCNIP1	chr5	169770491	170166636	396145	Kv channel interacting protein 1
PA30042	30819	KCNIP2	chr10	103582731	103613769	31038	Kv channel interacting protein 2
PA26934	30818	KCNIP3	chr2	95953072	96054825	101753	Kv channel interacting protein 3, calsenilin
PA134893552	80333	KCNIP4	chr4	20727234	21960424	1233190	Kv channel interacting protein 4
PA213	3758	KCNJ1	chr11	128704909	128747268	42359	potassium inwardly-rectifying channel, subfamily J, member 1
PA30043	3766	KCNJ10	chr1	160004257	160050051	45794	potassium inwardly-rectifying channel, subfamily J, member 10
PA217	3767	KCNJ11	chr11	17403795	17420878	17083	potassium inwardly-rectifying channel, subfamily J, member 11
PA218	3768	KCNJ12	chr17	21269699	21326184	56485	potassium inwardly-rectifying channel, subfamily J, member 12
PA30044	3769	KCNJ13	chr2	233627512	233651275	23763	potassium inwardly-rectifying channel, subfamily J, member 13
PA30045	3770	KCNJ14	chr19	48948964	48972367	23403	potassium inwardly-rectifying channel, subfamily J, member 14
PA30046	3772	KCNJ15	chr21	39591837	39678043	86206	potassium inwardly-rectifying channel, subfamily J, member 15
PA30047	3773	KCNJ16	chr17	68061348	68134749	73401	potassium inwardly-rectifying channel, subfamily J, member 16
PA214	3759	KCNJ2	chr17	68154757	68179189	24432	potassium inwardly-rectifying channel, subfamily J, member 2
PA215	3760	KCNJ3	chr2	155545093	155717864	172771	potassium inwardly-rectifying channel, subfamily J, member 3
PA30048	3761	KCNJ4	chr22	38819332	38861205	41873	potassium inwardly-rectifying channel, subfamily J, member 4
PA216	3762	KCNJ5	chr11	128751313	128794060	42747	potassium inwardly-rectifying channel, subfamily J, member 5
PA30049	3763	KCNJ6	chr21	38993778	39298741	304963	potassium inwardly-rectifying channel, subfamily J, member 6
PA30050	3764	KCNJ8	chr12	21914889	21938436	23547	potassium inwardly-rectifying channel, subfamily J, member 8
PA30051	3765	KCNJ9	chr1	160041360	160062212	20852	potassium inwardly-rectifying channel, subfamily J, member 9
PA219	3775	KCNK1	chr1	233739750	233811258	71508	potassium channel, subfamily K, member 1
PA30053	54207	KCNK10	chr14	88643452	88803256	159804	potassium channel, subfamily K, member 10
PA30054	56660	KCNK12	chr2	47744914	47807470	62556	potassium channel, subfamily K, member 12
PA30055	56659	KCNK13	chr14	90518109	90655201	137092	potassium channel, subfamily K, member 13
PA30056	60598	KCNK15	chr20	43364488	43383954	19466	potassium channel, subfamily K, member 15
PA30057	83795	KCNK16	chr6	39279474	39300330	20856	potassium channel, subfamily K, member 16
PA30058	89822	KCNK17	chr6	39263777	39292237	28460	potassium channel, subfamily K, member 17
PA134985465	338567	KCNK18	chr10	118947000	118972810	25810	potassium channel, subfamily K, member 18
PA30059	3776	KCNK2	chr1	215168885	215413436	244551	potassium channel, subfamily K, member 2
PA30060	3777	KCNK3	chr2	26905581	26957066	51485	potassium channel, subfamily K, member 3
PA30061	50801	KCNK4	chr11	64048774	64070503	21729	potassium channel, subfamily K, member 4
PA30062	8645	KCNK5	chr6	39153747	39207251	53504	potassium channel, subfamily K, member 5
PA30063	9424	KCNK6	chr19	38800484	38822654	22170	potassium channel, subfamily K, member 6
PA30064	10089	KCNK7	chr11	65357326	65373467	16141	potassium channel, subfamily K, member 7
PA30065	51305	KCNK9	chr8	140610081	140725299	115218	potassium channel, subfamily K, member 9
PA220	3778	KCNMA1	chr10	78626359	79407577	781218	potassium large conductance calcium-activated channel, subfamily M, alpha member 1
PA221	3779	KCNMB1	chr5	169802165	169826681	24516	potassium large conductance calcium-activated channel, subfamily M, beta member 1
PA30066	10242	KCNMB2	chr3	178244086	178565217	321131	potassium large conductance calcium-activated channel, subfamily M, beta member 2
PA30067	27094	KCNMB3	chr3	178954537	178994838	40301	potassium large conductance calcium-activated channel, subfamily M beta member 3
PA30069	27345	KCNMB4	chr12	70750062	70831072	81010	potassium large conductance calcium-activated channel, subfamily M, beta member 4
PA30070	3780	KCNN1	chr19	18052111	18113133	61022	potassium intermediate/small conductance calcium-activated channel, subfamily N, member 1
PA30071	3781	KCNN2	chr5	113688016	113835197	147181	potassium intermediate/small conductance calcium-activated channel, subfamily N, member 2
PA30072	3782	KCNN3	chr1	154666938	154852754	185816	potassium intermediate/small conductance calcium-activated channel, subfamily N, member 3
PA222	3783	KCNN4	chr19	44267685	44296269	28584	potassium intermediate/small conductance calcium-activated channel, subfamily N, member 4
PA223	3784	KCNQ1	chr11	2456221	2873340	417119	potassium voltage-gated channel, KQT-like subfamily, member 1
PA30074	3785	KCNQ2	chr20	62028561	62113993	85432	potassium voltage-gated channel, KQT-like subfamily, member 2
PA30075	3786	KCNQ3	chr8	133130105	133503004	372899	potassium voltage-gated channel, KQT-like subfamily, member 3
PA30076	9132	KCNQ4	chr1	41239684	41309124	69440	potassium voltage-gated channel, KQT-like subfamily, member 4
PA30077	56479	KCNQ5	chr6	73321571	73911574	590003	potassium voltage-gated channel, KQT-like subfamily, member 5
PA134924183	283518	KCNRG	chr13	50579390	50598058	18668	potassium channel regulator
PA30078	3787	KCNS1	chr20	43717950	43739753	21803	potassium voltage-gated channel, delayed-rectifier, subfamily S, member 1
PA30079	3788	KCNS2	chr8	99429250	99446025	16775	potassium voltage-gated channel, delayed-rectifier, subfamily S, member 2
PA30080	3790	KCNS3	chr2	18049105	18117225	68120	potassium voltage-gated channel, delayed-rectifier, subfamily S, member 3
PA38725	57582	KCNT1	chr9	138584031	138687993	103962	potassium channel, subfamily T, member 1
PA38726	343450	KCNT2	chr1	196191913	196587690	395777	potassium channel, subfamily T, member 2
PA38727	157855	KCNU1	chr8	36631842	36796643	164801	potassium channel, subfamily U, member 1
PA38721	27012	KCNV1	chr8	110976233	110997963	21730	potassium channel, subfamily V, member 1
PA134992655	169522	KCNV2	chr9	2707526	2733037	25511	potassium channel, subfamily V, member 2
PA30082	284252	KCTD1	chr18	24031874	24247365	215491	potassium channel tetramerization domain containing 1
PA134938409	83892	KCTD10	chr12	109883460	109925165	41705	potassium channel tetramerization domain containing 10
PA134890547	147040	KCTD11	chr17	7245208	7261263	16055	potassium channel tetramerization domain containing 11
PA25512	115207	KCTD12	chr13	77451304	77470540	19236	potassium channel tetramerization domain containing 12
PA134907908	253980	KCTD13	chr16	29914657	29947545	32888	potassium channel tetramerization domain containing 13
PA134875104	65987	KCTD14	chr11	77723761	77767237	43476	potassium channel tetramerization domain containing 14
PA134916319	79047	KCTD15	chr19	34277751	34309666	31915	potassium channel tetramerization domain containing 15
PA134973546	57528	KCTD16	chr5	143540437	143861097	320660	potassium channel tetramerization domain containing 16
PA142671638	79734	KCTD17	chr22	37437779	37462430	24651	potassium channel tetramerization domain containing 17
PA142671639	130535	KCTD18	chr2	201350677	201384817	34140	potassium channel tetramerization domain containing 18
PA142671640	146212	KCTD19	chr16	67320338	67370664	50326	potassium channel tetramerization domain containing 19
PA134890451	23510	KCTD2	chr17	73033279	73064981	31702	potassium channel tetramerization domain containing 2
PA134913479	222658	KCTD20	chr6	36400544	36461918	61374	potassium channel tetramerization domain containing 20
PA145148689	283219	KCTD21	chr11	77879289	77910006	30717	potassium channel tetramerization domain containing 21
PA134945859	51133	KCTD3	chr1	215730528	215798149	67621	potassium channel tetramerization domain containing 3
PA134880839	386618	KCTD4	chr13	45763988	45785175	21187	potassium channel tetramerization domain containing 4
PA134923177	54442	KCTD5	chr16	2722495	2762031	39536	potassium channel tetramerization domain containing 5
PA134918095	200845	KCTD6	chr3	58467823	58491087	23264	potassium channel tetramerization domain containing 6
PA134884591	154881	KCTD7	chr7	66083868	66116964	33096	potassium channel tetramerization domain containing 7
PA134909779	386617	KCTD8	chr4	44172920	44460824	287904	potassium channel tetramerization domain containing 8
PA134869993	54793	KCTD9	chr8	25282363	25325984	43621	potassium channel tetramerization domain containing 9
PA134974174	79070	KDELC1	chr13	103433631	103461404	27773	KDEL (Lys-Asp-Glu-Leu) containing 1
PA134904072	143888	KDELC2	chr11	108339832	108379169	39337	KDEL (Lys-Asp-Glu-Leu) containing 2
PA30083	10945	KDELR1	chr19	48882827	48904810	21983	KDEL (Lys-Asp-Glu-Leu) endoplasmic reticulum protein retention receptor 1
PA30084	11014	KDELR2	chr7	6497712	6533849	36137	KDEL (Lys-Asp-Glu-Leu) endoplasmic reticulum protein retention receptor 2
PA30085	11015	KDELR3	chr22	38854067	38882452	28385	KDEL (Lys-Asp-Glu-Leu) endoplasmic reticulum protein retention receptor 3
PA142672421	126695	KDF1	chr1	27273047	27296901	23854	keratinocyte differentiation factor 1
PA165751392	23028	KDM1A	chr1	23335937	23413184	77247	lysine (K)-specific demethylase 1A
PA165617946	221656	KDM1B	chr6	18145619	18227085	81466	lysine (K)-specific demethylase 1B
PA164721195	22992	KDM2A	chr11	66876740	67028553	151813	lysine (K)-specific demethylase 2A
PA164721242	84678	KDM2B	chr12	121863899	122029110	165211	lysine (K)-specific demethylase 2B
PA164721293	55818	KDM3A	chr2	86658271	86722839	64568	lysine (K)-specific demethylase 3A
PA25918	51780	KDM3B	chr5	137678285	137775716	97431	lysine (K)-specific demethylase 3B
PA164721403	9682	KDM4A	chr1	44105797	44174189	68392	lysine (K)-specific demethylase 4A
PA164721452	23030	KDM4B	chr19	4959123	5156609	197486	lysine (K)-specific demethylase 4B
PA164721503	23081	KDM4C	chr9	6710863	7178648	467785	lysine (K)-specific demethylase 4C
PA164721552	55693	KDM4D	chr11	94696845	94735678	38833	lysine (K)-specific demethylase 4D
PA165543440	390245	KDM4E	chr11	94748422	94763760	15338	lysine (K)-specific demethylase 4E
PA34250	5927	KDM5A	chr12	386223	508620	122397	lysine (K)-specific demethylase 5A
PA164721626	10765	KDM5B	chr1	202693532	202787549	94017	lysine (K)-specific demethylase 5B
PA35964	8242	KDM5C	chrX	53217503	53264604	47101	lysine (K)-specific demethylase 5C
PA35965	8284	KDM5D	chrY	21864301	21916825	52524	lysine (K)-specific demethylase 5D
PA37262	7403	KDM6A	chrX	44722419	44975024	252605	lysine (K)-specific demethylase 6A
PA165431973	23135	KDM6B	chr17	7727521	7761118	33597	lysine (K)-specific demethylase 6B
PA162392512	80853	KDM7A	chr7	139781546	139886741	105195	lysine (K)-specific demethylase 7A
PA143485510	79831	KDM8	chr16	27204807	27236089	31282	lysine (K)-specific demethylase 8
PA30086	3791	KDR	chr4	55941426	56001762	60336	kinase insert domain receptor (a type III receptor tyrosine kinase)
PA162392777	2531	KDSR	chr18	60991971	61044506	52535	3-ketodihydrosphingosine reductase
PA134887774	9817	KEAP1	chr19	10593796	10624054	30258	kelch-like ECH-associated protein 1
PA30087	3792	KEL	chr7	142635201	142669503	34302	Kell blood group, metallo-endopeptidase
PA30088	11081	KERA	chr12	91441268	91462131	20863	keratocan
PA162392802	80759	KHDC1	chr6	73948037	74029938	81901	KH homology domain containing 1
PA165617988	100129128	KHDC1L	chr6	73930267	73945175	14908	KH homology domain containing 1-like
PA162380388	154288	KHDC3L	chr6	74062400	74076898	14498	KH domain containing 3-like, subcortical maternal complex member
PA30092	10657	KHDRBS1	chr1	32469295	32529460	60165	KH domain containing, RNA binding, signal transduction associated 1
PA30093	202559	KHDRBS2	chr6	62386865	63006100	619235	KH domain containing, RNA binding, signal transduction associated 2
PA30094	10656	KHDRBS3	chr8	136459702	136672068	212366	KH domain containing, RNA binding, signal transduction associated 3
PA30095	3795	KHK	chr2	27299611	27326619	27008	ketohexokinase (fructokinase)
PA165479143	23351	KHNYN	chr14	24888882	24913548	24666	KH and NYN domain containing
PA30097	8570	KHSRP	chr19	6410115	6434822	24707	KH-type splicing regulatory protein
PA134895115	9933	KIAA0020	chr9	2801152	2854130	52978	KIAA0020
PA142671635	9703	KIAA0100	chr17	26938458	26982177	43719	KIAA0100
PA134974023	9768	KIAA0101	chr15	64654193	64689914	35721	KIAA0101
PA134992099	9812	KIAA0141	chr5	141293350	141333027	39677	KIAA0141
PA142671623	9772	KIAA0195	chr17	73442664	73499533	56869	KIAA0195
PA142671624	9897	KIAA0196	chr8	126033502	126114061	80559	KIAA0196
PA134887849	9711	KIAA0226	chr3	197395259	197486568	91309	KIAA0226
PA134942431	80183	KIAA0226L	chr13	46913136	46974177	61041	KIAA0226-like
PA162392816	9778	KIAA0232	chr4	6774459	6888899	114440	KIAA0232
PA128394557	9766	KIAA0247	chr14	70068310	70184861	116551	KIAA0247
PA134936721	9856	KIAA0319	chr6	24541332	24656383	115051	KIAA0319
PA142671625	79932	KIAA0319L	chr1	35896091	36033037	136946	KIAA0319-like
PA134927016	9710	KIAA0355	chr19	34735456	34849471	114015	KIAA0355
PA134979723	23392	KIAA0368	chr9	114119973	114257025	137052	KIAA0368
PA134879499	9692	KIAA0391	chr14	35581527	35746284	164757	KIAA0391
PA134883396	9729	KIAA0408	chr6	127756551	127790535	33984	KIAA0408
PA145148631	9665	KIAA0430	chr16	15685226	15747023	61797	KIAA0430
PA134951520	9764	KIAA0513	chr16	85051374	85130836	79462	KIAA0513
PA162392880	23247	KIAA0556	chr16	27551441	27794692	243251	KIAA0556
PA134992213	9786	KIAA0586	chr14	58884103	59018549	134446	KIAA0586
PA142671615	9851	KIAA0753	chr17	6478645	6555066	76421	KIAA0753
PA128394598	643314	KIAA0754	chr1	39865176	39885154	19978	KIAA0754
PA162380116	285600	KIAA0825	chr5	93483556	93964309	480753	KIAA0825
PA164721801	23366	KIAA0895	chr7	36360759	36439734	78975	KIAA0895
PA164721818	653319	KIAA0895L	chr16	67206505	67227883	21378	KIAA0895-like
PA142671618	22889	KIAA0907	chr1	155879834	155914209	34375	KIAA0907
PA128394615	23240	KIAA0922	chr4	154377498	154561760	184262	KIAA0922
PA128394623	23313	KIAA0930	chr22	45585123	45646650	61527	KIAA0930
PA162393036	23251	KIAA1024	chr15	79714858	79767642	52784	KIAA1024
PA128394626	23325	KIAA1033	chr12	105491492	105565912	74420	KIAA1033
PA134993280	23349	KIAA1045	chr9	34947484	34985541	38057	KIAA1045
PA142671620	23285	KIAA1107	chr1	92622609	92653280	30671	KIAA1107
PA142671621	84162	KIAA1109	chr4	123063488	123286914	223426	KIAA1109
PA142671622	57456	KIAA1143	chr3	44787236	44813173	25937	KIAA1143
PA145148613	57189	KIAA1147	chr7	141353528	141411953	58425	KIAA1147
PA134929853	57462	KIAA1161	chr9	34365907	34386894	20987	KIAA1161
PA143485516	57179	KIAA1191	chr5	175770065	175798809	28744	KIAA1191
PA164721837	57481	KIAA1210	chrX	118209598	118294542	84944	KIAA1210
PA164721869	57482	KIAA1211	chr4	57026361	57199890	173529	KIAA1211
PA162379241	343990	KIAA1211L	chr2	99407309	99562684	155375	KIAA1211-like
PA134893343	56243	KIAA1217	chr10	23973675	24839772	866097	KIAA1217
PA134888863	57221	KIAA1244	chr6	138473053	138668800	195747	KIAA1244
PA142671603	57501	KIAA1257	chr3	128686779	128729915	43136	KIAA1257
PA134897614	26128	KIAA1279	chr10	70738477	70779739	41262	KIAA1279
PA142671607	57535	KIAA1324	chr1	109646585	109752403	105818	KIAA1324
PA142671608	222223	KIAA1324L	chr7	86503222	86699014	195792	KIAA1324-like
PA134875219	57536	KIAA1328	chr18	34399069	34815095	416026	KIAA1328
PA143485517	57562	KIAA1377	chr11	101775746	101874793	99047	KIAA1377
PA134916748	57577	KIAA1407	chr3	113679984	113785460	105476	KIAA1407
PA142671611	25962	KIAA1429	chr8	95497005	95575746	78741	KIAA1429
PA143485343	57604	KIAA1456	chr8	12793183	12890286	97103	KIAA1456
PA134955526	57608	KIAA1462	chr10	30298729	30358488	59759	KIAA1462
PA128395790	57613	KIAA1467	chr12	13187300	13239383	52083	KIAA1467
PA134865247	57614	KIAA1468	chr18	59844506	59977355	132849	KIAA1468
PA142671612	57648	KIAA1522	chr1	33197492	33243571	46079	KIAA1522
PA134887850	57650	KIAA1524	chr3	108265716	108318491	52775	KIAA1524
PA162393138	57670	KIAA1549	chr7	138513126	138676064	162938	KIAA1549
PA142672301	25758	KIAA1549L	chr11	33553877	33698648	144771	KIAA1549-like
PA143485365	55196	KIAA1551	chr12	32102353	32149041	46688	KIAA1551
PA134963244	57691	KIAA1586	chr6	56901343	56923023	21680	KIAA1586
PA134973737	57698	KIAA1598	chr10	118639888	118896097	256209	KIAA1598
PA142671595	57710	KIAA1614	chr1	180872313	180923745	51432	KIAA1614
PA164721896	85352	KIAA1644	chr22	44636545	44737470	100925	KIAA1644
PA165378342	85379	KIAA1671	chr22	25338676	25596415	257739	KIAA1671
PA134952902	80726	KIAA1683	chr19	18364906	18395319	30413	KIAA1683
PA134938939	80856	KIAA1715	chr2	176787410	176877018	89608	KIAA1715
PA162393181	85449	KIAA1755	chr20	36835907	36899174	63267	KIAA1755
PA144596415	84542	KIAA1841	chr2	61283005	61368169	85164	KIAA1841
PA128394744	91749	KIAA1919	chr6	111570482	111593263	22781	KIAA1919
PA134937806	158405	KIAA1958	chr9	115239248	115430587	191339	KIAA1958
PA142671593	90231	KIAA2013	chr1	11976645	11996485	19840	KIAA2013
PA142671594	205717	KIAA2018	chr3	113364232	113425493	61261	KIAA2018
PA162393214	340533	KIAA2022	chrX	73949691	74155287	205596	KIAA2022
PA134907262	158358	KIAA2026	chr9	5916008	6018479	102471	KIAA2026
PA164721911	57498	KIDINS220	chr2	8862295	8987755	125460	kinase D-interacting substrate, 220kDa
PA30177	3832	KIF11	chr10	94342825	94418152	75327	kinesin family member 11
PA134931618	113220	KIF12	chr9	116850903	116871600	20697	kinesin family member 12
PA30098	63971	KIF13A	chr6	17756414	17997864	241450	kinesin family member 13A
PA30099	23303	KIF13B	chr8	28921795	29130610	208815	kinesin family member 13B
PA38820	9928	KIF14	chr1	200517625	200599862	82237	kinesin family member 14
PA30183	56992	KIF15	chr3	44793209	44897748	104539	kinesin family member 15
PA162393227	55614	KIF16B	chr20	16249742	16564079	314337	kinesin family member 16B
PA38809	57576	KIF17	chr1	20987475	21054317	66842	kinesin family member 17
PA134951326	81930	KIF18A	chr11	28039163	28139746	100583	kinesin family member 18A
PA162393284	146909	KIF18B	chr17	42999079	43035079	36000	kinesin family member 18B
PA143485523	124602	KIF19	chr17	72312351	72354959	42608	kinesin family member 19
PA25180	547	KIF1A	chr2	241650181	241769725	119544	kinesin family member 1A
PA38176	23095	KIF1B	chr1	10260606	10444664	184058	kinesin family member 1B
PA30100	10749	KIF1C	chr17	4891243	4934694	43451	kinesin family member 1C
PA34149	10112	KIF20A	chr5	137504408	137526404	21996	kinesin family member 20A
PA162393285	9585	KIF20B	chr10	91451264	91537700	86436	kinesin family member 20B
PA134882934	55605	KIF21A	chr12	39684030	39847192	163162	kinesin family member 21A
PA134925106	23046	KIF21B	chr1	200935514	201002828	67314	kinesin family member 21B
PA30180	3835	KIF22	chr16	29791383	29819706	28323	kinesin family member 22
PA30181	9493	KIF23	chr15	69696585	69743766	47181	kinesin family member 23
PA142671589	347240	KIF24	chr9	34249378	34339198	89820	kinesin family member 24
PA30179	3834	KIF25	chr6	168408553	168448769	40216	kinesin family member 25
PA134888008	26153	KIF26A	chr14	104595060	104650235	55175	kinesin family member 26A
PA145148575	55083	KIF26B	chr1	245308287	245869428	561141	kinesin family member 26B
PA134912901	55582	KIF27	chr9	86448613	86546428	97815	kinesin family member 27
PA162393356	3796	KIF2A	chr5	61591989	61686011	94022	kinesin heavy chain member 2A
PA134928830	84643	KIF2B	chr17	51890239	51905573	15334	kinesin family member 2B
PA30182	11004	KIF2C	chr1	45195396	45236439	41043	kinesin family member 2C
PA30102	11127	KIF3A	chr5	132025323	132083265	57942	kinesin family member 3A
PA30103	9371	KIF3B	chr20	30855443	30925814	70371	kinesin family member 3B
PA30104	3797	KIF3C	chr2	26146455	26215443	68988	kinesin family member 3C
PA30105	24137	KIF4A	chrX	69499879	69643774	143895	kinesin family member 4A
PA30106	285643	KIF4B	chr5	154383260	154400685	17425	kinesin family member 4B
PA30107	3798	KIF5A	chr12	57933812	57983416	49604	kinesin family member 5A
PA30108	3799	KIF5B	chr10	32294938	32355371	60433	kinesin family member 5B
PA30109	3800	KIF5C	chr2	149783796	149886273	102477	kinesin family member 5C
PA134920075	221458	KIF6	chr6	39299876	39703181	403305	kinesin family member 6
PA134871338	374654	KIF7	chr15	90168201	90208725	40524	kinesin family member 7
PA30110	64147	KIF9	chr3	47266516	47334337	67821	kinesin family member 9
PA30111	22920	KIFAP3	chr1	169887461	170053882	166421	kinesin-associated protein 3
PA30178	3833	KIFC1	chr6	33349301	33380701	31400	kinesin family member C1
PA134874212	90990	KIFC2	chr8	145681432	145702499	21067	kinesin family member C2
PA30112	3801	KIFC3	chr16	57789129	57906957	117828	kinesin family member C3
PA30113	22944	KIN	chr10	7789925	7839990	50065	Kin17 DNA and RNA binding protein
PA30114	3802	KIR2DL1	chr19	55271265	55298778	27513	killer cell immunoglobulin-like receptor, two domains, long cytoplasmic tail, 1
PA30115	3803	KIR2DL2	chr19	11917	39449	27532	killer cell immunoglobulin-like receptor, two domains, long cytoplasmic tail, 2
PA30116	3804	KIR2DL3	chr19	55239974	55267504	27530	killer cell immunoglobulin-like receptor, two domains, long cytoplasmic tail, 3
PA30117	3805	KIR2DL4	chr19	55305067	55328972	23905	killer cell immunoglobulin-like receptor, two domains, long cytoplasmic tail, 4
PA142671590	57292	KIR2DL5A	chr19	76691	99155	22464	killer cell immunoglobulin-like receptor, two domains, long cytoplasmic tail, 5A
PA142671591	553128	KIR2DL5B	chr19	59948288	60037138	88850	killer cell immunoglobulin-like receptor, two domains, long cytoplasmic tail, 5B
PA30118	3806	KIR2DS1	chr19	105099	132113	27014	killer cell immunoglobulin-like receptor, two domains, short cytoplasmic tail, 1
PA30119	100132285	KIR2DS2	chr19	121449	148745	27296	killer cell immunoglobulin-like receptor, two domains, short cytoplasmic tail, 2
PA30121	3809	KIR2DS4	chr19	55334174	55363023	28849	killer cell immunoglobulin-like receptor, two domains, short cytoplasmic tail, 4
PA30123	3811	KIR3DL1	chr19	55317893	55345233	27340	killer cell immunoglobulin-like receptor, three domains, long cytoplasmic tail, 1
PA30124	3812	KIR3DL2	chr19	55351898	55381662	29764	killer cell immunoglobulin-like receptor, three domains, long cytoplasmic tail, 2
PA134887375	115653	KIR3DL3	chr19	55225984	55251003	25019	killer cell immunoglobulin-like receptor, three domains, long cytoplasmic tail, 3
PA30125	3813	KIR3DS1	chr19	60097	87658	27561	killer cell immunoglobulin-like receptor, three domains, short cytoplasmic tail, 1
PA30126	55243	KIRREL	chr1	157953063	158068846	115783	kin of IRRE like (Drosophila)
PA38693	84063	KIRREL2	chr19	36332552	36361048	28496	kin of IRRE like 2 (Drosophila)
PA134958283	84623	KIRREL3	chr11	126290388	126880766	590378	kin of IRRE like 3 (Drosophila)
PA30127	3814	KISS1	chr1	204156469	204175619	19150	KiSS-1 metastasis-suppressor
PA28899	84634	KISS1R	chr19	907342	924015	16673	KISS1 receptor
PA30128	3815	KIT	chr4	55514095	55609881	95786	v-kit Hardy-Zuckerman 4 feline sarcoma viral oncogene homolog
PA30129	4254	KITLG	chr12	88883570	88984250	100680	KIT ligand
PA165392491	55857	KIZ	chr20	21096624	21230260	133636	kizuna centrosomal protein
PA30130	9365	KL	chr13	33580571	33643282	62711	klotho
PA142671586	152831	KLB	chr4	39398473	39456153	57680	klotho beta
PA162393424	3831	KLC1	chr14	104085525	104170888	85363	kinesin light chain 1
PA142671587	64837	KLC2	chr11	66014765	66038332	23567	kinesin light chain 2
PA142671588	147700	KLC3	chr19	45833998	45857864	23866	kinesin light chain 3
PA134934134	89953	KLC4	chr6	43017372	43045833	28461	kinesin light chain 4
PA30131	10661	KLF1	chr19	12992236	13008017	15781	Kruppel-like factor 1 (erythroid)
PA36517	7071	KLF10	chr8	103658005	103678130	20125	Kruppel-like factor 10
PA36518	8462	KLF11	chr2	10160776	10197963	37187	Kruppel-like factor 11
PA30132	11278	KLF12	chr13	74257149	74718400	461251	Kruppel-like factor 12
PA30133	51621	KLF13	chr15	31609083	31673102	64019	Kruppel-like factor 13
PA134868089	136259	KLF14	chr7	130414382	130428860	14478	Kruppel-like factor 14
PA30134	28999	KLF15	chr3	126058478	126086236	27758	Kruppel-like factor 15
PA30135	83855	KLF16	chr19	1849398	1873564	24166	Kruppel-like factor 16
PA134877071	128209	KLF17	chr1	44503987	44603812	99825	Kruppel-like factor 17
PA30136	10365	KLF2	chr19	16425651	16441345	15694	Kruppel-like factor 2
PA30137	51274	KLF3	chr4	38655790	38706129	50339	Kruppel-like factor 3 (basic)
PA30138	9314	KLF4	chr9	110244133	110262047	17914	Kruppel-like factor 4 (gut)
PA30139	688	KLF5	chr13	73619114	73654676	35562	Kruppel-like factor 5 (intestinal)
PA26751	1316	KLF6	chr10	3815188	3837473	22285	Kruppel-like factor 6
PA30140	8609	KLF7	chr2	207935861	208041970	106109	Kruppel-like factor 7 (ubiquitous)
PA30141	11279	KLF8	chrX	56248814	56317322	68508	Kruppel-like factor 8
PA25444	687	KLF9	chr9	72996513	73039573	43060	Kruppel-like factor 9
PA134938689	122773	KLHDC1	chr14	50149823	50222870	73047	kelch domain containing 1
PA164721976	23008	KLHDC10	chr7	129700349	129778560	78211	kelch domain containing 10
PA134924955	23588	KLHDC2	chr14	50224787	50252856	28069	kelch domain containing 2
PA134892782	116138	KLHDC3	chr6	42971841	42992036	20195	kelch domain containing 3
PA134914472	54758	KLHDC4	chr16	87727239	87809603	82364	kelch domain containing 4
PA142671581	127707	KLHDC7A	chr1	18797424	18815540	18116	kelch domain containing 7A
PA142671582	113730	KLHDC7B	chr22	50976462	50992452	15990	kelch domain containing 7B
PA142671583	55220	KLHDC8A	chr1	205302193	205336218	34025	kelch domain containing 8A
PA142671584	200942	KLHDC8B	chr3	49198987	49216919	17932	kelch domain containing 8B
PA162393459	126823	KLHDC9	chr1	161058151	161073138	14987	kelch domain containing 9
PA30142	57626	KLHL1	chr13	70271725	70692625	420900	kelch-like family member 1
PA134969977	317719	KLHL10	chr17	39982572	40007599	25027	kelch-like family member 10
PA38777	55175	KLHL11	chr17	40006799	40031629	24830	kelch-like family member 11
PA134952416	59349	KLHL12	chr1	202857230	202907766	50536	kelch-like family member 12
PA134959204	90293	KLHL13	chrX	117028776	117261303	232527	kelch-like family member 13
PA134945930	57565	KLHL14	chr18	30249634	30363815	114181	kelch-like family member 14
PA134934728	80311	KLHL15	chrX	23998833	24055303	56470	kelch-like family member 15
PA134887396	339451	KLHL17	chr1	885967	904099	18132	kelch-like family member 17
PA134920201	23276	KLHL18	chr3	47314116	47391306	77190	kelch-like family member 18
PA30143	11275	KLHL2	chr4	166118770	166247308	128538	kelch-like family member 2
PA134982126	27252	KLHL20	chr1	173674063	173758960	84897	kelch-like family member 20
PA134989246	9903	KLHL21	chr1	6647784	6672958	25174	kelch-like family member 21
PA142671574	84861	KLHL22	chr22	20792806	20860170	67364	kelch-like family member 22
PA142671575	151230	KLHL23	chr2	170580356	170611396	31040	kelch-like family member 23
PA142671576	54800	KLHL24	chr3	183343398	183405307	61909	kelch-like family member 24
PA142671577	64410	KLHL25	chr15	86299557	86348189	48632	kelch-like family member 25
PA143485524	55295	KLHL26	chr19	18737835	18784308	46473	kelch-like family member 26
PA162393472	54813	KLHL28	chr14	45390527	45441179	50652	kelch-like family member 28
PA162393486	114818	KLHL29	chr2	23598298	23934483	336185	kelch-like family member 29
PA30144	26249	KLHL3	chr5	136950189	137160310	210121	kelch-like family member 3
PA162393522	377007	KLHL30	chr2	239037310	239064547	27237	kelch-like family member 30
PA162393541	401265	KLHL31	chr6	53509699	53540506	30807	kelch-like family member 31
PA162393552	114792	KLHL32	chr6	97362496	97591630	229134	kelch-like family member 32
PA162393579	123103	KLHL33	chr14	20892866	20914354	21488	kelch-like family member 33
PA162393594	257240	KLHL34	chrX	21670609	21686448	15839	kelch-like family member 34
PA162393595	283212	KLHL35	chr11	75130438	75151674	21236	kelch-like family member 35
PA162393612	79786	KLHL36	chr16	84672131	84704187	32056	kelch-like family member 36
PA162393613	340359	KLHL38	chr8	124654743	124676041	21298	kelch-like family member 38
PA30145	56062	KLHL4	chrX	86762715	86928050	165335	kelch-like family member 4
PA134908127	131377	KLHL40	chr3	42717011	42736938	19927	kelch-like family member 40
PA134950205	10324	KLHL41	chr2	170356212	170385772	29560	kelch-like family member 41
PA142671579	57542	KLHL42	chr12	27923187	27958973	35786	kelch-like family member 42
PA30146	51088	KLHL5	chr4	39036308	39130853	94545	kelch-like family member 5
PA38621	89857	KLHL6	chr3	183202319	183283499	81180	kelch-like family member 6
PA38392	55975	KLHL7	chr7	23135353	23218040	82687	kelch-like family member 7
PA38616	57563	KLHL8	chr4	88078260	88171466	93206	kelch-like family member 8
PA38662	55958	KLHL9	chr9	21328018	21345429	17411	kelch-like family member 9
PA224	3816	KLK1	chr19	51319402	51337043	17641	kallikrein 1
PA30147	5655	KLK10	chr19	51513000	51533431	20431	kallikrein-related peptidase 10
PA30148	11012	KLK11	chr19	51522487	51541290	18803	kallikrein-related peptidase 11
PA30149	43849	KLK12	chr19	51529348	51548486	19138	kallikrein-related peptidase 12
PA30150	26085	KLK13	chr19	51556021	51578367	22346	kallikrein-related peptidase 13
PA30151	43847	KLK14	chr19	51578154	51597502	19348	kallikrein-related peptidase 14
PA134977502	55554	KLK15	chr19	51325545	51344779	19234	kallikrein-related peptidase 15
PA30152	3817	KLK2	chr19	51366689	51386823	20134	kallikrein-related peptidase 2
PA164741810	354	KLK3	chr19	51348171	51367020	18849	kallikrein-related peptidase 3
PA30154	9622	KLK4	chr19	51406608	51423994	17386	kallikrein-related peptidase 4
PA30155	25818	KLK5	chr19	51443559	51466344	22785	kallikrein-related peptidase 5
PA30156	5653	KLK6	chr19	51458887	51482929	24042	kallikrein-related peptidase 6
PA30157	5650	KLK7	chr19	51476735	51497320	20585	kallikrein-related peptidase 7
PA30158	11202	KLK8	chr19	51496264	51514958	18694	kallikrein-related peptidase 8
PA30159	284366	KLK9	chr19	51502769	51522890	20121	kallikrein-related peptidase 9
PA30160	3818	KLKB1	chr4	187138502	187182625	44123	kallikrein B, plasma (Fletcher factor) 1
PA30162	3820	KLRB1	chr12	9744870	9770497	25627	killer cell lectin-like receptor subfamily B, member 1
PA30163	3821	KLRC1	chr12	10591863	10617215	25352	killer cell lectin-like receptor subfamily C, member 1
PA30164	3822	KLRC2	chr12	10580198	10598780	18582	killer cell lectin-like receptor subfamily C, member 2
PA30165	3823	KLRC3	chr12	10561914	10583194	21280	killer cell lectin-like receptor subfamily C, member 3
PA30166	8302	KLRC4	chr12	10538529	10572370	33841	killer cell lectin-like receptor subfamily C, member 4
PA30167	3824	KLRD1	chr12	10447050	10472850	25800	killer cell lectin-like receptor subfamily D, member 1
PA30169	51348	KLRF1	chr12	9970038	10000604	30566	killer cell lectin-like receptor subfamily F, member 1
PA165512949	100431172	KLRF2	chr12	10024088	10051432	27344	killer cell lectin-like receptor subfamily F, member 2
PA30170	10219	KLRG1	chr12	9132137	9166343	34206	killer cell lectin-like receptor subfamily G, member 1
PA162393624	346689	KLRG2	chr7	139135088	139178457	43369	killer cell lectin-like receptor subfamily G, member 2
PA128394594	22914	KLRK1	chr12	10521952	10552653	30701	killer cell lectin-like receptor subfamily K, member 1
PA30172	8564	KMO	chr1	241685324	241761949	76625	kynurenine 3-monooxygenase (kynurenine 3-hydroxylase)
PA241	4297	KMT2A	chr11	118297205	118400539	103334	lysine (K)-specific methyltransferase 2A
PA30847	58508	KMT2C	chr7	151829010	152143090	314080	lysine (K)-specific methyltransferase 2C
PA30846	8085	KMT2D	chr12	49409758	49463935	54177	lysine (K)-specific methyltransferase 2D
PA38568	55904	KMT2E	chr7	104644637	104757532	112895	lysine (K)-specific methyltransferase 2E
PA162393639	148930	KNCN	chr1	47008316	47026887	18571	kinocilin
PA134983621	85442	KNDC1	chr10	134963971	135042916	78945	kinase non-catalytic C-lobe domain (KIND) containing 1
PA225	3827	KNG1	chr3	186425098	186465199	40101	kininogen 1
PA162378471	400506	KNOP1	chr16	19714673	19739726	25053	lysine-rich nucleolar protein 1
PA134895025	90417	KNSTRN	chr15	40664922	40689489	24567	kinetochore-localized astrin/SPAG5 binding protein
PA30184	9735	KNTC1	chr12	123001796	123113947	112151	kinetochore associated 1
PA30185	3836	KPNA1	chr3	122137748	122243786	106038	karyopherin alpha 1 (importin alpha 5)
PA30186	3838	KPNA2	chr17	66021848	66045970	24122	karyopherin alpha 2 (RAG cohort 1, importin alpha 1)
PA30187	3839	KPNA3	chr13	50270443	50377057	106614	karyopherin alpha 3 (importin alpha 4)
PA30188	3840	KPNA4	chr3	160209783	160293376	83593	karyopherin alpha 4 (importin alpha 3)
PA30189	3841	KPNA5	chr6	116992367	117066030	73663	karyopherin alpha 5 (importin alpha 6)
PA30190	23633	KPNA6	chr1	32563644	32645169	81525	karyopherin alpha 6 (importin alpha 7)
PA164722048	402569	KPNA7	chr7	98768197	98815089	46892	karyopherin alpha 7 (importin alpha 8)
PA30191	3837	KPNB1	chr17	45716861	45765037	48176	karyopherin (importin) beta 1
PA162393640	448834	KPRP	chr1	152720506	152737529	17023	keratinocyte proline-rich protein
PA30194	11133	KPTN	chr19	47975398	47997521	22123	kaptin (actin binding protein)
PA30196	3845	KRAS	chr12	25355180	25413870	58690	Kirsten rat sarcoma viral oncogene homolog
PA162393641	84626	KRBA1	chr7	149402061	149434664	32603	KRAB-A domain containing 1
PA162393680	124751	KRBA2	chr17	8268973	8290027	21054	KRAB-A domain containing 2
PA165697464	100506243	KRBOX1	chr3	42967834	42987284	19450	KRAB box domain containing 1
PA142670474	55634	KRBOX4	chrX	46296624	46337074	40450	KRAB box domain containing 4
PA162393681	51315	KRCC1	chr2	88323724	88365315	41591	lysine-rich coiled-coil 1
PA38241	83999	KREMEN1	chr22	29459066	29567321	108255	kringle containing transmembrane protein 1
PA38683	79412	KREMEN2	chr16	3004217	3021384	17167	kringle containing transmembrane protein 2
PA162393682	65095	KRI1	chr19	10660761	10686702	25941	KRI1 homolog (S. cerevisiae)
PA26144	889	KRIT1	chr7	91825283	91885414	60131	KRIT1, ankyrin repeat containing
PA29450	11103	KRR1	chr12	75888419	75915418	26999	KRR1, small subunit (SSU) processome component, homolog (yeast)
PA30199	3848	KRT1	chr12	53065520	53084191	18671	keratin 1
PA30200	3858	KRT10	chr17	38971369	38988863	17494	keratin 10
PA30201	3859	KRT12	chr17	39014430	39033462	19032	keratin 12
PA30202	3860	KRT13	chr17	39654233	39671865	17632	keratin 13
PA30203	3861	KRT14	chr17	39735531	39753147	17616	keratin 14
PA30208	3866	KRT15	chr17	39666997	39688033	21036	keratin 15
PA30210	3868	KRT16	chr17	39763030	39779079	16049	keratin 16
PA30207	729252	KRT16P1	chr17	18333222	18349209	15987	keratin 16 pseudogene 1
PA30214	3872	KRT17	chr17	39772692	39790882	18190	keratin 17
PA30217	3875	KRT18	chr12	53332655	53349690	17035	keratin 18
PA30225	3880	KRT19	chr17	39676869	39694641	17772	keratin 19
PA30227	3849	KRT2	chr12	53035342	53055959	20617	keratin 2
PA134938907	54474	KRT20	chr17	39029141	39051495	22354	keratin 20
PA165432008	125113	KRT222	chr17	38808872	38831416	22544	keratin 222
PA134914537	25984	KRT23	chr17	39075948	39103895	27947	keratin 23 (histone deacetylase inducible)
PA38344	192666	KRT24	chr17	38851243	38870002	18759	keratin 24
PA134977088	147183	KRT25	chr17	38901273	38921584	20311	keratin 25
PA134863261	353288	KRT26	chr17	38919490	38938411	18921	keratin 26
PA134990976	342574	KRT27	chr17	38930060	38948786	18726	keratin 27
PA134871316	162605	KRT28	chr17	38945448	38966211	20763	keratin 28
PA30228	3850	KRT3	chr12	53180469	53199892	19423	keratin 3
PA30237	3881	KRT31	chr17	39546976	39563844	16868	keratin 31
PA30238	3882	KRT32	chr17	39612765	39633638	20873	keratin 32
PA30239	3883	KRT33A	chr17	39499344	39517064	17720	keratin 33A
PA30240	3884	KRT33B	chr17	39516746	39536052	19306	keratin 33B
PA30241	3885	KRT34	chr17	39530921	39548636	17715	keratin 34
PA30242	3886	KRT35	chr17	39629941	39647392	17451	keratin 35
PA30243	8689	KRT36	chr17	39639388	39658799	19411	keratin 36
PA30244	8688	KRT37	chr17	39573809	39590822	17013	keratin 37
PA30245	8687	KRT38	chr17	39589621	39607596	17975	keratin 38
PA147357633	390792	KRT39	chr17	39111669	39133144	21475	keratin 39
PA30229	3851	KRT4	chr12	53197327	53217900	20573	keratin 4
PA147357651	125115	KRT40	chr17	39130968	39153387	22419	keratin 40
PA30230	3852	KRT5	chr12	52905359	52924328	18969	keratin 5
PA30231	3853	KRT6A	chr12	52877958	52897181	19223	keratin 6A
PA30232	3854	KRT6B	chr12	52837435	52855910	18475	keratin 6B
PA134891227	286887	KRT6C	chr12	52859300	52877569	18269	keratin 6C
PA30233	3855	KRT7	chr12	52616954	52645709	28755	keratin 7
PA147357697	112802	KRT71	chr12	52934693	52956931	22238	keratin 71
PA147357719	140807	KRT72	chr12	52976373	53005322	28949	keratin 72
PA147031702	319101	KRT73	chr12	52998354	53022343	23989	keratin 73
PA147357741	121391	KRT74	chr12	52956603	52977609	21006	keratin 74
PA147357763	9119	KRT75	chr12	52814854	52838110	23256	keratin 75
PA147357785	51350	KRT76	chr12	53158939	53181129	22190	keratin 76
PA134896049	374454	KRT77	chr12	53080396	53107247	26851	keratin 77
PA147357807	196374	KRT78	chr12	53228588	53252778	24190	keratin 78
PA162393725	338785	KRT79	chr12	53212231	53238077	25846	keratin 79
PA30234	3856	KRT8	chr12	53287971	53353650	65679	keratin 8
PA147357831	144501	KRT80	chr12	52559780	52595798	36018	keratin 80
PA30247	3887	KRT81	chr12	52676697	52695299	18602	keratin 81
PA30248	3888	KRT82	chr12	52784735	52810176	25441	keratin 82
PA30249	3889	KRT83	chr12	52705085	52725182	20097	keratin 83
PA30250	3890	KRT84	chr12	52768596	52789417	20821	keratin 84
PA30251	3891	KRT85	chr12	52750790	52771309	20519	keratin 85
PA30252	3892	KRT86	chr12	52632892	52705947	73055	keratin 86
PA30235	3857	KRT9	chr17	39719093	39738310	19217	keratin 9
PA38412	81851	KRTAP1-1	chr17	39193811	39207713	13902	keratin associated protein 1-1
PA38411	81850	KRTAP1-3	chr17	39187136	39201107	13971	keratin associated protein 1-3
PA38752	728255	KRTAP1-4	chr17	39182929	39196377	13448	keratin associated protein 1-4
PA38417	83895	KRTAP1-5	chr17	39179278	39193454	14176	keratin associated protein 1-5
PA134884303	386677	KRTAP10-1	chr21	45956068	45970078	14010	keratin associated protein 10-1
PA134906562	353333	KRTAP10-10	chr21	46047273	46061372	14099	keratin associated protein 10-10
PA134873081	386678	KRTAP10-11	chr21	46056331	46070567	14236	keratin associated protein 10-11
PA134977717	386685	KRTAP10-12	chr21	46107087	46120959	13872	keratin associated protein 10-12
PA134989110	386679	KRTAP10-2	chr21	45967240	45981388	14148	keratin associated protein 10-2
PA134941853	386682	KRTAP10-3	chr21	45974906	45988643	13737	keratin associated protein 10-3
PA134942730	386672	KRTAP10-4	chr21	45983606	45997987	14381	keratin associated protein 10-4
PA134950015	386680	KRTAP10-5	chr21	45996564	46010481	13917	keratin associated protein 10-5
PA134871340	386674	KRTAP10-6	chr21	46008149	46022386	14237	keratin associated protein 10-6
PA134976547	386675	KRTAP10-7	chr21	46010497	46025091	14594	keratin associated protein 10-7
PA134968895	386681	KRTAP10-8	chr21	46021996	46035871	13875	keratin associated protein 10-8
PA134991131	386676	KRTAP10-9	chr21	46037040	46051295	14255	keratin associated protein 10-9
PA134907329	337880	KRTAP11-1	chr21	32249963	32263874	13911	keratin associated protein 11-1
PA134971238	353332	KRTAP12-1	chr21	46098491	46112078	13587	keratin associated protein 12-1
PA134993440	353323	KRTAP12-2	chr21	46083106	46096844	13738	keratin associated protein 12-2
PA134986807	386683	KRTAP12-3	chr21	46067849	46081258	13409	keratin associated protein 12-3
PA134932676	386684	KRTAP12-4	chr21	46071130	46084576	13446	keratin associated protein 12-4
PA134987916	140258	KRTAP13-1	chr21	31758392	31772140	13748	keratin associated protein 13-1
PA134994193	337959	KRTAP13-2	chr21	31740709	31754557	13848	keratin associated protein 13-2
PA134901486	337960	KRTAP13-3	chr21	31794711	31808230	13519	keratin associated protein 13-3
PA134861175	284827	KRTAP13-4	chr21	31792594	31806076	13482	keratin associated protein 13-4
PA134911178	254950	KRTAP15-1	chr21	31802646	31816098	13452	keratin associated protein 15-1
PA134895884	100505753	KRTAP16-1	chr17	39460952	39475505	14553	keratin associated protein 16-1
PA38763	83902	KRTAP17-1	chr17	39468169	39481947	13778	keratin associated protein 17-1
PA134956142	337882	KRTAP19-1	chr21	31849364	31862636	13272	keratin associated protein 19-1
PA134969992	337969	KRTAP19-2	chr21	31856509	31869667	13158	keratin associated protein 19-2
PA134977711	337970	KRTAP19-3	chr21	31860782	31874275	13493	keratin associated protein 19-3
PA134984740	337971	KRTAP19-4	chr21	31866174	31879428	13254	keratin associated protein 19-4
PA134992782	337972	KRTAP19-5	chr21	31871190	31884408	13218	keratin associated protein 19-5
PA134901069	337973	KRTAP19-6	chr21	31910854	31924181	13327	keratin associated protein 19-6
PA134868084	337974	KRTAP19-7	chr21	31930417	31943608	13191	keratin associated protein 19-7
PA162393748	728299	KRTAP19-8	chr21	32407478	32420795	13317	keratin associated protein 19-8
PA38415	81872	KRTAP2-1	chr17	39199793	39213568	13775	keratin associated protein 2-1
PA38753	728279	KRTAP2-2	chr17	39207750	39221463	13713	keratin associated protein 2-2
PA38743	85294	KRTAP2-4	chr17	39218368	39232131	13763	keratin associated protein 2-4
PA134953935	337975	KRTAP20-1	chr21	31978774	31991944	13170	keratin associated protein 20-1
PA134896461	337976	KRTAP20-2	chr21	31997583	32010780	13197	keratin associated protein 20-2
PA162393749	337985	KRTAP20-3	chr21	32005183	32018455	13272	keratin associated protein 20-3
PA134897035	337977	KRTAP21-1	chr21	32124457	32137696	13239	keratin associated protein 21-1
PA134884584	337978	KRTAP21-2	chr21	32116269	32129520	13251	keratin associated protein 21-2
PA165378419	100288323	KRTAP21-3	chr21	32087843	32101095	13252	keratin associated protein 21-3
PA134897377	337979	KRTAP22-1	chr21	31963440	31976586	13146	keratin associated protein 22-1
PA165378424	100288287	KRTAP22-2	chr21	31959424	31972716	13292	keratin associated protein 22-2
PA134978709	337963	KRTAP23-1	chr21	31717717	31730924	13207	keratin associated protein 23-1
PA162393751	643803	KRTAP24-1	chr21	31650627	31665276	14649	keratin associated protein 24-1
PA162393758	100131902	KRTAP25-1	chr21	31658463	31671832	13369	keratin associated protein 25-1
PA162393763	388818	KRTAP26-1	chr21	31688449	31702607	14158	keratin associated protein 26-1
PA162393770	643812	KRTAP27-1	chr21	31706331	31720012	13681	keratin associated protein 27-1
PA38418	83896	KRTAP3-1	chr17	39161773	39175366	13593	keratin associated protein 3-1
PA38419	83897	KRTAP3-2	chr17	39152445	39166138	13693	keratin associated protein 3-2
PA38742	85293	KRTAP3-3	chr17	39146682	39160385	13703	keratin associated protein 3-3
PA38755	85285	KRTAP4-1	chr17	39337352	39351147	13795	keratin associated protein 4-1
PA38759	653240	KRTAP4-11	chr17	39270433	39284606	14173	keratin associated protein 4-11
PA38416	83755	KRTAP4-12	chr17	39276343	39290419	14076	keratin associated protein 4-12
PA38749	85291	KRTAP4-2	chr17	39330698	39344460	13762	keratin associated protein 4-2
PA38756	85290	KRTAP4-3	chr17	39320483	39334424	13941	keratin associated protein 4-3
PA38426	84616	KRTAP4-4	chr17	39312905	39326983	14078	keratin associated protein 4-4
PA38748	85289	KRTAP4-5	chr17	39302176	39316054	13878	keratin associated protein 4-5
PA38757	81871	KRTAP4-6	chr17	39292685	39306739	14054	keratin associated protein 4-6
PA38747	100132476	KRTAP4-7	chr17	39230459	39244396	13937	keratin associated protein 4-7
PA38442	728224	KRTAP4-8	chr17	39250233	39264375	14142	keratin associated protein 4-8
PA38758	100132386	KRTAP4-9	chr17	39251641	39265740	14099	keratin associated protein 4-9
PA134874098	387264	KRTAP5-1	chr11	1602572	1616513	13941	keratin associated protein 5-1
PA134898624	387273	KRTAP5-10	chr11	71266609	71280666	14057	keratin associated protein 5-10
PA134989436	440051	KRTAP5-11	chr11	71289901	71303921	14020	keratin associated protein 5-11
PA134981423	440021	KRTAP5-2	chr11	1615407	1629524	14117	keratin associated protein 5-2
PA134865306	387266	KRTAP5-3	chr11	1625795	1639693	13898	keratin associated protein 5-3
PA134916197	387267	KRTAP5-4	chr11	1639188	1653368	14180	keratin associated protein 5-4
PA134889326	439915	KRTAP5-5	chr11	1641033	1655160	14127	keratin associated protein 5-5
PA134922071	440023	KRTAP5-6	chr11	1708425	1721985	13560	keratin associated protein 5-6
PA134880610	440050	KRTAP5-7	chr11	71228313	71242210	13897	keratin associated protein 5-7
PA134954599	57830	KRTAP5-8	chr11	71239071	71253253	14182	keratin associated protein 5-8
PA134946701	3846	KRTAP5-9	chr11	71249466	71263653	14187	keratin associated protein 5-9
PA134988301	337966	KRTAP6-1	chr21	31983005	31996223	13218	keratin associated protein 6-1
PA134980095	337967	KRTAP6-2	chr21	31968005	31981193	13188	keratin associated protein 6-2
PA134866119	337968	KRTAP6-3	chr21	31954759	31968374	13615	keratin associated protein 6-3
PA134918132	337879	KRTAP8-1	chr21	32182015	32195570	13555	keratin associated protein 8-1
PA134939475	728318	KRTAP9-1	chr17	39336139	39349891	13752	keratin associated protein 9-1
PA38424	83899	KRTAP9-2	chr17	39372900	39386904	14004	keratin associated protein 9-2
PA38425	83900	KRTAP9-3	chr17	39378715	39392706	13991	keratin associated protein 9-3
PA38750	85280	KRTAP9-4	chr17	39395939	39409905	13966	keratin associated protein 9-4
PA38761	100507608	KRTAP9-6	chr17	39411630	39425112	13482	keratin associated protein 9-6
PA38762	100505724	KRTAP9-7	chr17	39421950	39435459	13509	keratin associated protein 9-7
PA38443	83901	KRTAP9-8	chr17	39384270	39398256	13986	keratin associated protein 9-8
PA38413	81870	KRTAP9-9	chr17	39401636	39415616	13980	keratin associated protein 9-9
PA134967679	200185	KRTCAP2	chr1	155138884	155161331	22447	keratinocyte associated protein 2
PA134974952	200634	KRTCAP3	chr2	27655233	27672348	17115	keratinocyte associated protein 3
PA30236	388533	KRTDAP	chr19	35975226	35991433	16207	keratinocyte differentiation-associated protein
PA30254	8844	KSR1	chr17	25789036	25953718	164682	kinase suppressor of ras 1
PA134914125	283455	KSR2	chr12	117887817	118416399	528582	kinase suppressor of ras 2
PA142671571	112970	KTI12	chr1	52494777	52509472	14695	KTI12 homolog, chromatin associated (S. cerevisiae)
PA30256	3895	KTN1	chr14	56036925	56154302	117377	kinectin 1 (kinesin receptor)
PA147358357	79036	KXD1	chr19	18658572	18683197	24625	KxDL motif containing 1
PA134878738	339855	KY	chr3	134315765	134380522	64757	kyphoscoliosis peptidase
PA30258	8942	KYNU	chr2	143496497	143802885	306388	kynureninase
PA30259	3897	L1CAM	chrX	153123969	153161628	37659	L1 cell adhesion molecule
PA145008170	54596	L1TD1	chr1	62650474	62681000	30526	LINE-1 type transposase domain containing 1
PA134971279	79944	L2HGDH	chr14	50701285	50788947	87662	L-2-hydroxyglutarate dehydrogenase
PA134961537	112849	L3HYPDH	chr14	59922698	59961281	38583	L-3-hydroxyproline dehydratase (trans-)
PA30260	26013	L3MBTL1	chr20	42126320	42182590	56270	l(3)mbt-like 1 (Drosophila)
PA38356	83746	L3MBTL2	chr22	41591312	41630276	38964	l(3)mbt-like 2 (Drosophila)
PA134943930	84456	L3MBTL3	chr6	130329728	130465594	135866	l(3)mbt-like 3 (Drosophila)
PA134935795	91133	L3MBTL4	chr18	5951705	6424910	473205	l(3)mbt-like 4 (Drosophila)
PA147358522	144811	LACC1	chr13	44443420	44471068	27648	laccase (multicopper oxidoreductase) domain containing 1
PA38404	246269	LACE1	chr6	108606098	108849751	243653	lactation elevated 1
PA30261	90070	LACRT	chr12	55021623	55038663	17040	lacritin
PA30262	114294	LACTB	chr15	63403999	63437260	33261	lactamase, beta
PA134952605	51110	LACTB2	chr8	71546501	71591447	44946	lactamase, beta 2
PA165751480	646262	LACTBL1	chr1	23276537	23299672	23135	lactamase, beta-like 1
PA30263	3898	LAD1	chr1	201346966	201378669	31703	ladinin 1
PA30265	3902	LAG3	chr12	6871670	6890621	18951	lymphocyte-activation gene 3
PA128394540	8270	LAGE3	chrX	153702241	153717596	15355	L antigen family, member 3
PA30266	3903	LAIR1	chr19	54862235	54892241	30006	leukocyte-associated immunoglobulin-like receptor 1
PA30267	3904	LAIR2	chr19	55004013	55024900	20887	leukocyte-associated immunoglobulin-like receptor 2
PA30269	3906	LALBA	chr12	48958467	48973829	15362	lactalbumin, alpha-
PA30270	284217	LAMA1	chr18	6938743	7127813	189070	laminin, alpha 1
PA30271	3908	LAMA2	chr6	129194286	129840711	646425	laminin, alpha 2
PA30272	3909	LAMA3	chr18	21259562	21538030	278468	laminin, alpha 3
PA30273	3910	LAMA4	chr6	112426134	112585924	159790	laminin, alpha 4
PA30274	3911	LAMA5	chr20	60881116	60952368	71252	laminin, alpha 5
PA30275	3912	LAMB1	chr7	107561244	107653804	92560	laminin, beta 1
PA164741827	3913	LAMB2	chr3	49155547	49180599	25052	laminin, beta 2 (laminin S)
PA30278	3914	LAMB3	chr1	209785215	209835820	50605	laminin, beta 3
PA30279	22798	LAMB4	chr7	107660996	107780801	119805	laminin, beta 4
PA30280	3915	LAMC1	chr1	182982572	183117727	135155	laminin, gamma 1 (formerly LAMB2)
PA30281	3918	LAMC2	chr1	183137952	183217262	79310	laminin, gamma 2
PA30282	10319	LAMC3	chr9	133874504	133971446	96942	laminin, gamma 3
PA30283	3916	LAMP1	chr13	113941436	113980746	39310	lysosomal-associated membrane protein 1
PA30285	3920	LAMP2	chrX	119557003	119613204	56201	lysosomal-associated membrane protein 2
PA30286	27074	LAMP3	chr3	182837003	182890667	53664	lysosomal-associated membrane protein 3
PA25643	24141	LAMP5	chr20	9485005	9514171	29166	lysosomal-associated membrane protein family, member 5
PA143485354	55004	LAMTOR1	chr11	71802371	71824433	22062	late endosomal/lysosomal adaptor, MAPK and MTOR activator 1
PA164725527	28956	LAMTOR2	chr1	156014517	156031301	16784	late endosomal/lysosomal adaptor, MAPK and MTOR activator 2
PA164722189	8649	LAMTOR3	chr4	100796495	100825703	29208	late endosomal/lysosomal adaptor, MAPK and MTOR activator 3
PA162380687	389541	LAMTOR4	chr7	99736530	99754833	18303	late endosomal/lysosomal adaptor, MAPK and MTOR activator 4
PA29211	10542	LAMTOR5	chr1	110940875	110960546	19671	late endosomal/lysosomal adaptor, MAPK and MTOR activator 5
PA30293	10314	LANCL1	chr2	211292973	211352347	59374	LanC lantibiotic synthetase component C-like 1 (bacterial)
PA30294	55915	LANCL2	chr7	55423141	55504435	81294	LanC lantibiotic synthetase component C-like 2 (bacterial)
PA134879796	347404	LANCL3	chrX	37420822	37539750	118928	LanC lantibiotic synthetase component C-like 3 (bacterial)
PA38537	51056	LAP3	chr4	17568927	17612590	43663	leucine aminopeptidase 3
PA30295	9741	LAPTM4A	chr2	20229411	20261789	32378	lysosomal protein transmembrane 4 alpha
PA128395785	55353	LAPTM4B	chr8	98777809	98867830	90021	lysosomal protein transmembrane 4 beta
PA134953439	7805	LAPTM5	chr1	31202315	31240683	38368	lysosomal protein transmembrane 5
PA30296	9215	LARGE	chr22	33665509	34326464	660955	like-glycosyltransferase
PA142671564	23367	LARP1	chr5	154052224	154200167	147943	La ribonucleoprotein domain family, member 1
PA165664174	55132	LARP1B	chr4	128972421	129147086	174665	La ribonucleoprotein domain family, member 1B
PA142671566	113251	LARP4	chr12	50784592	50876788	92196	La ribonucleoprotein domain family, member 4
PA165548762	23185	LARP4B	chr10	849854	987645	137791	La ribonucleoprotein domain family, member 4B
PA142671568	55323	LARP6	chr15	71120889	71156498	35609	La ribonucleoprotein domain family, member 6
PA145148525	51574	LARP7	chr4	113548120	113581748	33628	La ribonucleoprotein domain family, member 7
PA30297	51520	LARS	chr5	145489589	145572294	82705	leucyl-tRNA synthetase
PA134982982	23395	LARS2	chr3	45420053	45593334	173281	leucyl-tRNA synthetase 2, mitochondrial
PA128394732	81887	LAS1L	chrX	64729462	64764686	35224	LAS1-like (S. cerevisiae)
PA30298	3927	LASP1	chr17	37016112	37081023	64911	LIM and SH3 protein 1
PA38728	27040	LAT	chr16	28986147	29005104	18957	linker for activation of T cells
PA37356	7462	LAT2	chr7	73614087	73647164	33077	linker for activation of T cells family, member 2
PA30301	9113	LATS1	chr6	149976289	150049392	73103	large tumor suppressor kinase 1
PA30302	26524	LATS2	chr13	21544175	21645722	101547	large tumor suppressor kinase 2
PA142671569	54900	LAX1	chr1	203724284	203748500	24216	lymphocyte transmembrane adaptor 1
PA142671570	143903	LAYN	chr11	111401233	111435470	34237	layilin
PA162393798	81606	LBH	chr2	30444397	30485899	41502	limb bud and heart development
PA142672293	79081	LBHD1	chr11	62427289	62449241	21952	LBH domain containing 1
PA30303	3929	LBP	chr20	36964814	37008653	43839	lipopolysaccharide binding protein
PA30304	3930	LBR	chr1	225586204	225626557	40353	lamin B receptor
PA142671561	10660	LBX1	chr10	102983733	102999954	16221	ladybird homeobox 1
PA30305	85474	LBX2	chr2	74721644	74740443	18799	ladybird homeobox 2
PA142671563	167691	LCA5	chr6	80191708	80257147	65439	Leber congenital amaurosis 5
PA162393809	150082	LCA5L	chr21	40774770	40827676	52906	Leber congenital amaurosis 5-like
PA226	3931	LCAT	chr16	67970787	67988656	17869	lecithin-cholesterol acyltransferase
PA134885053	353131	LCE1A	chr1	152789949	152803573	13624	late cornified envelope 1A
PA38171	353132	LCE1B	chr1	152774447	152788585	14138	late cornified envelope 1B
PA134895875	353133	LCE1C	chr1	152774311	152789107	14796	late cornified envelope 1C
PA134906518	353134	LCE1D	chr1	152759227	152773657	14430	late cornified envelope 1D
PA134866413	353135	LCE1E	chr1	152748753	152763902	15149	late cornified envelope 1E
PA134962947	353137	LCE1F	chr1	152738848	152752445	13597	late cornified envelope 1F
PA134911274	353139	LCE2A	chr1	152660840	152674918	14078	late cornified envelope 2A
PA38170	26239	LCE2B	chr1	152648599	152662877	14278	late cornified envelope 2B
PA134903160	353140	LCE2C	chr1	152637791	152652050	14259	late cornified envelope 2C
PA38157	353141	LCE2D	chr1	152625887	152640135	14248	late cornified envelope 2D
PA134880553	353142	LCE3A	chr1	152592310	152605579	13269	late cornified envelope 3A
PA134946555	353143	LCE3B	chr1	152576287	152589574	13287	late cornified envelope 3B
PA38407	353144	LCE3C	chr1	152563138	152576562	13424	late cornified envelope 3C
PA38174	84648	LCE3D	chr1	152548860	152562980	14120	late cornified envelope 3D
PA134941153	353145	LCE3E	chr1	152535175	152549229	14054	late cornified envelope 3E
PA38172	199834	LCE4A	chr1	152671523	152684910	13387	late cornified envelope 4A
PA38173	254910	LCE5A	chr1	152473320	152487653	14333	late cornified envelope 5A
PA162393834	448835	LCE6A	chr1	152805330	152819459	14129	late cornified envelope 6A
PA30307	3932	LCK	chr1	32706840	32754766	47926	LCK proto-oncogene, Src family tyrosine kinase
PA164722072	253558	LCLAT1	chr2	30660102	30870091	209989	lysocardiolipin acyltransferase 1
PA134928443	51451	LCMT1	chr16	25113047	25192551	79504	leucine carboxyl methyltransferase 1
PA134878443	9836	LCMT2	chr15	43616974	43632820	15846	leucine carboxyl methyltransferase 2
PA30308	3933	LCN1	chr9	138403284	138421386	18102	lipocalin 1
PA134942375	414332	LCN10	chr9	139629619	139647411	17792	lipocalin 10
PA134959347	286256	LCN12	chr9	139834032	139852957	18925	lipocalin 12
PA164722091	389812	LCN15	chr9	139651086	139668965	17879	lipocalin 15
PA30309	3934	LCN2	chr9	130901732	130918734	17002	lipocalin 2
PA30310	158062	LCN6	chr9	139635469	139652980	17511	lipocalin 6
PA134958919	138307	LCN8	chr9	139645838	139662995	17157	lipocalin 8
PA134879860	392399	LCN9	chr9	138545168	138565577	20409	lipocalin 9
PA164722092	401562	LCNL1	chr9	139867445	139883210	15765	lipocalin-like 1
PA145148487	84458	LCOR	chr10	98582017	98727198	145181	ligand dependent nuclear receptor corepressor
PA145148507	254251	LCORL	chr4	17841839	18033483	191644	ligand dependent nuclear receptor corepressor-like
PA30312	3936	LCP1	chr13	46697058	46766459	69401	lymphocyte cytosolic protein 1 (L-plastin)
PA30313	3937	LCP2	chr5	169672088	169734822	62734	lymphocyte cytosolic protein 2 (SH2 domain containing leukocyte protein of 76kDa)
PA30315	3938	LCT	chr2	136542415	136604750	62335	lactase
PA142671560	197021	LCTL	chr15	66836806	66868317	31511	lactase-like
PA30316	8861	LDB1	chr10	103863315	103890210	26895	LIM domain binding 1
PA30317	9079	LDB2	chr4	16500164	16910424	410260	LIM domain binding 2
PA30318	11155	LDB3	chr10	88416542	88498829	82287	LIM domain binding 3
PA30319	3939	LDHA	chr11	18405936	18432765	26829	lactate dehydrogenase A
PA134950539	160287	LDHAL6A	chr11	18467374	18504814	37440	lactate dehydrogenase A-like 6A
PA134943157	92483	LDHAL6B	chr15	59489015	59503787	14772	lactate dehydrogenase A-like 6B
PA30325	3945	LDHB	chr12	21785275	21820789	35514	lactate dehydrogenase B
PA30328	3948	LDHC	chr11	18423851	18475798	51947	lactate dehydrogenase C
PA134917525	197257	LDHD	chr16	75142758	75160670	17912	lactate dehydrogenase D
PA227	3949	LDLR	chr19	11190037	11247506	57469	low density lipoprotein receptor
PA142671554	388633	LDLRAD1	chr1	54469971	54493859	23888	low density lipoprotein receptor class A domain containing 1
PA142671555	401944	LDLRAD2	chr1	22128758	22154714	25956	low density lipoprotein receptor class A domain containing 2
PA142671556	143458	LDLRAD3	chr11	35955537	36256688	301151	low density lipoprotein receptor class A domain containing 3
PA25593	753	LDLRAD4	chr18	13208729	13655753	447024	low density lipoprotein receptor class A domain containing 4
PA128394641	26119	LDLRAP1	chr1	25860071	25898377	38306	low density lipoprotein receptor adaptor protein 1
PA30329	23641	LDOC1	chrX	140266930	140281310	14380	leucine zipper, down-regulated in cancer 1
PA134971270	84247	LDOC1L	chr22	44885450	44904005	18555	leucine zipper, down-regulated in cancer 1-like
PA162393840	116842	LEAP2	chr5	132199358	132213582	14224	liver expressed antimicrobial peptide 2
PA134897668	11061	LECT1	chr13	53274399	53323947	49548	leukocyte cell derived chemotaxin 1
PA30330	3950	LECT2	chr5	135279600	135300723	21123	leukocyte cell-derived chemotaxin 2
PA30331	51176	LEF1	chr4	108965701	109100112	134411	lymphoid enhancer-binding factor 1
PA30332	10637	LEFTY1	chr1	226070982	226086846	15864	left-right determination factor 1
PA27580	7044	LEFTY2	chr1	226121298	226139083	17785	left-right determination factor 2
PA162393851	389170	LEKR1	chr3	156533069	156766918	233849	leucine, glutamate and lysine rich 1
PA142671557	149018	LELP1	chr1	153165906	153180601	14695	late cornified envelope-like proline-rich 1
PA38660	93273	LEMD1	chr1	205347506	205401214	53708	LEM domain containing 1
PA134952135	221496	LEMD2	chr6	33735990	33766906	30916	LEM domain containing 2
PA134907442	23592	LEMD3	chr12	65553351	65645141	91790	LEM domain containing 3
PA30333	55891	LENEP	chr1	154956062	154969791	13729	lens epithelial protein
PA134904804	79165	LENG1	chr19	54656377	54673446	17069	leukocyte receptor cluster (LRC) member 1
PA134903953	114823	LENG8	chr19	54949605	54976196	26591	leukocyte receptor cluster (LRC) member 8
PA134975056	94059	LENG9	chr19	54969976	54984894	14918	leukocyte receptor cluster (LRC) member 9
PA142671558	123169	LEO1	chr15	52227222	52273995	46773	Leo1, Paf1/RNA polymerase II complex component, homolog (S. cerevisiae)
PA228	3952	LEP	chr7	127871241	127900682	29441	leptin
PA229	3953	LEPR	chr1	65876335	66106176	229841	leptin receptor
PA134930599	64175	LEPRE1	chr1	43209006	43242755	33749	leucine proline-enriched proteoglycan (leprecan) 1
PA134922807	55214	LEPREL1	chr3	189671517	189850226	178709	leprecan-like 1
PA134890414	10536	LEPREL2	chr12	6927572	6952018	24446	leprecan-like 2
PA134913422	54741	LEPROT	chr1	65876131	66110242	234111	leptin receptor overlapping transcript
PA30334	23484	LEPROTL1	chr8	29942922	29998222	55300	leptin receptor overlapping transcript-like 1
PA30335	3954	LETM1	chr4	1810206	1867974	57768	leucine zipper-EF-hand containing transmembrane protein 1
PA134887111	137994	LETM2	chr8	38230041	38270045	40004	leucine zipper-EF-hand containing transmembrane protein 2
PA134914870	25875	LETMD1	chr12	51432082	51457207	25125	LETM1 domain containing 1
PA162393884	342900	LEUTX	chr19	40257234	40279775	22541	leucine twenty homeobox
PA30336	3955	LFNG	chr7	2542163	2571811	29648	LFNG O-fucosylpeptide 3-beta-N-acetylglucosaminyltransferase
PA30337	3956	LGALS1	chr22	38061613	38078809	17196	lectin, galactoside-binding, soluble, 1
PA30338	85329	LGALS12	chr11	63263524	63287246	23722	lectin, galactoside-binding, soluble, 12
PA134923011	29124	LGALS13	chr19	40083169	40101114	17945	lectin, galactoside-binding, soluble, 13
PA134882378	56891	LGALS14	chr19	40184946	40203088	18142	lectin, galactoside-binding, soluble, 14
PA164741896	3957	LGALS2	chr22	37963253	37986024	22771	lectin, galactoside-binding, soluble, 2
PA30340	3958	LGALS3	chr14	55585935	55615148	29213	lectin, galactoside-binding, soluble, 3
PA30341	3959	LGALS3BP	chr17	76964335	76986061	21726	lectin, galactoside-binding, soluble, 3 binding protein
PA30342	3960	LGALS4	chr19	39289311	39313740	24429	lectin, galactoside-binding, soluble, 4
PA30345	3963	LGALS7	chr19	39258608	39274157	15549	lectin, galactoside-binding, soluble, 7
PA162393892	653499	LGALS7B	chr19	39269850	39285394	15544	lectin, galactoside-binding, soluble, 7B
PA30346	3964	LGALS8	chr1	236671514	236719281	47767	lectin, galactoside-binding, soluble, 8
PA30347	3965	LGALS9	chr17	25948174	25979586	31412	lectin, galactoside-binding, soluble, 9
PA162393903	284194	LGALS9B	chr17	20349708	20380848	31140	lectin, galactoside-binding, soluble, 9B
PA162393930	654346	LGALS9C	chr17	18370099	18401259	31160	lectin, galactoside-binding, soluble, 9C
PA30349	9211	LGI1	chr10	95507566	95560916	53350	leucine-rich, glioma inactivated 1
PA38654	55203	LGI2	chr4	24997471	25042414	44943	leucine-rich repeat LGI family, member 2
PA38655	203190	LGI3	chr8	22001343	22024344	23001	leucine-rich repeat LGI family, member 3
PA38656	163175	LGI4	chr19	35612417	35636178	23761	leucine-rich repeat LGI family, member 4
PA30354	5641	LGMN	chr14	93167152	93225047	57895	legumain
PA28893	55366	LGR4	chr11	27384508	27504338	119830	leucine-rich repeat containing G protein-coupled receptor 4
PA28894	8549	LGR5	chr12	71822931	71983090	160159	leucine-rich repeat containing G protein-coupled receptor 5
PA134927114	59352	LGR6	chr1	202153118	202291889	138771	leucine-rich repeat containing G protein-coupled receptor 6
PA164722103	51557	LGSN	chr6	63982856	64039882	57026	lengsin, lens protein with glutamine synthetase domain
PA30356	3972	LHB	chr19	49516237	49530350	14113	luteinizing hormone beta polypeptide
PA30357	3973	LHCGR	chr2	48910913	48992880	81967	luteinizing hormone/choriogonadotropin receptor
PA30358	10186	LHFP	chr13	39914029	40187356	273327	lipoma HMGIC fusion partner
PA30359	340596	LHFPL1	chrX	111870879	111933375	62496	lipoma HMGIC fusion partner-like 1
PA30360	10184	LHFPL2	chr5	77778038	77954648	176610	lipoma HMGIC fusion partner-like 2
PA30361	375612	LHFPL3	chr7	103959104	104552005	592901	lipoma HMGIC fusion partner-like 3
PA164741909	375323	LHFPL4	chr3	9537045	9605486	68441	lipoma HMGIC fusion partner-like 4
PA134943389	222662	LHFPL5	chr6	35763071	35794852	31781	lipoma HMGIC fusion partner-like 5
PA165548763	64077	LHPP	chr10	126140341	126305710	165369	phospholysine phosphohistidine inorganic pyrophosphate phosphatase
PA30364	3975	LHX1	chr17	35284772	35304915	20143	LIM homeobox 1
PA30365	9355	LHX2	chr9	126763889	126798572	34683	LIM homeobox 2
PA30366	8022	LHX3	chr9	139085096	139106955	21859	LIM homeobox 3
PA134962876	89884	LHX4	chr1	180189433	180247188	57755	LIM homeobox 4
PA30367	64211	LHX5	chr12	113897694	113919877	22183	LIM homeobox 5
PA134949308	26468	LHX6	chr9	124961856	125001166	39310	LIM homeobox 6
PA142671553	431707	LHX8	chr1	75584119	75630218	46099	LIM homeobox 8
PA30368	56956	LHX9	chr1	197871635	197907606	35971	LIM homeobox 9
PA30369	11019	LIAS	chr4	39450644	39482273	31629	lipoic acid synthetase
PA30370	3976	LIF	chr22	30633436	30652840	19404	leukemia inhibitory factor
PA30371	3977	LIFR	chr5	38472065	38605507	133442	leukemia inhibitory factor receptor alpha
PA30372	3978	LIG1	chr19	48615702	48683852	68150	ligase I, DNA, ATP-dependent
PA30374	3980	LIG3	chr17	33297517	33335088	37571	ligase III, DNA, ATP-dependent
PA30375	3981	LIG4	chr13	108856790	108880716	23926	ligase IV, DNA, ATP-dependent
PA30376	11024	LILRA1	chr19	55095041	55116846	21805	leukocyte immunoglobulin-like receptor, subfamily A (with TM domain), member 1
PA30377	11027	LILRA2	chr19	55074469	55102027	27558	leukocyte immunoglobulin-like receptor, subfamily A (with TM domain), member 2
PA30378	11026	LILRA3	chr19	54796854	54814625	17771	leukocyte immunoglobulin-like receptor, subfamily A (without TM domain), member 3
PA142671546	23547	LILRA4	chr19	54841473	54860421	18948	leukocyte immunoglobulin-like receptor, subfamily A (with TM domain), member 4
PA142671547	353514	LILRA5	chr19	54815353	54834409	19056	leukocyte immunoglobulin-like receptor, subfamily A (with TM domain), member 5
PA142671548	79168	LILRA6	chr19	54737469	54756724	19255	leukocyte immunoglobulin-like receptor, subfamily A (with TM domain), member 6
PA30379	10859	LILRB1	chr19	55118384	55152007	33623	leukocyte immunoglobulin-like receptor, subfamily B (with TM and ITIM domains), member 1
PA30380	10288	LILRB2	chr19	54774675	54795033	20358	leukocyte immunoglobulin-like receptor, subfamily B (with TM and ITIM domains), member 2
PA30381	11025	LILRB3	chr19	54717147	54736997	19850	leukocyte immunoglobulin-like receptor, subfamily B (with TM and ITIM domains), member 3
PA30382	11006	LILRB4	chr19	55164271	55184810	20539	leukocyte immunoglobulin-like receptor, subfamily B (with TM and ITIM domains), member 4
PA30383	10990	LILRB5	chr19	54751270	54771167	19897	leukocyte immunoglobulin-like receptor, subfamily B (with TM and ITIM domains), member 5
PA30384	3982	LIM2	chr19	51880163	51901210	21047	lens intrinsic membrane protein 2, 19kDa
PA143485527	51474	LIMA1	chr12	50566563	50687353	120790	LIM domain and actin binding 1
PA162393957	22998	LIMCH1	chr4	41352802	41705061	352259	LIM and calponin homology domains 1
PA30385	8994	LIMD1	chr3	45626323	45725755	99432	LIM domains containing 1
PA143485528	80774	LIMD2	chr17	61770249	61788527	18278	LIM domain containing 2
PA142671551	54923	LIME1	chr20	62357480	62373460	15980	Lck interacting transmembrane adaptor 1
PA30386	3984	LIMK1	chr7	73488107	73539855	51748	LIM domain kinase 1
PA30387	3985	LIMK2	chr22	31598225	31679066	80841	LIM domain kinase 2
PA30389	3987	LIMS1	chr2	109140811	109306702	165891	LIM and senescent cell antigen-like domains 1
PA30390	55679	LIMS2	chr2	128392996	128449360	56364	LIM and senescent cell antigen-like domains 2
PA134917873	96626	LIMS3	chr2	110646009	110686202	40193	LIM and senescent cell antigen-like domains 3
PA165751523	79727	LIN28A	chr1	26727269	26759219	31950	lin-28 homolog A (C. elegans)
PA142671543	389421	LIN28B	chr6	105374874	105534207	159333	lin-28 homolog B (C. elegans)
PA162394016	55957	LIN37	chr19	36229262	36248420	19158	lin-37 DREAM MuvB core complex component
PA162394039	91750	LIN52	chr14	74541656	74670117	128461	lin-52 DREAM MuvB core complex component
PA162394056	132660	LIN54	chr4	83842756	83944097	101341	lin-54 DREAM MuvB core complex component
PA134881936	8825	LIN7A	chr12	81188171	81341702	153531	lin-7 homolog A (C. elegans)
PA134914453	64130	LIN7B	chr19	49607618	49624717	17099	lin-7 homolog B (C. elegans)
PA134891786	55327	LIN7C	chr11	27512965	27538326	25361	lin-7 homolog C (C. elegans)
PA134970771	286826	LIN9	chr1	226415850	226507789	91939	lin-9 DREAM MuvB core complex component
PA165392421	284739	LINC00176	chr20	62655697	62674315	18618	long intergenic non-protein coding RNA 176
PA25957	83655	LINC00208	chr8	11424044	11441850	17806	long intergenic non-protein coding RNA 208
PA165479209	440184	LINC00238	chr14	66943109	66968271	25162	long intergenic non-protein coding RNA 238
PA165752123	388719	LINC00272	chr1	182366756	182386948	20192	long intergenic non-protein coding RNA 272
PA165479205	283673	LINC00277	chr15	69355266	69391225	35959	long intergenic non-protein coding RNA 277
PA142672238	284185	LINC00482	chr17	79273624	79293048	19424	long intergenic non-protein coding RNA 482
PA142672388	23434	LINC01565	chr3	128287843	128304929	17086	long intergenic non-protein coding RNA 1565
PA162394087	84894	LINGO1	chr15	77902369	77998490	96121	leucine rich repeat and Ig domain containing 1
PA162394096	158038	LINGO2	chr9	27945084	29222998	1277914	leucine rich repeat and Ig domain containing 2
PA162394097	645191	LINGO3	chr19	2286774	2318156	31382	leucine rich repeat and Ig domain containing 3
PA162394098	339398	LINGO4	chr1	151769765	151787882	18117	leucine rich repeat and Ig domain containing 4
PA142671544	55180	LINS	chr15	101106428	101152445	46017	lines homolog (Drosophila)
PA30391	3988	LIPA	chr10	90970326	91021660	51334	lipase A, lysosomal acid, cholesterol esterase
PA230	3990	LIPC	chr15	58692953	58864073	171120	lipase, hepatic
PA30393	3991	LIPE	chr19	42902664	42941578	38914	lipase, hormone-sensitive
PA30394	8513	LIPF	chr10	90414146	90441572	27426	lipase, gastric
PA30395	9388	LIPG	chr18	47077069	47122278	45209	lipase, endothelial
PA134934352	200879	LIPH	chr3	185222570	185280369	57799	lipase, member H
PA38695	149998	LIPI	chr21	15477784	15593361	115577	lipase, member I
PA162394099	142910	LIPJ	chr10	90336519	90369733	33214	lipase, family member J
PA162394100	643414	LIPK	chr10	90474301	90515513	41212	lipase, family member K
PA162394101	340654	LIPM	chr10	90552487	90583315	30828	lipase, family member M
PA162394123	643418	LIPN	chr10	90509786	90541648	31862	lipase, family member N
PA134940073	51601	LIPT1	chr2	99761418	99782620	21202	lipoyltransferase 1
PA165543447	387787	LIPT2	chr11	74199923	74214755	14832	lipoyl(octanoyl) transferase 2 (putative)
PA134879224	9516	LITAF	chr16	11638578	11691322	52744	lipopolysaccharide-induced TNF factor
PA38353	167410	LIX1	chr5	96424574	96488520	63946	Lix1 homolog (chicken)
PA134915428	128077	LIX1L	chr1	145467059	145504670	37611	Lix1 homolog (chicken) like
PA162378956	198437	LKAAEAR1	chr20	62711733	62725712	13979	LKAAEAR motif containing 1
PA30396	3996	LLGL1	chr17	18118907	18151189	32282	lethal giant larvae homolog 1 (Drosophila)
PA30397	3993	LLGL2	chr17	73511783	73574290	62507	lethal giant larvae homolog 2 (Drosophila)
PA164722116	84298	LLPH	chr12	66513849	66534533	20684	LLP homolog, long-term synaptic facilitation (Aplysia)
PA30399	3998	LMAN1	chr18	56992055	57036508	44453	lectin, mannose-binding, 1
PA30400	79748	LMAN1L	chr15	75095194	75121099	25905	lectin, mannose-binding, 1 like
PA25919	10960	LMAN2	chr5	176755563	176788885	33322	lectin, mannose-binding 2
PA134937652	81562	LMAN2L	chr2	97368666	97415813	47147	lectin, mannose-binding 2-like
PA25945	64327	LMBR1	chr7	156467537	156695902	228365	limb development membrane protein 1
PA142671545	55716	LMBR1L	chr12	49487334	49514683	27349	limb development membrane protein 1-like
PA134948847	55788	LMBRD1	chr6	70382641	70517049	134408	LMBR1 domain containing 1
PA142671541	92255	LMBRD2	chr5	36100414	36162015	61601	LMBR1 domain containing 2
PA30401	29995	LMCD1	chr3	8533493	8612811	79318	LIM and cysteine-rich domains 1
PA25540	64788	LMF1	chr16	900634	1041318	140684	lipase maturation factor 1
PA162394144	91289	LMF2	chr22	50938376	50956148	17772	lipase maturation factor 2
PA30402	89782	LMLN	chr3	197677071	197773591	96520	leishmanolysin-like (metallopeptidase M8 family)
PA231	4000	LMNA	chr1	156042369	156112880	70511	lamin A/C
PA30403	4001	LMNB1	chr5	126102315	126175712	73397	lamin B1
PA30404	84823	LMNB2	chr19	2425163	2466966	41803	lamin B2
PA162391895	160492	LMNTD1	chr12	25626016	25811488	185472	lamin tail domain containing 1
PA142672302	256329	LMNTD2	chr11	551850	570779	18929	lamin tail domain containing 2
PA30407	4004	LMO1	chr11	8242851	8300182	57331	LIM domain only 1 (rhombotin 1)
PA30408	4005	LMO2	chr11	33877122	33923836	46714	LIM domain only 2 (rhombotin-like 1)
PA30409	55885	LMO3	chr12	16698306	16771148	72842	LIM domain only 3 (rhombotin-like 2)
PA30410	8543	LMO4	chr1	87784151	87817606	33455	LIM domain only 4
PA30412	4008	LMO7	chr13	76184570	76437006	252436	LIM domain 7
PA30413	25802	LMOD1	chr1	201862584	201925716	63132	leiomodin 1 (smooth muscle)
PA30414	442721	LMOD2	chr7	123285861	123307147	21286	leiomodin 2 (cardiac)
PA30415	56203	LMOD3	chr3	69153039	69181746	28707	leiomodin 3 (fetal)
PA134884391	22853	LMTK2	chr7	97726197	97841945	115748	lemur tyrosine kinase 2
PA134951789	114783	LMTK3	chr19	48985528	49026446	40918	lemur tyrosine kinase 3
PA30416	4009	LMX1A	chr1	165168104	165335952	167848	LIM homeobox transcription factor 1, alpha
PA30417	4010	LMX1B	chr9	129366722	129466311	99589	LIM homeobox transcription factor 1, beta
PA142671542	348801	LNP1	chr3	100110037	100178170	68133	leukemia NUP98 fusion partner 1
PA30418	4012	LNPEP	chr5	96261346	96368115	106769	leucyl/cystinyl aminopeptidase
PA30419	84708	LNX1	chr4	54323437	54528653	205216	ligand of numb-protein X 1, E3 ubiquitin protein ligase
PA134899015	222484	LNX2	chr13	28117048	28204720	87672	ligand of numb-protein X 2
PA30421	118426	LOH12CR1	chr12	12499967	12640587	140620	loss of heterozygosity, 12, chromosomal region 1
PA162394145	9361	LONP1	chr19	5688845	5730463	41618	lon peptidase 1, mitochondrial
PA162394186	83752	LONP2	chr16	48268211	48390888	122677	lon peptidase 2, peroxisomal
PA128394743	91694	LONRF1	chr8	12576406	12622992	46586	LON peptidase N-terminal domain and ring finger 1
PA142671540	164832	LONRF2	chr2	100886753	100949195	62442	LON peptidase N-terminal domain and ring finger 2
PA134900980	79836	LONRF3	chrX	118098577	118155816	57239	LON peptidase N-terminal domain and ring finger 3
PA30426	4014	LOR	chr1	153222179	153237600	15421	loricrin
PA30427	4015	LOX	chr5	121395890	121424206	28316	lysyl oxidase
PA134878065	125336	LOXHD1	chr18	44053935	44246996	193061	lipoxygenase homology domains 1
PA30428	4016	LOXL1	chr15	74208789	74247478	38689	lysyl oxidase-like 1
PA30429	4017	LOXL2	chr8	23151410	23271722	120312	lysyl oxidase-like 2
PA30430	84695	LOXL3	chr2	74756946	74791088	34142	lysyl oxidase-like 3
PA30431	84171	LOXL4	chr10	100004443	100038007	33564	lysyl oxidase-like 4
PA30432	4018	LPA	chr6	160949506	161107478	157972	lipoprotein, Lp(a)
PA162394187	1902	LPAR1	chr9	113632542	113811523	178981	lysophosphatidic acid receptor 1
PA162394202	9170	LPAR2	chr19	19731464	19749039	17575	lysophosphatidic acid receptor 2
PA162394213	23566	LPAR3	chr1	85276086	85368896	92810	lysophosphatidic acid receptor 3
PA162394222	2846	LPAR4	chrX	77993206	78017211	24005	lysophosphatidic acid receptor 4
PA28935	57121	LPAR5	chr12	6725001	6755297	30296	lysophosphatidic acid receptor 5
PA165505129	10161	LPAR6	chr13	48982181	49028840	46659	lysophosphatidic acid receptor 6
PA162394232	79888	LPCAT1	chr5	1458542	1535644	77102	lysophosphatidylcholine acyltransferase 1
PA162394265	54947	LPCAT2	chr16	55532913	55623582	90669	lysophosphatidylcholine acyltransferase 2
PA162394266	10162	LPCAT3	chr12	7082347	7135842	53495	lysophosphatidylcholine acyltransferase 3
PA162394297	254531	LPCAT4	chr15	34648089	34669397	21308	lysophosphatidylcholine acyltransferase 4
PA134869091	9926	LPGAT1	chr1	211913799	212058531	144732	lysophosphatidylglycerol acyltransferase 1
PA134868822	22859	LPHN1	chr19	14255549	14326997	71448	latrophilin 1
PA38589	23266	LPHN2	chr1	82256082	82461107	205025	latrophilin 2
PA134968284	23284	LPHN3	chr4	62056949	62941168	884219	latrophilin 3
PA30436	23175	LPIN1	chr2	11807705	11970535	162830	lipin 1
PA30437	9663	LPIN2	chr18	2913992	3023313	109321	lipin 2
PA30438	64900	LPIN3	chr20	39959495	39992222	32727	lipin 3
PA232	4023	LPL	chr8	19786582	19827770	41188	lipoprotein lipase
PA30439	4025	LPO	chr17	56305787	56348879	43092	lactoperoxidase
PA30440	4026	LPP	chr3	187861097	188611460	750363	LIM domain containing preferred translocation partner in lipoma
PA30441	9404	LPXN	chr11	58291344	58355688	64344	leupaxin
PA30443	9227	LRAT	chr4	155655163	155677270	22107	lecithin retinol acyltransferase (phosphatidylcholine--retinol O-acyltransferase)
PA30444	987	LRBA	chr4	151182811	151946879	764068	LPS-responsive vesicle trafficking, beach and anchor containing
PA134898200	23143	LRCH1	chr13	47117296	47330176	212880	leucine-rich repeats and calponin homology (CH) domain containing 1
PA134890613	57631	LRCH2	chrX	114342179	114478635	136456	leucine-rich repeats and calponin homology (CH) domain containing 2
PA134923024	84859	LRCH3	chr3	197508112	197618307	110195	leucine-rich repeats and calponin homology (CH) domain containing 3
PA30467	4034	LRCH4	chr7	100168634	100193806	25172	leucine-rich repeats and calponin homology (CH) domain containing 4
PA134871732	57622	LRFN1	chr19	39794457	39816740	22283	leucine rich repeat and fibronectin type III domain containing 1
PA134913285	57497	LRFN2	chr6	40356373	40565126	208753	leucine rich repeat and fibronectin type III domain containing 2
PA134880779	79414	LRFN3	chr19	36418022	36439097	21075	leucine rich repeat and fibronectin type III domain containing 3
PA134922153	78999	LRFN4	chr11	66614558	66630946	16388	leucine rich repeat and fibronectin type III domain containing 4
PA134888453	145581	LRFN5	chr14	42066764	42376752	309988	leucine rich repeat and fibronectin type III domain containing 5
PA134919634	116844	LRG1	chr19	4534227	4550036	15809	leucine-rich alpha-2-glycoprotein 1
PA162394330	136332	LRGUK	chr7	133802105	133951933	149828	leucine-rich repeats and guanylate kinase domain containing
PA142672487	55791	LRIF1	chr1	111486812	111516825	30013	ligand dependent nuclear receptor interacting factor 1
PA38450	26018	LRIG1	chr3	66426221	66561446	135225	leucine-rich repeats and immunoglobulin-like domains 1
PA134905053	9860	LRIG2	chr1	113605792	113670824	65032	leucine-rich repeats and immunoglobulin-like domains 2
PA134864136	121227	LRIG3	chr12	59262937	59324319	61382	leucine-rich repeats and immunoglobulin-like domains 3
PA162394331	26103	LRIT1	chr10	85988276	86011217	22941	leucine-rich repeat, immunoglobulin-like and transmembrane domains 1
PA162394344	340745	LRIT2	chr10	85977241	85995339	18098	leucine-rich repeat, immunoglobulin-like and transmembrane domains 2
PA162394355	345193	LRIT3	chr4	110759340	110796471	37131	leucine-rich repeat, immunoglobulin-like and transmembrane domains 3
PA30450	4033	LRMP	chr12	25195181	25264269	69088	lymphoid-restricted membrane protein
PA233	4035	LRP1	chr12	57512282	57610142	97860	low density lipoprotein receptor-related protein 1
PA38383	26020	LRP10	chr14	23330822	23353789	22967	low density lipoprotein receptor-related protein 10
PA134880462	84918	LRP11	chr6	150136894	150196398	59504	low density lipoprotein receptor-related protein 11
PA134921850	29967	LRP12	chr8	105498459	105611252	112793	low density lipoprotein receptor-related protein 12
PA30451	53353	LRP1B	chr2	140985996	142899270	1913274	low density lipoprotein receptor-related protein 1B
PA30452	4036	LRP2	chr2	169980619	170229123	248504	low density lipoprotein receptor-related protein 2
PA142671538	55805	LRP2BP	chr4	186282032	186328297	46265	LRP2 binding protein
PA30453	4037	LRP3	chr19	33675599	33702773	27174	low density lipoprotein receptor-related protein 3
PA30454	4038	LRP4	chr11	46875268	46950173	74905	low density lipoprotein receptor-related protein 4
PA30455	4041	LRP5	chr11	68070077	68219743	149666	low density lipoprotein receptor-related protein 5
PA142671533	91355	LRP5L	chr22	25744218	25811337	67119	low density lipoprotein receptor-related protein 5-like
PA30456	4040	LRP6	chr12	12265959	12429811	163852	low density lipoprotein receptor-related protein 6
PA30457	7804	LRP8	chr1	53705036	53803821	98785	low density lipoprotein receptor-related protein 8, apolipoprotein e receptor
PA30458	4043	LRPAP1	chr4	3502324	3544224	41900	low density lipoprotein receptor-related protein associated protein 1
PA30459	10128	LRPPRC	chr2	44110363	44233144	122781	leucine-rich pentatricopeptide repeat containing
PA134915321	122769	LRR1	chr14	50055383	50084390	29007	leucine rich repeat protein 1
PA30460	55227	LRRC1	chr6	53649295	53792490	143195	leucine rich repeat containing 1
PA134896853	376132	LRRC10	chr12	69999344	70014942	15598	leucine rich repeat containing 10
PA165543456	390205	LRRC10B	chr11	61266272	61281490	15218	leucine rich repeat containing 10B
PA134914089	9684	LRRC14	chr8	145733349	145753562	20213	leucine rich repeat containing 14
PA165660376	389257	LRRC14B	chr5	181626	198468	16842	leucine rich repeat containing 14B
PA134956867	131578	LRRC15	chr3	194072976	194100472	27496	leucine rich repeat containing 15
PA162394368	55604	LRRC16A	chr6	25269656	25623758	354102	leucine rich repeat containing 16A
PA162394445	90668	LRRC16B	chr14	24511206	24541937	30731	leucine rich repeat containing 16B
PA134866295	10234	LRRC17	chr7	102543344	102588558	45214	leucine rich repeat containing 17
PA134898691	474354	LRRC18	chr10	50114528	50157980	43452	leucine rich repeat containing 18
PA134892454	64922	LRRC19	chr9	26990134	27015691	25557	leucine rich repeat containing 19
PA30461	79442	LRRC2	chr3	46553875	46631589	77714	leucine rich repeat containing 2
PA30488	83598	LRRC2-AS1	chr3	46588888	46604178	15290	LRRC2 antisense RNA 1
PA134935389	55222	LRRC20	chr10	72055726	72152406	96680	leucine rich repeat containing 20
PA143485529	10233	LRRC23	chr12	7003897	7026406	22509	leucine rich repeat containing 23
PA142671520	441381	LRRC24	chr8	145744761	145762416	17655	leucine rich repeat containing 24
PA134957834	126364	LRRC25	chr19	18498947	18518428	19481	leucine rich repeat containing 25
PA134952867	389816	LRRC26	chr9	140060210	140074491	14281	leucine rich repeat containing 26
PA134904045	80313	LRRC27	chr10	134135614	134198010	62396	leucine rich repeat containing 27
PA134864287	123355	LRRC28	chr15	99781567	99933934	152367	leucine rich repeat containing 28
PA28029	26231	LRRC29	chr16	67238042	67270901	32859	leucine rich repeat containing 29
PA30462	81543	LRRC3	chr21	45865393	45881739	16346	leucine rich repeat containing 3
PA134945901	339291	LRRC30	chr18	7221137	7235042	13905	leucine rich repeat containing 30
PA134985943	79782	LRRC31	chr3	169554029	169597723	43694	leucine rich repeat containing 31
PA28574	2615	LRRC32	chr11	76365568	76391990	26422	leucine rich repeat containing 32
PA142671522	151827	LRRC34	chr3	169508216	169540574	32358	leucine rich repeat containing 34
PA142671524	55282	LRRC36	chr16	67350747	67422109	71362	leucine rich repeat containing 36
PA128395758	9884	LRRC37A	chr17	44306744	44418160	111416	leucine rich repeat containing 37A
PA162394530	474170	LRRC37A2	chr17	44577323	44636016	58693	leucine rich repeat containing 37, member A2
PA162394563	374819	LRRC37A3	chr17	62847486	62924903	77417	leucine rich repeat containing 37, member A3
PA142671525	114659	LRRC37B	chr17	30338155	30383519	45364	leucine rich repeat containing 37B
PA142671526	126755	LRRC38	chr1	13798445	13850242	51797	leucine rich repeat containing 38
PA142671527	127495	LRRC39	chr1	100611004	100653829	42825	leucine rich repeat containing 39
PA134962068	116135	LRRC3B	chr3	26654300	26755267	100967	leucine rich repeat containing 3B
PA30463	64101	LRRC4	chr7	127664124	127681002	16878	leucine rich repeat containing 4
PA142671528	55631	LRRC40	chr1	70607485	70681361	73876	leucine rich repeat containing 40
PA142671529	10489	LRRC41	chr1	46741072	46779038	37966	leucine rich repeat containing 41
PA142671530	115353	LRRC42	chr1	54401999	54436841	34842	leucine rich repeat containing 42
PA142671531	254050	LRRC43	chr12	122642266	122691018	48752	leucine rich repeat containing 43
PA142671505	201255	LRRC45	chr17	79971280	79992027	20747	leucine rich repeat containing 45
PA142671506	90506	LRRC46	chr17	45898993	45918079	19086	leucine rich repeat containing 46
PA142671507	57470	LRRC47	chr1	3693784	3723068	29284	leucine rich repeat containing 47
PA142671508	83450	LRRC48	chr17	17866127	17923203	57076	leucine rich repeat containing 48
PA142671509	54839	LRRC49	chr15	71135578	71345436	209858	leucine rich repeat containing 49
PA134890612	94030	LRRC4B	chr19	51017149	51081302	64153	leucine rich repeat containing 4B
PA142671534	57689	LRRC4C	chr11	40132524	41491186	1358662	leucine rich repeat containing 4C
PA142671512	440699	LRRC52	chr1	165503478	165536185	32707	leucine rich repeat containing 52
PA142671514	219527	LRRC55	chr11	56939221	56962188	22967	leucine rich repeat containing 55
PA142671515	115399	LRRC56	chr11	526722	557916	31194	leucine rich repeat containing 56
PA142671516	255252	LRRC57	chr15	42831720	42851002	19282	leucine rich repeat containing 57
PA142671517	116064	LRRC58	chr3	120040576	120078186	37610	leucine rich repeat containing 58
PA142671518	55379	LRRC59	chr17	48455594	48484914	29320	leucine rich repeat containing 59
PA134921522	23639	LRRC6	chr8	133581201	133697863	116662	leucine rich repeat containing 6
PA143485530	65999	LRRC61	chr7	150010296	150038245	27949	leucine rich repeat containing 61
PA162394565	220416	LRRC63	chr13	46776083	46861181	85098	leucine rich repeat containing 63
PA162394587	339977	LRRC66	chr4	52856806	52896477	39671	leucine rich repeat containing 66
PA162394619	100130742	LRRC69	chr8	92104847	92234473	129626	leucine rich repeat containing 69
PA134879588	57554	LRRC7	chr1	70023230	70592171	568941	leucine rich repeat containing 7
PA164722127	100130733	LRRC70	chr5	61864562	61880275	15713	leucine rich repeat containing 70
PA142672476	149499	LRRC71	chr1	156880400	156905881	25481	leucine rich repeat containing 71
PA134973511	221424	LRRC73	chr6	43471703	43488081	16378	leucine rich repeat containing 73
PA134862662	145497	LRRC74A	chr14	77282725	77339645	56920	leucine rich repeat containing 74A
PA143485400	388341	LRRC75A	chr17	16342328	16405480	63152	leucine rich repeat containing 75A
PA162378982	388886	LRRC75B	chr22	24978591	24999035	20444	leucine rich repeat containing 75B
PA134909315	56262	LRRC8A	chr9	131634391	131683318	48927	leucine rich repeat containing 8 family, member A
PA142671535	23507	LRRC8B	chr1	89979933	90066420	86487	leucine rich repeat containing 8 family, member B
PA142671536	84230	LRRC8C	chr1	90088644	90188094	99450	leucine rich repeat containing 8 family, member C
PA30464	55144	LRRC8D	chr1	90276573	90404991	128418	leucine rich repeat containing 8 family, member D
PA142671537	80131	LRRC8E	chr19	7943390	7969908	26518	leucine rich repeat containing 8 family, member E
PA142671519	85444	LRRCC1	chr8	86009323	86061315	51992	leucine rich repeat and coiled-coil centrosomal protein 1
PA30465	9208	LRRFIP1	chr2	238526224	238693290	167066	leucine rich repeat (in FLII) interacting protein 1
PA30466	9209	LRRFIP2	chr3	37091117	37227992	136875	leucine rich repeat (in FLII) interacting protein 2
PA134962087	84125	LRRIQ1	chr12	85420099	85661235	241136	leucine-rich repeats and IQ motif containing 1
PA162394627	127255	LRRIQ3	chr1	74488699	74673871	185172	leucine-rich repeats and IQ motif containing 3
PA162394647	344657	LRRIQ4	chr3	169520658	169558561	37903	leucine-rich repeats and IQ motif containing 4
PA134892363	79705	LRRK1	chr15	101449460	101613317	163857	leucine-rich repeat kinase 1
PA134968052	120892	LRRK2	chr12	40608813	40766087	157274	leucine-rich repeat kinase 2
PA134935557	57633	LRRN1	chr3	3831121	3892708	61587	leucine rich repeat neuronal 1
PA162394661	10446	LRRN2	chr1	204583298	204664597	81299	leucine rich repeat neuronal 2
PA30468	54674	LRRN3	chr7	110721062	110768510	47448	leucine rich repeat neuronal 3
PA162394670	164312	LRRN4	chr20	6018192	6044726	26534	leucine rich repeat neuronal 4
PA162394685	221091	LRRN4CL	chr11	62450874	62467371	16497	LRRN4 C-terminal like
PA134887293	347730	LRRTM1	chr2	80512481	80541718	29237	leucine rich repeat transmembrane neuronal 1
PA134993038	26045	LRRTM2	chr5	138202079	138221057	18978	leucine rich repeat transmembrane neuronal 2
PA134962991	347731	LRRTM3	chr10	68675792	68864309	188517	leucine rich repeat transmembrane neuronal 3
PA134972631	80059	LRRTM4	chr2	76971849	77759502	787653	leucine rich repeat transmembrane neuronal 4
PA134890010	90678	LRSAM1	chr9	130203765	130268780	65015	leucine rich repeat and sterile alpha motif containing 1
PA142671499	57408	LRTM1	chr3	54949264	55011115	61851	leucine-rich repeats and transmembrane domains 1
PA142671500	654429	LRTM2	chr12	1919433	1948919	29486	leucine-rich repeats and transmembrane domains 2
PA164722133	220074	LRTOMT	chr11	71781377	71824828	43451	leucine rich transmembrane and O-methyltransferase domain containing
PA162394694	222229	LRWD1	chr7	102095335	102116615	21280	leucine-rich repeats and WD repeat domain containing 1
PA30470	4045	LSAMP	chr3	115518210	116174385	656175	limbic system-associated membrane protein
PA142671501	55341	LSG1	chr3	194358517	194403206	44689	large 60S subunit nuclear export GTPase 1
PA134864226	27257	LSM1	chr8	38017839	38044248	26409	LSM1, U6 small nuclear RNA associated
PA134977215	84967	LSM10	chr1	36856031	36873493	17462	LSM10, U7 small nuclear RNA associated
PA134983181	134353	LSM11	chr5	157160755	157186746	25991	LSM11, U7 small nuclear RNA associated
PA142671502	124801	LSM12	chr17	42109003	42154987	45984	LSM12 homolog (S. cerevisiae)
PA134989467	26065	LSM14A	chr19	34653352	34723420	70068	LSM14A, SCD6 homolog A (S. cerevisiae)
PA25754	149986	LSM14B	chr20	60687517	60713434	25917	LSM14B, SCD6 homolog B (S. cerevisiae)
PA25929	57819	LSM2	chr6	31762169	31784761	22592	LSM2 homolog, U6 small nuclear RNA associated (S. cerevisiae)
PA134881991	27258	LSM3	chr3	14210228	14242869	32641	LSM3 homolog, U6 small nuclear RNA associated (S. cerevisiae)
PA134906569	25804	LSM4	chr19	18414040	18444001	29961	LSM4 homolog, U6 small nuclear RNA associated (S. cerevisiae)
PA134881171	23658	LSM5	chr7	32521945	32544870	22925	LSM5 homolog, U6 small nuclear RNA associated (S. cerevisiae)
PA128394584	11157	LSM6	chr4	147086835	147114213	27378	LSM6 homolog, U6 small nuclear RNA associated (S. cerevisiae)
PA134888612	51690	LSM7	chr19	2318520	2338614	20094	LSM7 homolog, U6 small nuclear RNA associated (S. cerevisiae)
PA165618166	51691	LSM8	chr7	117814086	117847093	33007	LSM8 homolog, U6 small nuclear RNA associated (S. cerevisiae)
PA162380593	286006	LSMEM1	chr7	112110908	112133943	23035	leucine-rich single-pass membrane protein 1
PA143485322	132228	LSMEM2	chr3	50306458	50328545	22087	leucine-rich single-pass membrane protein 2
PA30472	4046	LSP1	chr11	1864200	1916493	52293	lymphocyte-specific protein 1
PA142671504	51599	LSR	chr19	35729290	35761867	32577	lipolysis stimulated lipoprotein receptor
PA30473	4047	LSS	chr21	47605360	47658738	53378	lanosterol synthase (2,3-oxidosqualene-lanosterol cyclase)
PA37856	7940	LST1	chr6	31543956	31559686	15730	leukocyte specific transcript 1
PA30474	4049	LTA	chr6	31529876	31545101	15225	lymphotoxin alpha
PA24345	4048	LTA4H	chr12	96391531	96447298	55767	leukotriene A4 hydrolase
PA30475	4050	LTB	chr6	31545335	31560202	14867	lymphotoxin beta (TNF superfamily, member 3)
PA30476	1241	LTB4R	chr14	24770705	24790242	19537	leukotriene B4 receptor
PA134910672	56413	LTB4R2	chr14	24769357	24784259	14902	leukotriene B4 receptor 2
PA30477	4052	LTBP1	chr2	33162221	33627576	465355	latent transforming growth factor beta binding protein 1
PA164741922	4053	LTBP2	chr14	74961886	75089034	127148	latent transforming growth factor beta binding protein 2
PA30479	4054	LTBP3	chr11	65303030	65335858	32828	latent transforming growth factor beta binding protein 3
PA30480	8425	LTBP4	chr19	41089072	41138725	49653	latent transforming growth factor beta binding protein 4
PA30481	4055	LTBR	chr12	6474534	6503737	29203	lymphotoxin beta receptor (TNFR superfamily, member 3)
PA235	4056	LTC4S	chr5	179209263	179226616	17353	leukotriene C4 synthase
PA30482	4057	LTF	chr3	46474496	46516598	42102	lactotransferrin
PA30483	4058	LTK	chr15	41792840	41816085	23245	leukocyte receptor tyrosine kinase
PA37658	26046	LTN1	chr21	30297466	30375277	77811	listerin E3 ubiquitin protein ligase 1
PA134893631	84946	LTV1	chr6	144154508	144187943	33435	LTV1 ribosome biogenesis factor
PA30485	55692	LUC7L	chr16	235970	289449	53479	LUC7-like (S. cerevisiae)
PA134873425	51631	LUC7L2	chr7	139015105	139111203	96098	LUC7-like 2 (S. cerevisiae)
PA165432062	51747	LUC7L3	chr17	48786926	48833072	46146	LUC7-like 3 (S. cerevisiae)
PA30486	4060	LUM	chr12	91494232	91515542	21310	lumican
PA142672401	541468	LURAP1	chr1	46659006	46689928	30922	leucine rich adaptor protein 1
PA134938789	286343	LURAP1L	chr9	12764989	12826059	61070	leucine rich adaptor protein 1-like
PA30487	7798	LUZP1	chr1	23407516	23514301	106785	leucine zipper protein 1
PA134956714	338645	LUZP2	chr11	24508516	25107186	598670	leucine zipper protein 2
PA134920076	51213	LUZP4	chrX	114514292	114545121	30829	leucine zipper protein 4
PA134991999	56925	LXN	chr3	158381203	158400482	19279	latexin
PA134928593	8581	LY6D	chr8	143863298	143878008	14710	lymphocyte antigen 6 complex, locus D
PA30491	4061	LY6E	chr8	144089902	144106827	16925	lymphocyte antigen 6 complex, locus E
PA37826	58496	LY6G5B	chr6	31628728	31643227	14499	lymphocyte antigen 6 complex, locus G5B
PA37827	80741	LY6G5C	chr6	31641461	31658150	16689	lymphocyte antigen 6 complex, locus G5C
PA37830	80740	LY6G6C	chr6	31683425	31699511	16086	lymphocyte antigen 6 complex, locus G6C
PA37829	58530	LY6G6D	chr6	31673048	31688698	15650	lymphocyte antigen 6 complex, locus G6D
PA38371	259215	LY6G6F	chr6	31664625	31681372	16747	lymphocyte antigen 6 complex, locus G6F
PA30492	4062	LY6H	chr8	144236331	144252053	15722	lymphocyte antigen 6 complex, locus H
PA134987940	54742	LY6K	chr8	143771529	143788588	17059	lymphocyte antigen 6 complex, locus K
PA30493	4065	LY75	chr2	160656866	160771267	114401	lymphocyte antigen 75
PA128394549	9450	LY86	chr6	6578934	6658216	79282	lymphocyte antigen 86
PA30494	4063	LY9	chr1	160755864	160801045	45181	lymphocyte antigen 9
PA134924906	23643	LY96	chr8	74893564	74944314	50750	lymphocyte antigen 96
PA162394697	55646	LYAR	chr4	4266428	4301896	35468	Ly1 antibody reactive
PA162394698	129530	LYG1	chr2	99897701	99931205	33504	lysozyme G-like 1
PA162394717	254773	LYG2	chr2	99855709	99881570	25861	lysozyme G-like 2
PA30497	4066	LYL1	chr19	13205002	13223974	18972	lymphoblastic leukemia associated hematopoiesis regulator 1
PA30498	4067	LYN	chr8	56782386	56928006	145620	LYN proto-oncogene, Src family tyrosine kinase
PA134874147	66004	LYNX1	chr8	143842756	143869640	26884	Ly6/neurotoxin 1
PA134862471	116372	LYPD1	chr2	133399337	133439070	39733	LY6/PLAUR domain containing 1
PA134911921	137797	LYPD2	chr8	143828628	143843952	15324	LY6/PLAUR domain containing 2
PA142671490	27076	LYPD3	chr19	43961946	43979831	17885	LY6/PLAUR domain containing 3
PA142671491	147719	LYPD4	chr19	42336356	42358774	22418	LY6/PLAUR domain containing 4
PA142671492	284348	LYPD5	chr19	44297079	44334808	37729	LY6/PLAUR domain containing 5
PA147357619	130574	LYPD6	chr2	150176499	150333662	157163	LY6/PLAUR domain containing 6
PA162394734	130576	LYPD6B	chr2	149884981	150074776	189795	LY6/PLAUR domain containing 6B
PA30499	10434	LYPLA1	chr8	54955927	55024577	68650	lysophospholipase I
PA30500	11313	LYPLA2	chr1	24107275	24125029	17754	lysophospholipase II
PA134986975	127018	LYPLAL1	chr1	219337192	219389207	52015	lysophospholipase-like 1
PA162394735	57149	LYRM1	chr16	20901204	20939328	38124	LYR motif containing 1
PA162394751	57226	LYRM2	chr6	90338943	90358474	19531	LYR motif containing 2
PA162394762	57128	LYRM4	chr6	5044395	5271172	226777	LYR motif containing 4
PA162394773	144363	LYRM5	chr12	25338150	25360949	22799	LYR motif containing 5
PA162394784	90624	LYRM7	chr5	130496641	130544119	47478	LYR motif containing 7
PA165431642	201229	LYRM9	chr17	26202340	26230409	28069	LYR motif containing 9
PA142671493	388695	LYSMD1	chr1	151129224	151148424	19200	LysM, putative peptidoglycan-binding, domain containing 1
PA142671494	256586	LYSMD2	chr15	52012261	52053650	41389	LysM, putative peptidoglycan-binding, domain containing 2
PA142671495	116068	LYSMD3	chr5	89808443	89835401	26958	LysM, putative peptidoglycan-binding, domain containing 3
PA142671496	145748	LYSMD4	chr15	100264610	100283766	19156	LysM, putative peptidoglycan-binding, domain containing 4
PA26500	1130	LYST	chr1	235821331	236057008	235677	lysosomal trafficking regulator
PA162394799	10894	LYVE1	chr11	10575712	10600365	24653	lymphatic vessel endothelial hyaluronan receptor 1
PA30503	4069	LYZ	chr12	69732134	69751013	18879	lysozyme
PA134868520	84569	LYZL1	chr10	29567980	29610158	42178	lysozyme-like 1
PA134920379	119180	LYZL2	chr10	30897708	30928647	30939	lysozyme-like 2
PA134911368	131375	LYZL4	chr3	42435575	42462125	26550	lysozyme-like 4
PA134942111	57151	LYZL6	chr17	34258522	34280714	22192	lysozyme-like 6
PA30504	84328	LZIC	chr1	9979168	10013460	34292	leucine zipper and CTNNBIP1 domain containing
PA30505	54585	LZTFL1	chr3	45861808	45967216	105408	leucine zipper transcription factor-like 1
PA30506	8216	LZTR1	chr22	21326558	21356326	29768	leucine-zipper-like transcription regulator 1
PA30507	11178	LZTS1	chr8	20100676	20171492	70816	leucine zipper, putative tumor suppressor 1
PA134944540	84445	LZTS2	chr10	102746864	102770593	23729	leucine zipper, putative tumor suppressor 2
PA162379401	130951	M1AP	chr2	74782010	74885994	103984	meiosis 1 associated protein
PA30513	4074	M6PR	chr12	9089957	9112357	22400	mannose-6-phosphate receptor (cation dependent)
PA134904689	89876	MAATS1	chr3	119411869	119488949	77080	MYCBP-associated, testis expressed 1
PA30516	4081	MAB21L1	chr13	36044926	36062786	17860	mab-21-like 1 (C. elegans)
PA30517	10586	MAB21L2	chr4	151493077	151508845	15768	mab-21-like 2 (C. elegans)
PA142672412	126868	MAB21L3	chr1	116644376	116680861	36485	mab-21-like 3 (C. elegans)
PA164722150	346389	MACC1	chr7	20171278	20267013	95735	metastasis associated in colon cancer 1
PA30518	23499	MACF1	chr1	39539839	39955810	415971	microtubule-actin crosslinking factor 1
PA162394816	28992	MACROD1	chr11	63763006	63943602	180596	MACRO domain containing 1
PA162394843	140733	MACROD2	chr20	13966146	16036842	2070696	MACRO domain containing 2
PA372	8379	MAD1L1	chr7	1852428	2282583	430155	MAD1 mitotic arrest deficient-like 1 (yeast)
PA30521	4085	MAD2L1	chr4	120977577	120998013	20436	MAD2 mitotic arrest deficient-like 1 (yeast)
PA134911020	9587	MAD2L1BP	chr6	43587279	43611689	24410	MAD2L1 binding protein
PA398	10459	MAD2L2	chr1	11731537	11761678	30141	MAD2 mitotic arrest deficient-like 2 (yeast)
PA30522	8174	MADCAM1	chr19	486487	508343	21856	mucosal vascular addressin cell adhesion molecule 1
PA30523	8567	MADD	chr11	47280927	47354582	73655	MAP-kinase activating death domain
PA30533	10296	MAEA	chr4	1273642	1336925	63283	macrophage erythroblast attacher
PA142671488	84944	MAEL	chr1	166948394	166994451	46057	maelstrom spermatogenic transposon silencer
PA30534	4094	MAF	chr16	79624745	79644622	19877	v-maf avian musculoaponeurotic fibrosarcoma oncogene homolog
PA142671489	84232	MAF1	chr8	145149305	145165515	16210	MAF1 homolog (S. cerevisiae)
PA134963361	389692	MAFA	chr8	144507230	144522602	15372	v-maf avian musculoaponeurotic fibrosarcoma oncogene homolog A
PA30535	9935	MAFB	chr20	39311488	39327880	16392	v-maf avian musculoaponeurotic fibrosarcoma oncogene homolog B
PA30538	23764	MAFF	chr22	38587939	38615518	27579	v-maf avian musculoaponeurotic fibrosarcoma oncogene homolog F
PA30539	4097	MAFG	chr17	79873145	79895587	22442	v-maf avian musculoaponeurotic fibrosarcoma oncogene homolog G
PA30540	7975	MAFK	chr7	1560368	1585679	25311	v-maf avian musculoaponeurotic fibrosarcoma oncogene homolog K
PA30541	4099	MAG	chr19	35772989	35807710	34721	myelin associated glycoprotein
PA30542	4100	MAGEA1	chrX	152478522	152496116	17594	melanoma antigen family A, 1 (directs expression of antigen MZ2-E)
PA30543	4109	MAGEA10	chrX	151298782	151317050	18268	melanoma antigen family A, 10
PA30544	4110	MAGEA11	chrX	148759903	148801928	42025	melanoma antigen family A, 11
PA30545	4111	MAGEA12	chrX	151896293	151913184	16891	melanoma antigen family A, 12
PA30546	4101	MAGEA2	chrX	151915387	151932408	17021	melanoma antigen family A, 2
PA134906398	266740	MAGEA2B	chrX	151875384	151890080	14696	melanoma antigen family A, 2B
PA30547	4102	MAGEA3	chrX	151931652	151948250	16598	melanoma antigen family A, 3
PA30548	4103	MAGEA4	chrX	151070972	151096642	25670	melanoma antigen family A, 4
PA30549	4104	MAGEA5	chrX	151279521	151296411	16890	melanoma antigen family A, 5
PA30550	4105	MAGEA6	chrX	151857245	151873814	16569	melanoma antigen family A, 6
PA30552	4107	MAGEA8	chrX	148999941	149017609	17668	melanoma antigen family A, 8
PA30553	4108	MAGEA9	chrX	148853584	148872399	18815	melanoma antigen family A, 9
PA145148473	728269	MAGEA9B	chrX	148660309	148679125	18816	melanoma antigen family A, 9B
PA30554	4112	MAGEB1	chrX	30251848	30273155	21307	melanoma antigen family B, 1
PA134952121	139422	MAGEB10	chrX	27816107	27844131	28024	melanoma antigen family B, 10
PA134922508	139604	MAGEB16	chrX	35806459	35824852	18393	melanoma antigen family B, 16
PA134872991	645864	MAGEB17	chrX	16175604	16192516	16912	melanoma antigen family B, 17
PA142671483	286514	MAGEB18	chrX	26146460	26161853	15393	melanoma antigen family B, 18
PA30555	4113	MAGEB2	chrX	30223675	30241206	17531	melanoma antigen family B, 2
PA30556	4114	MAGEB3	chrX	30238553	30258612	20059	melanoma antigen family B, 3
PA30557	4115	MAGEB4	chrX	30250057	30265310	15253	melanoma antigen family B, 4
PA134913823	347541	MAGEB5	chrX	26224286	26239387	15101	melanoma antigen family B, 5
PA134864191	158809	MAGEB6	chrX	26200557	26216763	16206	melanoma antigen family B, 6
PA30558	9947	MAGEC1	chrX	140981642	141000187	18545	melanoma antigen family C, 1
PA134954317	51438	MAGEC2	chrX	141287128	141303076	15948	melanoma antigen family C, 2
PA134916199	139081	MAGEC3	chrX	140916102	140988618	72516	melanoma antigen family C, 3
PA30559	9500	MAGED1	chrX	51536155	51648450	112295	melanoma antigen family D, 1
PA30560	10916	MAGED2	chrX	54824131	54845445	21314	melanoma antigen family D, 2
PA134957670	728239	MAGED4	chrX	51917919	51938364	20445	melanoma antigen family D, 4
PA145148472	81557	MAGED4B	chrX	51801923	51822368	20445	melanoma antigen family D, 4B
PA164741999	57692	MAGEE1	chrX	75638046	75654746	16700	melanoma antigen family E, 1
PA134923697	139599	MAGEE2	chrX	74999823	75015079	15256	melanoma antigen family E, 2
PA134920978	64110	MAGEF1	chr3	184425155	184439836	14681	melanoma antigen family F, 1
PA128394650	28986	MAGEH1	chrX	55468538	55482999	14461	melanoma antigen family H, 1
PA30562	54551	MAGEL2	chr15	23885696	23902993	17297	MAGE-like 2
PA164742006	9223	MAGI1	chr3	65336200	66034511	698311	membrane associated guanylate kinase, WW and PDZ domain containing 1
PA142671484	9863	MAGI2	chr7	77643374	79093121	1449747	membrane associated guanylate kinase, WW and PDZ domain containing 2
PA142671485	260425	MAGI3	chr1	113923087	114231545	308458	membrane associated guanylate kinase, WW and PDZ domain containing 3
PA162394882	79917	MAGIX	chrX	49009181	49026836	17655	MAGI family member, X-linked
PA30563	4116	MAGOH	chr1	53689564	53714282	24718	mago-nashi homolog, proliferation-associated (Drosophila)
PA162394899	55110	MAGOHB	chr12	10753364	10776208	22844	mago-nashi homolog B (Drosophila)
PA162394900	84061	MAGT1	chrX	77078861	77161090	82229	magnesium transporter 1
PA30564	4117	MAK	chr6	10759956	10848788	88832	male germ cell-associated kinase
PA162394925	84549	MAK16	chr8	33332685	33361778	29093	MAK16 homolog (S. cerevisiae)
PA30565	4118	MAL	chr2	95681400	95722737	41337	mal, T-cell differentiation protein
PA30566	114569	MAL2	chr8	120210610	120260913	50303	mal, T-cell differentiation protein 2 (gene/pseudogene)
PA30567	7851	MALL	chr2	110838447	110884143	45696	mal, T-cell differentiation protein-like
PA134958320	340895	MALRD1	chr10	19595329	20026407	431078	MAM and LDL receptor class A domain containing 1
PA134866345	115416	MALSU1	chr7	23328940	23352180	23240	mitochondrial assembly of ribosomal large subunit 1
PA30568	10892	MALT1	chr18	56328618	56420371	91753	mucosa associated lymphoid tissue lymphoma translocation gene 1
PA134944739	256691	MAMDC2	chr9	72648435	72844899	196464	MAM domain containing 2
PA142671487	158056	MAMDC4	chr9	139736819	139758251	21432	MAM domain containing 4
PA30569	9794	MAML1	chr5	179149833	179211035	61202	mastermind-like 1 (Drosophila)
PA134946327	84441	MAML2	chr11	95708440	96086344	377904	mastermind-like 2 (Drosophila)
PA134953776	55534	MAML3	chr4	140634545	141085233	450688	mastermind-like 3 (Drosophila)
PA162394950	10046	MAMLD1	chrX	149519836	149685448	165612	mastermind-like domain containing 1
PA165393645	284358	MAMSTR	chr19	49212999	49232976	19977	MEF2 activating motif and SAP domain containing transcriptional regulator
PA30570	4121	MAN1A1	chr6	119495366	119681774	186408	mannosidase, alpha, class 1A, member 1
PA30571	10905	MAN1A2	chr1	117900085	118071320	171235	mannosidase, alpha, class 1A, member 2
PA30572	11253	MAN1B1	chr9	139971379	140006639	35260	mannosidase, alpha, class 1B, member 1
PA38788	57134	MAN1C1	chr1	25933959	26114258	180299	mannosidase, alpha, class 1C, member 1
PA30573	4124	MAN2A1	chr5	109015156	109206429	191273	mannosidase, alpha, class 2A, member 1
PA30574	4122	MAN2A2	chr15	91437420	91468815	31395	mannosidase, alpha, class 2A, member 2
PA30575	4125	MAN2B1	chr19	12754322	12787591	33269	mannosidase, alpha, class 2B, member 1
PA128394625	23324	MAN2B2	chr4	6566902	6627188	60286	mannosidase, alpha, class 2B, member 2
PA30576	4123	MAN2C1	chr15	75645133	75671455	26322	mannosidase, alpha, class 2C, member 1
PA30577	4126	MANBA	chr4	103549643	103692151	142508	mannosidase, beta A, lysosomal
PA30578	63905	MANBAL	chr20	35908051	35948663	40612	mannosidase, beta A, lysosomal-like
PA134891001	79694	MANEA	chr6	96015373	96060333	44960	mannosidase, endo-alpha
PA142671481	149175	MANEAL	chr1	38249721	38270278	20557	mannosidase, endo-alpha-like
PA24993	7873	MANF	chr3	51412692	51429828	17136	mesencephalic astrocyte-derived neurotrophic factor
PA134948173	54682	MANSC1	chr12	12479195	12513475	34280	MANSC domain containing 1
PA236	4128	MAOA	chrX	43504155	43609071	104916	monoamine oxidase A
PA237	4129	MAOB	chrX	43622857	43751721	128864	monoamine oxidase B
PA142671610	54627	MAP10	chr1	232930638	232949092	18454	microtubule-associated protein 10
PA30580	4130	MAP1A	chr15	43793165	43826818	33653	microtubule-associated protein 1A
PA30581	4131	MAP1B	chr5	71393118	71508397	115279	microtubule-associated protein 1B
PA30582	84557	MAP1LC3A	chr20	33124688	33151149	26461	microtubule-associated protein 1 light chain 3 alpha
PA134923100	81631	MAP1LC3B	chr16	87413157	87441380	28223	microtubule-associated protein 1 light chain 3 beta
PA162394969	643246	MAP1LC3B2	chr12	116987186	117017425	30239	microtubule-associated protein 1 light chain 3 beta 2
PA142671482	440738	MAP1LC3C	chr1	242155792	242174630	18838	microtubule-associated protein 1 light chain 3 gamma
PA38031	55201	MAP1S	chr19	17820303	17848324	28021	microtubule-associated protein 1S
PA30583	4133	MAP2	chr2	210278733	210601842	323109	microtubule-associated protein 2
PA30584	5604	MAP2K1	chr15	66669182	66786882	117700	mitogen-activated protein kinase kinase 1
PA30587	5605	MAP2K2	chr19	4087319	4134126	46807	mitogen-activated protein kinase kinase 2
PA30588	5606	MAP2K3	chr17	21177968	21221552	43584	mitogen-activated protein kinase kinase 3
PA30589	6416	MAP2K4	chr17	11914135	12050148	136013	mitogen-activated protein kinase kinase 4
PA30590	5607	MAP2K5	chr15	67825021	68102455	277434	mitogen-activated protein kinase kinase 5
PA30591	5608	MAP2K6	chr17	67400838	67541470	140632	mitogen-activated protein kinase kinase 6
PA284	5609	MAP2K7	chr19	7958665	7982363	23698	mitogen-activated protein kinase kinase 7
PA30592	4214	MAP3K1	chr5	56100900	56194979	94079	mitogen-activated protein kinase kinase kinase 1, E3 ubiquitin protein ligase
PA30593	4294	MAP3K10	chr19	40687504	40724487	36983	mitogen-activated protein kinase kinase kinase 10
PA30594	4296	MAP3K11	chr11	65362226	65391720	29494	mitogen-activated protein kinase kinase kinase 11
PA30595	7786	MAP3K12	chr12	53870456	53903444	32988	mitogen-activated protein kinase kinase kinase 12
PA30596	9175	MAP3K13	chr3	184990729	185209882	219153	mitogen-activated protein kinase kinase kinase 13
PA30597	9020	MAP3K14	chr17	43337488	43404414	66926	mitogen-activated protein kinase kinase kinase 14
PA134935369	389840	MAP3K15	chrX	19375174	19543379	168205	mitogen-activated protein kinase kinase kinase 15
PA142670554	80122	MAP3K19	chr2	135719076	135792301	73225	mitogen-activated protein kinase kinase kinase 19
PA30598	10746	MAP3K2	chr2	128053245	128110805	57560	mitogen-activated protein kinase kinase kinase 2
PA30599	4215	MAP3K3	chr17	61689404	61776670	87266	mitogen-activated protein kinase kinase kinase 3
PA30600	4216	MAP3K4	chr6	161402816	161541417	138601	mitogen-activated protein kinase kinase kinase 4
PA30601	4217	MAP3K5	chr6	136875184	137123656	248472	mitogen-activated protein kinase kinase kinase 5
PA30602	9064	MAP3K6	chr1	27678670	27703558	24888	mitogen-activated protein kinase kinase kinase 6
PA30603	6885	MAP3K7	chr6	91220292	91307020	86728	mitogen-activated protein kinase kinase kinase 7
PA25864	56911	MAP3K7CL	chr21	30439659	30551210	111551	MAP3K7 C-terminal like
PA30606	1326	MAP3K8	chr10	30712950	30753762	40812	mitogen-activated protein kinase kinase kinase 8
PA30607	4293	MAP3K9	chr14	71186243	71285912	99669	mitogen-activated protein kinase kinase kinase 9
PA30608	4134	MAP4	chr3	47889180	48140769	251589	microtubule-associated protein 4
PA30609	11184	MAP4K1	chr19	39075281	39118643	43362	mitogen-activated protein kinase kinase kinase kinase 1
PA30610	5871	MAP4K2	chr11	64553609	64580720	27111	mitogen-activated protein kinase kinase kinase kinase 2
PA30611	8491	MAP4K3	chr2	39473407	39674453	201046	mitogen-activated protein kinase kinase kinase kinase 3
PA30612	9448	MAP4K4	chr2	102304165	102514152	209987	mitogen-activated protein kinase kinase kinase kinase 4
PA30613	11183	MAP4K5	chr14	50882211	51009376	127165	mitogen-activated protein kinase kinase kinase kinase 5
PA30614	4135	MAP6	chr11	75294959	75389479	94520	microtubule-associated protein 6
PA142671480	79929	MAP6D1	chr3	183530664	183553393	22729	MAP6 domain containing 1
PA30615	9053	MAP7	chr6	136660419	136881957	221538	microtubule-associated protein 7
PA162394970	55700	MAP7D1	chr1	36611751	36649450	37699	MAP7 domain containing 1
PA162394971	256714	MAP7D2	chrX	20021831	20145114	123283	MAP7 domain containing 2
PA162394972	79649	MAP7D3	chrX	135292379	135348641	56262	MAP7 domain containing 3
PA145148442	79884	MAP9	chr4	156260810	156308122	47312	microtubule-associated protein 9
PA30616	5594	MAPK1	chr22	22110946	22231970	121024	mitogen-activated protein kinase 1
PA30617	5602	MAPK10	chr4	86930452	87384283	453831	mitogen-activated protein kinase 10
PA30618	5600	MAPK11	chr22	50699142	50718779	19637	mitogen-activated protein kinase 11
PA30619	6300	MAPK12	chr22	50688331	50710248	21917	mitogen-activated protein kinase 12
PA30620	5603	MAPK13	chr6	36088261	36115301	27040	mitogen-activated protein kinase 13
PA30621	1432	MAPK14	chr6	35985412	36082013	96601	mitogen-activated protein kinase 14
PA142671478	225689	MAPK15	chr8	144788507	144807633	19126	mitogen-activated protein kinase 15
PA162395015	93487	MAPK1IP1L	chr14	55508362	55539912	31550	mitogen-activated protein kinase 1 interacting protein 1-like
PA30622	5595	MAPK3	chr16	30122426	30144630	22204	mitogen-activated protein kinase 3
PA30623	5596	MAPK4	chr18	48076484	48261196	184712	mitogen-activated protein kinase 4
PA30624	5597	MAPK6	chr15	52286377	52361462	75085	mitogen-activated protein kinase 6
PA30625	5598	MAPK7	chr17	19271034	19289857	18823	mitogen-activated protein kinase 7
PA283	5599	MAPK8	chr10	49504682	49650403	145721	mitogen-activated protein kinase 8
PA30626	9479	MAPK8IP1	chr11	45897047	45931016	33969	mitogen-activated protein kinase 8 interacting protein 1
PA30627	23542	MAPK8IP2	chr22	51029131	51052979	23848	mitogen-activated protein kinase 8 interacting protein 2
PA30628	23162	MAPK8IP3	chr16	1746184	1823318	77134	mitogen-activated protein kinase 8 interacting protein 3
PA30630	5601	MAPK9	chr5	179657594	179729071	71477	mitogen-activated protein kinase 9
PA38674	79109	MAPKAP1	chr9	128196673	128479513	282840	mitogen-activated protein kinase associated protein 1
PA30631	9261	MAPKAPK2	chr1	206848295	206910630	62335	mitogen-activated protein kinase-activated protein kinase 2
PA30632	7867	MAPKAPK3	chr3	50639293	50689728	50435	mitogen-activated protein kinase-activated protein kinase 3
PA30633	8550	MAPKAPK5	chr12	112270032	112334228	64196	mitogen-activated protein kinase-activated protein kinase 5
PA142671479	23005	MAPKBP1	chr15	42056632	42123053	66421	mitogen-activated protein kinase binding protein 1
PA30634	22919	MAPRE1	chr20	31397699	31441211	43512	microtubule-associated protein, RP/EB family, member 1
PA30635	10982	MAPRE2	chr18	32546892	32726434	179542	microtubule-associated protein, RP/EB family, member 2
PA30636	22924	MAPRE3	chr2	27183525	27253087	69562	microtubule-associated protein, RP/EB family, member 3
PA238	4137	MAPT	chr17	43961702	44108700	146998	microtubule-associated protein tau
PA142671344	64757	MARC1	chr1	220950039	220990741	40702	mitochondrial amidoxime reducing component 1
PA142671345	54996	MARC2	chr1	220911325	220961157	49832	mitochondrial amidoxime reducing component 2
PA134986392	55016	MARCH1	chr4	164442450	165315093	872643	membrane-associated ring finger (C3HC4) 1, E3 ubiquitin protein ligase
PA162395028	162333	MARCH10	chr17	60775675	60895705	120030	membrane-associated ring finger (C3HC4) 10, E3 ubiquitin protein ligase
PA162395055	441061	MARCH11	chr5	16064474	16189897	125423	membrane-associated ring finger (C3HC4) 11
PA134993565	51257	MARCH2	chr19	8468187	8506901	38714	membrane-associated ring finger (C3HC4) 2, E3 ubiquitin protein ligase
PA134901491	115123	MARCH3	chr5	126200406	126376500	176094	membrane-associated ring finger (C3HC4) 3, E3 ubiquitin protein ligase
PA134861849	57574	MARCH4	chr2	217119585	217246750	127165	membrane-associated ring finger (C3HC4) 4, E3 ubiquitin protein ligase
PA128394672	54708	MARCH5	chr10	94040920	94116721	75801	membrane-associated ring finger (C3HC4) 5
PA134869368	10299	MARCH6	chr5	10343751	10443500	99749	membrane-associated ring finger (C3HC4) 6, E3 ubiquitin protein ligase
PA25198	64844	MARCH7	chr2	160558980	160628084	69104	membrane-associated ring finger (C3HC4) 7, E3 ubiquitin protein ligase
PA134880669	220972	MARCH8	chr10	45947033	46100354	153321	membrane-associated ring finger (C3HC4) 8, E3 ubiquitin protein ligase
PA134920045	92979	MARCH9	chr12	58138881	58157193	18312	membrane-associated ring finger (C3HC4) 9
PA30637	4082	MARCKS	chr6	114168527	114187652	19125	myristoylated alanine-rich protein kinase C substrate
PA30857	65108	MARCKSL1	chr1	32796430	32811840	15410	MARCKS-like 1
PA30638	8685	MARCO	chr2	119689745	119755236	65491	macrophage receptor with collagenous structure
PA30639	4139	MARK1	chr1	220691568	220840799	149231	MAP/microtubule affinity-regulating kinase 1
PA35047	2011	MARK2	chr11	63596400	63681492	85092	MAP/microtubule affinity-regulating kinase 2
PA30640	4140	MARK3	chr14	103841701	103973168	131467	MAP/microtubule affinity-regulating kinase 3
PA30641	57787	MARK4	chr19	45744516	45811541	67025	MAP/microtubule affinity-regulating kinase 4
PA30642	4141	MARS	chr12	57871736	57913438	41702	methionyl-tRNA synthetase
PA134863396	92935	MARS2	chr2	198560028	198576114	16086	methionyl-tRNA synthetase 2, mitochondrial
PA134937190	83742	MARVELD1	chr10	99463465	99480909	17444	MARVEL domain containing 1
PA134954584	153562	MARVELD2	chr5	68700939	68741701	40762	MARVEL domain containing 2
PA134986126	91862	MARVELD3	chr16	71650056	71678868	28812	MARVEL domain containing 3
PA30643	4142	MAS1	chr6	160310218	160332339	22121	MAS1 proto-oncogene, G protein-coupled receptor
PA134912067	116511	MAS1L	chr6	29451543	29465679	14136	MAS1 proto-oncogene like, G protein-coupled receptor
PA30644	5648	MASP1	chr3	186930873	187019810	88937	mannan-binding lectin serine peptidase 1 (C4/C2 activating component of Ra-reactive factor)
PA30645	10747	MASP2	chr1	11083580	11117296	33716	mannan-binding lectin serine peptidase 2
PA134946727	22983	MAST1	chr19	12939259	12988766	49507	microtubule associated serine/threonine kinase 1
PA134954073	23139	MAST2	chr1	46259269	46504796	245527	microtubule associated serine/threonine kinase 2
PA134877725	23031	MAST3	chr19	18198585	18265502	66917	microtubule associated serine/threonine kinase 3
PA134920494	375449	MAST4	chr5	65882176	66468426	586250	microtubule associated serine/threonine kinase family member 4
PA134943781	84930	MASTL	chr10	27433753	27478848	45095	microtubule associated serine/threonine kinase-like
PA30646	4143	MAT1A	chr10	82028576	82059721	31145	methionine adenosyltransferase I, alpha
PA30647	4144	MAT2A	chr2	85756101	85775403	19302	methionine adenosyltransferase II, alpha
PA30648	27430	MAT2B	chr5	162920070	162949359	29289	methionine adenosyltransferase II, beta
PA30649	4145	MATK	chr19	3774967	3811810	36843	megakaryocyte-associated tyrosine kinase
PA30650	4146	MATN1	chr1	31181124	31206432	25308	matrilin 1, cartilage matrix protein
PA30651	4147	MATN2	chr8	98871284	99051948	180664	matrilin 2
PA30652	4148	MATN3	chr2	20188813	20222455	33642	matrilin 3
PA30653	8785	MATN4	chr20	43919086	43947206	28120	matrilin 4
PA30655	9782	MATR3	chr5	138599441	138670366	70925	matrin 3
PA134991458	23383	MAU2	chr19	19421496	19472563	51067	MAU2 sister chromatid cohesion factor
PA164722208	57506	MAVS	chr20	3817446	3859770	42324	mitochondrial antiviral signaling protein
PA30656	4149	MAX	chr14	65469819	65579413	109594	MYC associated factor X
PA30657	4150	MAZ	chr16	29807417	29825504	18087	MYC-associated zinc finger protein (purine-binding transcription factor)
PA30658	4151	MB	chr22	35999811	36029401	29590	myoglobin
PA134956015	115004	MB21D1	chr6	74131856	74172043	40187	Mab-21 domain containing 1
PA143485335	151963	MB21D2	chr3	192511604	192645950	134346	Mab-21 domain containing 2
PA30659	4152	MBD1	chr18	47790252	47818144	27892	methyl-CpG binding domain protein 1
PA30660	8932	MBD2	chr18	51674971	51761158	86187	methyl-CpG binding domain protein 2
PA30661	53615	MBD3	chr19	1573670	1602760	29090	methyl-CpG binding domain protein 3
PA30662	85509	MBD3L1	chr19	8933074	8957016	23942	methyl-CpG binding domain protein 3-like 1
PA38567	125997	MBD3L2	chr19	7039351	7054746	15395	methyl-CpG binding domain protein 3-like 2
PA30663	8930	MBD4	chr3	129146787	129169022	22235	methyl-CpG binding domain protein 4
PA134924244	55777	MBD5	chr2	148768580	149274046	505466	methyl-CpG binding domain protein 5
PA134866196	114785	MBD6	chr12	57905463	57926931	21468	methyl-CpG binding domain protein 6
PA134929415	51562	MBIP	chr14	36764764	36799882	35118	MAP3K12 binding inhibitory protein 1
PA30665	4153	MBL2	chr10	54522140	54542578	20438	mannose-binding lectin (protein C) 2, soluble
PA164722227	255374	MBLAC1	chr7	99714317	99729121	14804	metallo-beta-lactamase domain containing 1
PA164722236	153364	MBLAC2	chr5	89751020	89780585	29565	metallo-beta-lactamase domain containing 2
PA30666	4154	MBNL1	chr3	151952120	152186569	234449	muscleblind-like splicing regulator 1
PA134901420	10150	MBNL2	chr13	97864549	98049374	184825	muscleblind-like splicing regulator 2
PA134992936	55796	MBNL3	chrX	131500342	131634063	133721	muscleblind-like splicing regulator 3
PA134979205	154141	MBOAT1	chr6	20096915	20222695	125780	membrane bound O-acyltransferase domain containing 1
PA134987740	129642	MBOAT2	chr2	8993701	9153876	160175	membrane bound O-acyltransferase domain containing 2
PA142671233	619373	MBOAT4	chr8	29986187	30012200	26013	membrane bound O-acyltransferase domain containing 4
PA162395057	79143	MBOAT7	chr19	54674106	54703733	29627	membrane bound O-acyltransferase domain containing 7
PA30667	4155	MBP	chr18	74687789	74854774	166985	myelin basic protein
PA134938339	54799	MBTD1	chr17	49251786	49347788	96002	mbt domain containing 1
PA30671	8720	MBTPS1	chr16	84084368	84160517	76149	membrane-bound transcription factor peptidase, site 1
PA30672	51360	MBTPS2	chrX	21847656	21919427	71771	membrane-bound transcription factor peptidase, site 2
PA30673	4157	MC1R	chr16	89974287	89990385	16098	melanocortin 1 receptor (alpha melanocyte stimulating hormone receptor)
PA30674	4158	MC2R	chr18	13879043	13925535	46492	melanocortin 2 receptor (adrenocorticotropic hormone)
PA30675	4159	MC3R	chr20	54813788	54827871	14083	melanocortin 3 receptor
PA30676	4160	MC4R	chr18	58035564	58050001	14437	melanocortin 4 receptor
PA30677	4161	MC5R	chr18	13815543	13829861	14318	melanocortin 5 receptor
PA30678	4162	MCAM	chr11	119176234	119199087	22853	melanoma cell adhesion molecule
PA162395058	27349	MCAT	chr22	43525212	43549403	24191	malonyl CoA:ACP acyltransferase (mitochondrial)
PA30679	4163	MCC	chr5	112354796	112834527	479731	mutated in colorectal cancers
PA30680	56922	MCCC1	chr3	182730006	182827373	97367	methylcrotonoyl-CoA carboxylase 1 (alpha)
PA30681	64087	MCCC2	chr5	70873115	70957533	84418	methylcrotonoyl-CoA carboxylase 2 (beta)
PA134913652	401250	MCCD1	chr6	31486739	31501008	14269	mitochondrial coiled-coil domain 1
PA30683	84693	MCEE	chr2	71333806	71367394	33588	methylmalonyl CoA epimerase
PA162378700	199675	MCEMP1	chr19	7731943	7747719	15776	mast cell-expressed membrane protein 1
PA30684	4168	MCF2	chrX	138660930	138800381	139451	MCF.2 cell line derived transforming sequence
PA30685	23263	MCF2L	chr13	113538692	113757053	218361	MCF.2 cell line derived transforming sequence-like
PA134863801	23101	MCF2L2	chr3	182892831	183156031	263200	MCF.2 cell line derived transforming sequence-like 2
PA134925788	90411	MCFD2	chr2	47126009	47178994	52985	multiple coagulation factor deficiency 2
PA28867	2847	MCHR1	chr22	41065182	41081818	16636	melanin-concentrating hormone receptor 1
PA134950856	84539	MCHR2	chr6	100364786	100452114	87328	melanin-concentrating hormone receptor 2
PA30688	4170	MCL1	chr1	150544027	150562214	18187	myeloid cell leukemia 1
PA30689	55388	MCM10	chr10	13193554	13256104	62550	minichromosome maintenance complex component 10
PA164742061	4171	MCM2	chr3	127307200	127344279	37079	minichromosome maintenance complex component 2
PA30691	4172	MCM3	chr6	52125812	52159679	33867	minichromosome maintenance complex component 3
PA30692	8888	MCM3AP	chr21	47652047	47716211	64164	minichromosome maintenance complex component 3 associated protein
PA30694	4173	MCM4	chr8	48862763	48893720	30957	minichromosome maintenance complex component 4
PA30695	4174	MCM5	chr22	35786116	35823495	37379	minichromosome maintenance complex component 5
PA30696	4175	MCM6	chr2	136594196	136644047	49851	minichromosome maintenance complex component 6
PA30697	4176	MCM7	chr7	99687351	99709563	22212	minichromosome maintenance complex component 7
PA25696	84515	MCM8	chr20	5921298	5978852	57554	minichromosome maintenance complex component 8
PA162395071	254394	MCM9	chr6	119131612	119266327	134715	minichromosome maintenance complex component 9
PA134862625	79892	MCMBP	chr10	121585916	121643140	57224	minichromosome maintenance complex binding protein
PA142672364	157777	MCMDC2	chr8	67772984	67837283	64299	minichromosome maintenance domain containing 2
PA30699	57192	MCOLN1	chr19	7577496	7601895	24399	mucolipin 1
PA134913691	255231	MCOLN2	chr1	85388266	85472796	84530	mucolipin 2
PA134947324	55283	MCOLN3	chr1	85480765	85524585	43820	mucolipin 3
PA30701	79648	MCPH1	chr8	6254113	6504140	250027	microcephalin 1
PA30708	10445	MCRS1	chr12	49949077	49971928	22851	microspherule protein 1
PA142671472	79772	MCTP1	chr5	94035280	94630279	594999	multiple C2 domains, transmembrane 1
PA142671473	55784	MCTP2	chr15	94764772	95030181	265409	multiple C2 domains, transmembrane 2
PA128394649	28985	MCTS1	chrX	119727744	119758014	30270	malignant T cell amplified sequence 1
PA134888841	90550	MCU	chr10	74441889	74650452	208563	mitochondrial calcium uniporter
PA162381944	63933	MCUR1	chr6	13783781	13824794	41013	mitochondrial calcium uniporter regulator 1
PA134942837	9656	MDC1	chr6	30664584	30695458	30874	mediator of DNA-damage checkpoint 1
PA30713	4188	MDFI	chr6	41596194	41624984	28790	MyoD family inhibitor
PA142671474	29969	MDFIC	chr7	114552169	114662971	110802	MyoD family inhibitor domain containing
PA134864540	266727	MDGA1	chr6	37597284	37675766	78482	MAM domain containing glycosylphosphatidylinositol anchor 1
PA162395090	161357	MDGA2	chr14	47305826	48154157	848331	MAM domain containing glycosylphosphatidylinositol anchor 2
PA30714	4190	MDH1	chr2	63805743	63837331	31588	malate dehydrogenase 1, NAD (soluble)
PA30715	130752	MDH1B	chr2	207599487	207640268	40781	malate dehydrogenase 1B, NAD (soluble)
PA30716	4191	MDH2	chr7	75667182	75699826	32644	malate dehydrogenase 2, NAD (mitochondrial)
PA30717	4192	MDK	chr11	46392334	46408387	16053	midkine (neurite growth-promoting factor 2)
PA134879752	56890	MDM1	chr12	68685346	68736161	50815	Mdm1 nuclear protein homolog (mouse)
PA30718	4193	MDM2	chr12	69191952	69242324	50372	MDM2 proto-oncogene, E3 ubiquitin protein ligase
PA30719	4194	MDM4	chr1	204475507	204599131	123624	MDM4, p53 regulator
PA30720	23195	MDN1	chr6	90349494	90539442	189948	MDN1, midasin homolog (yeast)
PA165479165	145553	MDP1	chr14	24680143	24695276	15133	magnesium-dependent phosphatase 1
PA30723	4199	ME1	chr6	83917108	84150938	233830	malic enzyme 1, NADP(+)-dependent, cytosolic
PA30724	4200	ME2	chr18	48395432	48479165	83733	malic enzyme 2, NAD(+)-dependent, mitochondrial
PA30725	10873	ME3	chr11	86149150	86393678	244528	malic enzyme 3, NADP(+)-dependent, mitochondrial
PA30726	4201	MEA1	chr6	42945082	42991947	46865	male-enhanced antigen 1
PA165751536	64769	MEAF6	chr1	37952561	37990420	37859	MYST/Esa1-associated factor 6
PA27912	2122	MECOM	chr3	168798287	169391563	593276	MDS1 and EVI1 complex locus
PA30729	4204	MECP2	chrX	153284025	153373188	89163	methyl CpG binding protein 2
PA142671471	51102	MECR	chr1	29516385	29567460	51075	mitochondrial trans-2-enoyl-CoA reductase
PA33556	5469	MED1	chr17	37557538	37617527	59989	mediator complex subunit 1
PA144596412	84246	MED10	chr5	6369039	6388639	19600	mediator complex subunit 10
PA144596413	400569	MED11	chr17	4624723	4639902	15179	mediator complex subunit 11
PA36645	9968	MED12	chrX	70328406	70365304	36898	mediator complex subunit 12
PA134884590	116931	MED12L	chr3	150793452	151157465	364013	mediator complex subunit 12-like
PA162395168	9969	MED13	chr17	60016966	60152643	135677	mediator complex subunit 13
PA162395233	23389	MED13L	chr12	116393381	116724991	331610	mediator complex subunit 13-like
PA26890	9282	MED14	chrX	40505795	40605374	99579	mediator complex subunit 14
PA33088	51586	MED15	chr22	20851849	20944919	93070	mediator complex subunit 15
PA162395406	10025	MED16	chr19	864961	903218	38257	mediator complex subunit 16
PA162395443	9440	MED17	chr11	93507405	93549496	42091	mediator complex subunit 17
PA134884523	54797	MED18	chr1	28645513	28665478	19965	mediator complex subunit 18
PA134926032	219541	MED19	chr11	57468182	57489804	21622	mediator complex subunit 19
PA162395472	9477	MED20	chr6	41870092	41898877	28785	mediator complex subunit 20
PA162395485	9412	MED21	chr12	27165455	27186606	21151	mediator complex subunit 21
PA162395486	6837	MED22	chr9	136204751	136225011	20260	mediator complex subunit 22
PA162395499	9439	MED23	chr6	131892106	131959379	67273	mediator complex subunit 23
PA162395566	9862	MED24	chr17	38172350	38220889	48539	mediator complex subunit 24
PA134984839	81857	MED25	chr19	50311319	50343237	31918	mediator complex subunit 25
PA162395623	9441	MED26	chr19	16682718	16749015	66297	mediator complex subunit 26
PA162395634	9442	MED27	chr9	134732497	134965274	232777	mediator complex subunit 27
PA134935853	80306	MED28	chr4	17606273	17629160	22887	mediator complex subunit 28
PA162395655	55588	MED29	chr19	39871893	39894203	22310	mediator complex subunit 29
PA162395656	90390	MED30	chr8	118522532	118555510	32978	mediator complex subunit 30
PA134884310	51003	MED31	chr17	6543633	6565191	21558	mediator complex subunit 31
PA134877001	29079	MED4	chr13	48646864	48679277	32413	mediator complex subunit 4
PA134868263	10001	MED6	chr14	71047306	71077401	30095	mediator complex subunit 6
PA162395669	9443	MED7	chr5	156562451	156579921	17470	mediator complex subunit 7
PA134893073	112950	MED8	chr1	43846579	43865483	18904	mediator complex subunit 8
PA134925396	55090	MED9	chr17	17370300	17399534	29234	mediator complex subunit 9
PA147358556	84935	MEDAG	chr13	31470312	31502709	32397	mesenteric estrogen-dependent adipogenesis
PA30731	4205	MEF2A	chr15	100096133	100259688	163555	myocyte enhancer factor 2A
PA30733	100271849	MEF2B	chr19	19253376	19291098	37722	myocyte enhancer factor 2B
PA30734	4208	MEF2C	chr5	88011058	88209922	198864	myocyte enhancer factor 2C
PA30735	4209	MEF2D	chr1	156430513	156480634	50121	myocyte enhancer factor 2D
PA30736	4210	MEFV	chr16	3289028	3316648	27620	Mediterranean fever
PA144596410	84466	MEGF10	chr5	126555206	126799914	244708	multiple EGF-like-domains 10
PA144596411	84465	MEGF11	chr15	66184634	66556075	371441	multiple EGF-like-domains 11
PA27665	1953	MEGF6	chr1	3401506	3538059	136553	multiple EGF-like-domains 6
PA27666	1954	MEGF8	chr19	42819730	42885921	66191	multiple EGF-like-domains 8
PA27667	1955	MEGF9	chr9	123360196	123486765	126569	multiple EGF-like-domains 9
PA162395678	150365	MEI1	chr22	42085518	42198459	112941	meiosis inhibitor 1
PA134895701	644890	MEIG1	chr10	14986324	15017856	31532	meiosis/spermiogenesis associated 1
PA145149601	254528	MEIOB	chr16	1880984	1932179	51195	meiosis specific with OB domains
PA30740	4211	MEIS1	chr2	66652257	66802891	150634	Meis homeobox 1
PA30741	4212	MEIS2	chr15	37180222	37403500	223278	Meis homeobox 2
PA30742	56917	MEIS3	chr19	47903375	47932785	29410	Meis homeobox 3
PA134902874	9833	MELK	chr9	36562859	36680680	117821	maternal embryonic leucine zipper kinase
PA162395745	51072	MEMO1	chr2	32089892	32246116	156224	mediator of cell motility 1
PA30746	4221	MEN1	chr11	64567986	64588766	20780	multiple endocrine neoplasia I
PA30747	4222	MEOX1	chr17	41714757	41749262	34505	mesenchyme homeobox 1
PA30748	4223	MEOX2	chr7	15647837	15736308	88471	mesenchyme homeobox 2
PA30749	4224	MEP1A	chr6	46751094	46810519	59425	meprin A, alpha (PABA peptide hydrolase)
PA30754	4225	MEP1B	chr18	29759987	29803367	43380	meprin A, beta
PA162395768	56257	MEPCE	chr7	100016321	100034749	18428	methylphosphate capping enzyme
PA30755	56955	MEPE	chr4	88732563	88770969	38406	matrix extracellular phosphoglycoprotein
PA30759	10461	MERTK	chr2	112646056	112800293	154237	MER proto-oncogene, tyrosine kinase
PA30760	59274	MESDC1	chr15	81283295	81299345	16050	mesoderm development candidate 1
PA30761	23184	MESDC2	chr15	81236667	81292235	55568	mesoderm development candidate 2
PA142671468	55897	MESP1	chr15	90290098	90304540	14442	mesoderm posterior basic helix-loop-helix transcription factor 1
PA142671469	145873	MESP2	chr15	90309589	90324985	15396	mesoderm posterior basic helix-loop-helix transcription factor 2
PA30762	4232	MEST	chr7	130116016	130149138	33122	mesoderm specific transcript
PA30763	4233	MET	chr7	116302406	116441440	139034	MET proto-oncogene, receptor tyrosine kinase
PA30764	23173	METAP1	chr4	99906788	99986960	80172	methionyl aminopeptidase 1
PA30765	10988	METAP2	chr12	95857822	95912615	54793	methionyl aminopeptidase 2
PA25537	79006	METRN	chr16	755173	772655	17482	meteorin, glial cell differentiation regulator
PA134970048	284207	METRNL	chr17	81027567	81055867	28300	meteorin, glial cell differentiation regulator-like
PA30766	4234	METTL1	chr12	58159254	58175914	16660	methyltransferase like 1
PA162395769	399818	METTL10	chr10	126431336	126490439	59103	methyltransferase like 10
PA162395801	149281	METTL11B	chr1	170105188	170139923	34735	methyltransferase like 11B
PA164722245	751071	METTL12	chr11	62422725	62437923	15198	methyltransferase like 12
PA164722256	51603	METTL13	chr1	171740761	171769856	29095	methyltransferase like 13
PA164722277	57721	METTL14	chr4	119596525	119636374	39849	methyltransferase like 14
PA142671458	196074	METTL15	chr11	28119798	28358054	238256	methyltransferase like 15
PA142671460	79066	METTL16	chr17	2316343	2425200	108857	methyltransferase like 16
PA145008140	64745	METTL17	chr14	21447432	21468194	20762	methyltransferase like 17
PA142672407	92342	METTL18	chr1	169758670	169774088	15418	methyltransferase like 18
PA164716777	254013	METTL20	chr12	31790094	31825016	34922	methyltransferase like 20
PA145008433	151194	METTL21A	chr2	208470839	208500652	29813	methyltransferase like 21A
PA145008445	25895	METTL21B	chr12	58156383	58179324	22941	methyltransferase like 21B
PA162378126	196541	METTL21C	chr13	103335097	103356871	21774	methyltransferase like 21C
PA144596479	79091	METTL22	chr16	8705497	8743079	37582	methyltransferase like 22
PA162378566	124512	METTL23	chr17	74712912	74732962	20050	methyltransferase like 23
PA134906793	728464	METTL24	chr6	110563666	110689475	125809	methyltransferase like 24
PA142672297	84190	METTL25	chr12	82742276	82876018	133742	methyltransferase like 25
PA143485532	339175	METTL2A	chr17	60491246	60530454	39208	methyltransferase like 2A
PA134924546	55798	METTL2B	chr7	128106783	128145978	39195	methyltransferase like 2B
PA134955499	56339	METTL3	chr14	21963282	21989457	26175	methyltransferase like 3
PA134916468	64863	METTL4	chr18	2534524	2581489	46965	methyltransferase like 4
PA142671461	29081	METTL5	chr2	170665267	170691439	26172	methyltransferase like 5
PA142671462	131965	METTL6	chr3	15419782	15479054	59272	methyltransferase like 6
PA128394635	25840	METTL7A	chr12	51307780	51329300	21520	methyltransferase like 7A
PA143485533	196410	METTL7B	chr12	56065330	56081395	16065	methyltransferase like 7B
PA145008118	79828	METTL8	chr2	172170912	172301312	130400	methyltransferase like 8
PA145148428	51108	METTL9	chr16	21598543	21671792	73249	methyltransferase like 9
PA162395812	92312	MEX3A	chr1	156038804	156061789	22985	mex-3 RNA binding family member A
PA162395820	84206	MEX3B	chr15	82331119	82348484	17365	mex-3 RNA binding family member B
PA162395821	51320	MEX3C	chr18	48697920	48734051	36131	mex-3 RNA binding family member C
PA162395829	399664	MEX3D	chr19	1551668	1578057	26389	mex-3 RNA binding family member D
PA30768	4236	MFAP1	chr15	44093733	44126951	33218	microfibrillar-associated protein 1
PA30769	4237	MFAP2	chr1	17297997	17318081	20084	microfibrillar-associated protein 2
PA30770	4238	MFAP3	chr5	153408519	153440014	31495	microfibrillar-associated protein 3
PA134974574	9848	MFAP3L	chr4	170904748	170958371	53623	microfibrillar-associated protein 3-like
PA30771	4239	MFAP4	chr17	19283755	19300532	16777	microfibrillar-associated protein 4
PA134915148	8076	MFAP5	chr12	8795540	8825433	29893	microfibrillar associated protein 5
PA162395839	56947	MFF	chr2	228179867	228225552	45685	mitochondrial fission factor
PA30772	4240	MFGE8	chr15	89438914	89466685	27771	milk fat globule-EGF factor 8 protein
PA30773	9258	MFHAS1	chr8	8637864	8761131	123267	malignant fibrous histiocytoma amplified sequence 1
PA30774	4241	MFI2	chr3	196725611	196766687	41076	antigen p97 (melanoma associated) identified by monoclonal antibodies 133.2 and 96.5
PA134945973	55669	MFN1	chr3	179055480	179114014	58534	mitofusin 1
PA134986046	9927	MFN2	chr1	12030238	12076572	46334	mitofusin 2
PA30775	4242	MFNG	chr22	37862101	37892499	30398	MFNG O-fucosylpeptide 3-beta-N-acetylglucosaminyltransferase
PA30776	83552	MFRP	chr11	119206644	119227383	20739	membrane frizzled-related protein
PA134947356	64747	MFSD1	chr3	158509051	158550508	41457	major facilitator superfamily domain containing 1
PA162395840	10227	MFSD10	chr4	2929288	2946586	17298	major facilitator superfamily domain containing 10
PA162395841	79157	MFSD11	chr17	74722647	74778336	55689	major facilitator superfamily domain containing 11
PA134955537	126321	MFSD12	chr19	3535263	3567582	32319	major facilitator superfamily domain containing 12
PA165751549	84879	MFSD2A	chr1	40410784	40438630	27846	major facilitator superfamily domain containing 2A
PA165696804	388931	MFSD2B	chr2	24222953	24251698	28745	major facilitator superfamily domain containing 2B
PA142671464	113655	MFSD3	chr8	145723161	145739596	16435	major facilitator superfamily domain containing 3
PA142671465	148808	MFSD4	chr1	205528112	205575046	46934	major facilitator superfamily domain containing 4
PA142671466	84975	MFSD5	chr12	53635035	53651190	16155	major facilitator superfamily domain containing 5
PA164722278	54842	MFSD6	chr2	191263081	191370041	106960	major facilitator superfamily domain containing 6
PA164722299	162387	MFSD6L	chr17	8697428	8712667	15239	major facilitator superfamily domain containing 6-like
PA143485534	84179	MFSD7	chr4	666992	693257	26265	major facilitator superfamily domain containing 7
PA162395842	256471	MFSD8	chr4	128835960	128897185	61225	major facilitator superfamily domain containing 8
PA162395873	84804	MFSD9	chr2	103328089	103363341	35252	major facilitator superfamily domain containing 9
PA134976336	23269	MGA	chr15	41903432	42065141	161709	MGA, MAX dimerization protein
PA30778	8972	MGAM	chr7	141685676	141809547	123871	maltase-glucoamylase (alpha-glucosidase)
PA164717327	84709	MGARP	chr4	140184317	140211492	27175	mitochondria-localized glutamic acid-rich protein
PA30779	4245	MGAT1	chr5	180214541	180247939	33398	mannosyl (alpha-1,3-)-glycoprotein beta-1,2-N-acetylglucosaminyltransferase
PA30780	4247	MGAT2	chr14	50077460	50093199	15739	mannosyl (alpha-1,6-)-glycoprotein beta-1,2-N-acetylglucosaminyltransferase
PA30781	4248	MGAT3	chr22	39833235	39891199	57964	mannosyl (beta-1,4-)-glycoprotein beta-1,4-N-acetylglucosaminyltransferase
PA30782	11320	MGAT4A	chr2	99232569	99357589	125020	mannosyl (alpha-1,3-)-glycoprotein beta-1,4-N-acetylglucosaminyltransferase, isozyme A
PA30783	11282	MGAT4B	chr5	179221597	179243952	22355	mannosyl (alpha-1,3-)-glycoprotein beta-1,4-N-acetylglucosaminyltransferase, isozyme B
PA143485535	25834	MGAT4C	chr12	86370037	87242681	872644	MGAT4 family, member C
PA30784	4249	MGAT5	chr2	134867502	135215192	347690	mannosyl (alpha-1,6-)-glycoprotein beta-1,6-N-acetyl-glucosaminyltransferase
PA134987427	146664	MGAT5B	chr17	74854798	74949472	94674	mannosyl (alpha-1,6-)-glycoprotein beta-1,6-N-acetyl-glucosaminyltransferase, isozyme B
PA30787	10724	MGEA5	chr10	103541200	103588930	47730	meningioma expressed antigen 5 (hyaluronidase)
PA30789	11343	MGLL	chr3	127404905	127552093	147188	monoglyceride lipase
PA25783	92667	MGME1	chr20	17939534	17974765	35231	mitochondrial genome maintenance exonuclease 1
PA239	4255	MGMT	chr10	131255454	131568783	313329	O-6-methylguanine-DNA methyltransferase
PA30790	4256	MGP	chr12	15031115	15048853	17738	matrix Gla protein
PA134941221	23295	MGRN1	chr16	4664825	4743975	79150	mahogunin ring finger 1, E3 ubiquitin protein ligase
PA30791	4257	MGST1	chr12	16490076	16533123	43047	microsomal glutathione S-transferase 1
PA30792	4258	MGST2	chr4	140576922	140664899	87977	microsomal glutathione S-transferase 2
PA30793	4259	MGST3	chr1	165590110	165628373	38263	microsomal glutathione S-transferase 3
PA30800	8190	MIA	chr19	41271082	41286398	15316	melanoma inhibitory activity
PA134870998	117153	MIA2	chr14	39693125	39725575	32450	melanoma inhibitory activity 2
PA143485536	375056	MIA3	chr1	222781444	222844351	62907	melanoma inhibitory activity family, member 3
PA134862722	57534	MIB1	chr18	19311290	19453918	142628	mindbomb E3 ubiquitin protein ligase 1
PA134924284	142678	MIB2	chr1	1540795	1568990	28195	mindbomb E3 ubiquitin protein ligase 2
PA30811	100507436	MICA	chr6	31357561	31386090	28529	MHC class I polypeptide-related sequence A
PA134900249	64780	MICAL1	chr6	109762265	109797171	34906	microtubule associated monooxygenase, calponin and LIM domain containing 1
PA142671453	9645	MICAL2	chr11	12122138	12288335	166197	microtubule associated monooxygenase, calponin and LIM domain containing 2
PA142671454	57553	MICAL3	chr22	18267415	18517325	249910	microtubule associated monooxygenase, calponin and LIM domain containing 3
PA142671455	84953	MICALCL	chr11	12298447	12386687	88240	MICAL C-terminal like
PA162395891	85377	MICALL1	chr22	38292155	38341465	49310	MICAL-like 1
PA162395928	79778	MICALL2	chr7	1470995	1509138	38143	MICAL-like 2
PA30812	4277	MICB	chr6	31452054	31481901	29847	MHC class I polypeptide-related sequence B
PA26110	10367	MICU1	chr10	74124084	74395949	271865	mitochondrial calcium uptake 1
PA134891566	221154	MICU2	chr13	22063828	22188355	124527	mitochondrial calcium uptake 2
PA134953154	286097	MICU3	chr8	16874747	16983148	108401	mitochondrial calcium uptake family, member 3
PA30816	4281	MID1	chrX	10410350	10861829	451479	midline 1
PA134941916	58526	MID1IP1	chrX	38650685	38668785	18100	MID1 interacting protein 1
PA30817	11043	MID2	chrX	107058889	107177867	118978	midline 2
PA30818	90007	MIDN	chr19	1238552	1262142	23590	midnolin
PA145148068	54471	MIEF1	chr22	39888284	39917137	28853	mitochondrial elongation factor 1
PA38265	125170	MIEF2	chr17	18153848	18172095	18247	mitochondrial elongation factor 2
PA134947080	84299	MIEN1	chr17	37882409	37896792	14383	migration and invasion enhancer 1
PA142671456	57708	MIER1	chr1	67380578	67457302	76724	mesoderm induction early response 1, transcriptional regulator
PA134925804	54531	MIER2	chr19	302575	354791	52216	mesoderm induction early response 1, family member 2
PA145008088	166968	MIER3	chr5	56212429	56257957	45528	mesoderm induction early response 1, family member 3
PA30819	4282	MIF	chr22	24226565	24240409	13844	macrophage migration inhibitory factor (glycosylation-inhibiting factor)
PA142671457	57409	MIF4GD	chr17	73259309	73277373	18064	MIF4G domain containing
PA165751598	60672	MIIP	chr1	12069299	12095106	25807	migration and invasion inhibitory protein
PA134991047	84864	MINA	chr3	97657661	97701295	43634	MYC induced nuclear antigen
PA134910641	50488	MINK1	chr17	4726635	4804356	77721	misshapen-like kinase 1
PA142672468	440574	MINOS1	chr1	19913471	19959315	45844	mitochondrial inner membrane organizing system 1
PA30820	9562	MINPP1	chr10	89254223	89316218	61995	multiple inositol-polyphosphate phosphatase 1
PA164722300	54468	MIOS	chr7	7596522	7650112	53590	missing oocyte, meiosis regulator, homolog (Drosophila)
PA24716	55586	MIOX	chr22	50915213	50931750	16537	myo-inositol oxygenase
PA30821	4284	MIP	chr12	56840286	56858435	18149	major intrinsic protein of lens fiber
PA30822	4285	MIPEP	chr13	24301328	24473587	172259	mitochondrial intermediate peptidase
PA134883770	145282	MIPOL1	chr14	37657118	38023464	366346	mirror-image polydactyly 1
PA165505138	407975	MIR17HG	chr13	91990074	92009829	19755	miR-17-92 cluster host gene (non-protein coding)
PA134951024	79003	MIS12	chr17	5379694	5397134	17440	MIS12 kinetochore complex component
PA25840	54069	MIS18A	chr21	33637530	33661376	23846	MIS18 kinetochore protein A
PA134927557	55320	MIS18BP1	chr14	45669393	45732714	63321	MIS18 binding protein 1
PA134861073	126353	MISP	chr19	740910	767318	26408	mitotic spindle positioning
PA147357601	129531	MITD1	chr2	99782726	99807524	24798	MIT, microtubule interacting and transport, domain containing 1
PA30823	4286	MITF	chr3	69778586	70020488	241902	microphthalmia-associated transcription factor
PA134976348	83881	MIXL1	chr1	226401325	226417756	16431	Mix paired-like homeobox
PA30825	4288	MKI67	chr10	129891923	129934468	42545	marker of proliferation Ki-67
PA30826	8195	MKKS	chr20	10382428	10424887	42459	McKusick-Kaufman syndrome
PA30827	57591	MKL1	chr22	40803292	41042690	239398	megakaryoblastic leukemia (translocation) 1
PA134981329	57496	MKL2	chr16	14155178	14363633	208455	MKL/myocardin-like 2
PA30828	4289	MKLN1	chr7	130784855	131184398	399543	muskelin 1, intracellular mediator containing kelch motifs
PA30829	8569	MKNK1	chr1	47020079	47079966	59887	MAP kinase interacting serine/threonine kinase 1
PA30830	2872	MKNK2	chr19	2034470	2061243	26773	MAP kinase interacting serine/threonine kinase 2
PA30831	23608	MKRN1	chr7	140149840	140189369	39529	makorin ring finger protein 1
PA30832	23609	MKRN2	chr3	12588513	12628212	39699	makorin ring finger protein 2
PA30833	7681	MKRN3	chr15	23800454	23823764	23310	makorin ring finger protein 3
PA30840	54903	MKS1	chr17	56279797	56306966	27169	Meckel syndrome, type 1
PA134964449	283078	MKX	chr10	27958803	28044778	85975	mohawk homeobox
PA30842	2315	MLANA	chr9	5880895	5912822	31927	melan-A
PA38199	23209	MLC1	chr22	50494820	50534358	39538	megalencephalic leukoencephalopathy with subcortical cysts 1
PA164723038	9761	MLEC	chr12	121114949	121142667	27718	malectin
PA30843	4291	MLF1	chr3	158278953	158327249	48296	myeloid leukemia factor 1
PA30844	8079	MLF2	chr12	6854158	6872721	18563	myeloid leukemia factor 2
PA240	4292	MLH1	chr3	37024841	37095337	70496	mutL homolog 1
PA30845	27030	MLH3	chr14	75477467	75528235	50768	mutL homolog 3
PA134918634	90523	MLIP	chr6	53873714	54134078	260364	muscular LMNA-interacting protein
PA142671349	197259	MLKL	chr16	74702753	74744789	42036	mixed lineage kinase domain-like
PA30848	4298	MLLT1	chr19	6207392	6289959	82567	myeloid/lymphoid or mixed-lineage leukemia (trithorax homolog, Drosophila); translocated to, 1
PA30849	8028	MLLT10	chr10	21803540	22035559	232019	myeloid/lymphoid or mixed-lineage leukemia (trithorax homolog, Drosophila); translocated to, 10
PA142671347	10962	MLLT11	chr1	151022151	151043973	21822	myeloid/lymphoid or mixed-lineage leukemia (trithorax homolog, Drosophila); translocated to, 11
PA30852	4300	MLLT3	chr9	20338663	20632514	293851	myeloid/lymphoid or mixed-lineage leukemia (trithorax homolog, Drosophila); translocated to, 3
PA30853	4301	MLLT4	chr6	168217602	168375703	158101	myeloid/lymphoid or mixed-lineage leukemia (trithorax homolog, Drosophila); translocated to, 4
PA30854	4302	MLLT6	chr17	36851873	36889056	37183	myeloid/lymphoid or mixed-lineage leukemia (trithorax homolog, Drosophila); translocated to, 6
PA30856	4295	MLN	chr6	33759449	33781793	22344	motilin
PA28884	2862	MLNR	chr13	49784474	49799513	15039	motilin receptor
PA134899891	79083	MLPH	chr2	238385053	238466961	81908	melanophilin
PA165450213	64223	MLST8	chr16	2245178	2262418	17240	MTOR associated protein, LST8 homolog (S. cerevisiae)
PA36397	6945	MLX	chr17	40709078	40728221	19143	MLX, MAX dimerization protein
PA128394590	22877	MLXIP	chr12	122601800	122631989	30189	MLX interacting protein
PA37353	51085	MLXIPL	chr7	73004524	73048903	44379	MLX interacting protein-like
PA30861	23417	MLYCD	chr16	83922720	83965428	42708	malonyl-CoA decarboxylase
PA134912808	166785	MMAA	chr4	146530540	146584187	53647	methylmalonic aciduria (cobalamin deficiency) cblA type
PA134864025	326625	MMAB	chr12	109988520	110021358	32838	methylmalonic aciduria (cobalamin deficiency) cblB type
PA142671348	25974	MMACHC	chr1	45955856	45979739	23883	methylmalonic aciduria (cobalamin deficiency) cblC type, with homocystinuria
PA164723053	27249	MMADHC	chr2	150423147	150454330	31183	methylmalonic aciduria (cobalamin deficiency) cblD type, with homocystinuria
PA30863	23531	MMD	chr17	53466974	53509341	42367	monocyte to macrophage differentiation-associated
PA134910250	221938	MMD2	chr7	4928876	5008844	79968	monocyte to macrophage differentiation-associated 2
PA30864	4311	MME	chr3	154787436	154904518	117082	membrane metallo-endopeptidase
PA30865	79258	MMEL1	chr1	2519078	2574499	55421	membrane metallo-endopeptidase-like 1
PA164723074	93380	MMGT1	chrX	135041230	135066224	24994	membrane magnesium transporter 1
PA30867	4312	MMP1	chr11	102657641	102678966	21325	matrix metallopeptidase 1 (interstitial collagenase)
PA30868	4319	MMP10	chr11	102638233	102661359	23126	matrix metallopeptidase 10 (stromelysin 2)
PA30869	4320	MMP11	chr22	24105036	24129503	24467	matrix metallopeptidase 11 (stromelysin 3)
PA30870	4321	MMP12	chr11	102730464	102755764	25300	matrix metallopeptidase 12 (macrophage elastase)
PA30871	4322	MMP13	chr11	102810721	102836463	25742	matrix metallopeptidase 13 (collagenase 3)
PA30872	4323	MMP14	chr14	23295742	23319809	24067	matrix metallopeptidase 14 (membrane-inserted)
PA30873	4324	MMP15	chr16	58049282	58083805	34523	matrix metallopeptidase 15 (membrane-inserted)
PA30874	4325	MMP16	chr8	89046460	89349717	303257	matrix metallopeptidase 16 (membrane-inserted)
PA30875	4326	MMP17	chr12	132302941	132339316	36375	matrix metallopeptidase 17 (membrane-inserted)
PA30876	4327	MMP19	chr12	56226214	56246767	20553	matrix metallopeptidase 19
PA30877	4313	MMP2	chr16	55503081	55543586	40505	matrix metallopeptidase 2 (gelatinase A, 72kDa gelatinase, 72kDa type IV collagenase)
PA30878	9313	MMP20	chr11	102444566	102506063	61497	matrix metallopeptidase 20
PA134885721	118856	MMP21	chr10	127452022	127474390	22368	matrix metallopeptidase 21
PA30880	8510	MMP23B	chr1	1557060	1573030	15970	matrix metallopeptidase 23B
PA30881	10893	MMP24	chr20	33804539	33867804	63265	matrix metallopeptidase 24 (membrane-inserted)
PA30882	64386	MMP25	chr16	3086682	3113727	27045	matrix metallopeptidase 25
PA30883	56547	MMP26	chr11	4999424	5016659	17235	matrix metallopeptidase 26
PA30884	64066	MMP27	chr11	102559415	102586468	27053	matrix metallopeptidase 27
PA30885	79148	MMP28	chr17	34080316	34132711	52395	matrix metallopeptidase 28
PA30886	4314	MMP3	chr11	102703528	102724342	20814	matrix metallopeptidase 3 (stromelysin 1, progelatinase)
PA30887	4316	MMP7	chr11	102388239	102411478	23239	matrix metallopeptidase 7 (matrilysin, uterine)
PA30888	4317	MMP8	chr11	102579526	102605734	26208	matrix metallopeptidase 8 (neutrophil collagenase)
PA30889	4318	MMP9	chr20	44627547	44648200	20653	matrix metallopeptidase 9 (gelatinase B, 92kDa gelatinase, 92kDa type IV collagenase)
PA30891	22915	MMRN1	chr4	90806003	90878780	72777	multimerin 1
PA134991578	79812	MMRN2	chr10	88692297	88727425	35128	multimerin 2
PA162395974	64210	MMS19	chr10	99215081	99268521	53440	MMS19 nucleotide excision repair homolog (S. cerevisiae)
PA134878007	253714	MMS22L	chr6	97587037	97741126	154089	MMS22-like, DNA repair protein
PA30893	4330	MN1	chr22	28141265	28207486	66221	meningioma (disrupted in balanced translocation) 1
PA30894	4331	MNAT1	chr14	61191459	61438398	246939	MNAT CDK-activating kinase assembly factor 1
PA143485544	84057	MND1	chr4	154255801	154339247	83446	meiotic nuclear divisions 1 homolog (S. cerevisiae)
PA30895	4332	MNDA	chr1	158791168	158822270	31102	myeloid cell nuclear differentiation antigen
PA142671346	55329	MNS1	chr15	56717929	56767335	49406	meiosis-specific nuclear structural 1
PA30898	4335	MNT	chr17	2284354	2314258	29904	MAX network transcriptional repressor
PA162396041	3110	MNX1	chr7	156794547	156813347	18800	motor neuron and pancreas homeobox 1
PA134908381	64112	MOAP1	chr14	93645541	93661249	15708	modulator of apoptosis 1
PA25894	55233	MOB1A	chr2	74378394	74416006	37612	MOB kinase activator 1A
PA134871841	92597	MOB1B	chr4	71758043	71856891	98848	MOB kinase activator 1B
PA134901591	126308	MOB3A	chr19	2068031	2106501	38470	MOB kinase activator 3A
PA134886513	79817	MOB3B	chr9	27322207	27540223	218016	MOB kinase activator 3B
PA134928770	148932	MOB3C	chr1	47070387	47092563	22176	MOB kinase activator 3C
PA162396053	25843	MOB4	chr2	198370295	198421423	51128	MOB family member 4, phocein
PA30899	4336	MOBP	chr3	39499064	39573988	74924	myelin-associated oligodendrocyte basic protein
PA134964534	55034	MOCOS	chr18	33757480	33851685	94205	molybdenum cofactor sulfurase
PA30900	4337	MOCS1	chr6	39869034	39912290	43256	molybdenum cofactor synthesis 1
PA30903	4338	MOCS2	chr5	52388509	52415602	27093	molybdenum cofactor synthesis 2
PA30904	27304	MOCS3	chr20	49565351	49581400	16049	molybdenum cofactor synthesis 3
PA30905	4340	MOG	chr6	29614758	29643149	28391	myelin oligodendrocyte glycoprotein
PA27305	116255	MOGAT1	chr2	223526457	223578005	51548	monoacylglycerol O-acyltransferase 1
PA134936582	80168	MOGAT2	chr11	75418934	75445331	26397	monoacylglycerol O-acyltransferase 2
PA134959238	346606	MOGAT3	chr7	100836010	100854302	18292	monoacylglycerol O-acyltransferase 3
PA164723075	7841	MOGS	chr2	74685184	74702537	17353	mannosyl-oligosaccharide glucosidase
PA34187	5891	MOK	chr14	102687834	102781537	93703	MOK protein kinase
PA142671340	84315	MON1A	chr3	49943302	49977445	34143	MON1 secretory trafficking family member A
PA142671341	22879	MON1B	chr16	77214821	77236543	21722	MON1 secretory trafficking family member B
PA143485545	23041	MON2	chr12	62850597	62994363	143766	MON2 homolog (S. cerevisiae)
PA30906	27136	MORC1	chr3	108673814	108846993	173179	MORC family CW-type zinc finger 1
PA134986990	22880	MORC2	chr22	31319598	31374483	54885	MORC family CW-type zinc finger 2
PA128394632	23515	MORC3	chr21	37682360	37752999	70639	MORC family CW-type zinc finger 3
PA128394718	79710	MORC4	chrX	106180964	106253474	72510	MORC family CW-type zinc finger 4
PA35666	10934	MORF4	chr4	174534087	174547794	13707	mortality factor 4
PA134895182	10933	MORF4L1	chr15	79122903	79193081	70178	mortality factor 4 like 1
PA134925837	9643	MORF4L2	chrX	102927426	102953086	25660	mortality factor 4 like 2
PA142671342	79906	MORN1	chr1	2248719	2333190	84471	MORN repeat containing 1
PA142671343	729967	MORN2	chr2	39093103	39112850	19747	MORN repeat containing 2
PA143485546	283385	MORN3	chr12	122086024	122120531	34507	MORN repeat containing 3
PA162396074	118812	MORN4	chr10	99371310	99403913	32603	MORN repeat containing 4
PA25975	254956	MORN5	chr9	124912190	124965368	53178	MORN repeat containing 5
PA30907	4342	MOS	chr8	57022501	57036541	14040	v-mos Moloney murine sarcoma viral oncogene homolog
PA134956517	56180	MOSPD1	chrX	134018656	134059314	40658	motile sperm domain containing 1
PA134898878	158747	MOSPD2	chrX	14881527	14943288	61761	motile sperm domain containing 2
PA134865874	64598	MOSPD3	chr7	100199725	100216003	16278	motile sperm domain containing 3
PA30908	4343	MOV10	chr1	113207048	113246368	39320	Mov10 RISC complex RNA helicase
PA30909	54456	MOV10L1	chr22	50518435	50603119	84684	Mov10 RISC complex RNA helicase like 1
PA134979178	26002	MOXD1	chr6	132614194	132732664	118470	monooxygenase, DBH-like 1
PA134940737	51660	MPC1	chr6	166775407	166806501	31094	mitochondrial pyruvate carrier 1
PA142672547	25874	MPC2	chr1	167882913	167916307	33394	mitochondrial pyruvate carrier 2
PA30913	9526	MPDU1	chr17	7476965	7494530	17565	mannose-P-dolichol utilization defect 1
PA30914	8777	MPDZ	chr9	13102700	13289660	186960	multiple PDZ domain protein
PA164723088	219972	MPEG1	chr11	58972983	58990494	17511	macrophage expressed 1
PA30917	4350	MPG	chr16	117018	138850	21832	N-methylpurine-DNA glycosylase
PA30919	10199	MPHOSPH10	chr2	71347444	71380232	32788	M-phase phosphoprotein 10 (U3 small nucleolar ribonucleoprotein)
PA30920	10200	MPHOSPH6	chr16	82178767	82213829	35062	M-phase phosphoprotein 6
PA162396090	54737	MPHOSPH8	chr13	20197787	20250599	52812	M-phase phosphoprotein 8
PA30921	10198	MPHOSPH9	chr12	123637943	123727785	89842	M-phase phosphoprotein 9
PA30922	4351	MPI	chr15	75172377	75193581	21204	mannose phosphate isomerase
PA30923	4352	MPL	chr1	43793475	43823135	29660	MPL proto-oncogene, thrombopoietin receptor
PA25943	136647	MPLKIP	chr7	40169342	40184251	14909	M-phase specific PLK1 interacting protein
PA162396091	84954	MPND	chr19	4333524	4363083	29559	MPN domain containing
PA243	4353	MPO	chr17	56344217	56368296	24079	myeloperoxidase
PA30924	4354	MPP1	chrX	154003959	154043802	39843	membrane protein, palmitoylated 1, 55kDa
PA30925	4355	MPP2	chr17	41949727	41997079	47352	membrane protein, palmitoylated 2 (MAGUK p55 subfamily member 2)
PA30926	4356	MPP3	chr17	41875167	41920547	45380	membrane protein, palmitoylated 3 (MAGUK p55 subfamily member 3)
PA30927	58538	MPP4	chr2	202506597	202573467	66870	membrane protein, palmitoylated 4 (MAGUK p55 subfamily member 4)
PA38631	64398	MPP5	chr14	67698012	67805778	107766	membrane protein, palmitoylated 5 (MAGUK p55 subfamily member 5)
PA38511	51678	MPP6	chr7	24603007	24736322	133315	membrane protein, palmitoylated 6 (MAGUK p55 subfamily member 6)
PA134985345	143098	MPP7	chr10	28336922	28601953	265031	membrane protein, palmitoylated 7 (MAGUK p55 subfamily member 7)
PA134913534	65258	MPPE1	chr18	11880470	11918796	38326	metallophosphoesterase 1
PA25880	758	MPPED1	chr22	43797202	43906688	109486	metallophosphoesterase domain containing 1
PA25499	744	MPPED2	chr11	30403040	30618260	215220	metallophosphoesterase domain containing 2
PA162396092	23164	MPRIP	chr17	16935790	17098962	163172	myosin phosphatase Rho interacting protein
PA30928	4357	MPST	chr22	37405683	37428863	23180	mercaptopyruvate sulfurtransferase
PA30929	4358	MPV17	chr2	27529360	27555969	26609	MpV17 mitochondrial inner membrane protein
PA145007960	255027	MPV17L	chr16	15479611	15506543	26932	MPV17 mitochondrial membrane protein-like
PA164723095	84769	MPV17L2	chr19	18293986	18310552	16566	MPV17 mitochondrial membrane protein-like 2
PA30930	4359	MPZ	chr1	161271525	161289762	18237	myelin protein zero
PA30931	9019	MPZL1	chr1	167681187	167764156	82969	myelin protein zero-like 1
PA162396145	10205	MPZL2	chr11	118121131	118145251	24120	myelin protein zero-like 2
PA162396160	196264	MPZL3	chr11	118094405	118134135	39730	myelin protein zero-like 3
PA29309	3140	MR1	chr1	180992561	181034074	41513	major histocompatibility complex, class I-related
PA25856	56246	MRAP	chr21	33654124	33690095	35971	melanocortin 2 receptor accessory protein
PA162396161	112609	MRAP2	chr6	84722746	84803606	80860	melanocortin 2 receptor accessory protein 2
PA30932	22808	MRAS	chr3	138056490	138127377	70887	muscle RAS oncogene homolog
PA30933	4360	MRC1	chr10	18088332	18203091	114759	mannose receptor, C type 1
PA134941260	414308	MRC1L1	chr10	17841363	17956179	114816	mannose receptor, C type 1-like 1
PA134988161	9902	MRC2	chr17	60694762	60773962	79200	mannose receptor, C type 2
PA30934	4361	MRE11A	chr11	94147466	94237040	89574	MRE11 meiotic recombination 11 homolog A (S. cerevisiae)
PA162396174	55686	MREG	chr2	216804314	216888346	84032	melanoregulin
PA142671332	93621	MRFAP1	chr4	6631818	6647472	15654	Morf4 family associated protein 1
PA142671333	114932	MRFAP1L1	chr4	6706428	6721606	15178	Morf4 family associated protein 1-like 1
PA25736	55257	MRGBP	chr20	61417804	61434945	17141	MRG/MORF4L binding protein
PA134978563	116512	MRGPRD	chr11	68744490	68758455	13965	MAS-related GPR, member D
PA134939296	116534	MRGPRE	chr11	3246041	3263616	17575	MAS-related GPR, member E
PA134896544	116535	MRGPRF	chr11	68768862	68790850	21988	MAS-related GPR, member F
PA134953683	386746	MRGPRG	chr11	3236174	3250043	13869	MAS-related GPR, member G
PA142671334	259249	MRGPRX1	chr11	18952360	18966549	14189	MAS-related GPR, member X1
PA142671335	117194	MRGPRX2	chr11	19073002	19092228	19226	MAS-related GPR, member X2
PA142671336	117195	MRGPRX3	chr11	18132502	18163027	30525	MAS-related GPR, member X3
PA142671337	117196	MRGPRX4	chr11	18184384	18198827	14443	MAS-related GPR, member X4
PA164723110	84245	MRI1	chr19	13865328	13888096	22768	methylthioribose-1-phosphate isomerase 1
PA142671338	79922	MRM1	chr17	34948010	34968407	20397	mitochondrial rRNA methyltransferase 1 homolog (S. cerevisiae)
PA134932281	83876	MRO	chr18	48318490	48361808	43318	maestro
PA164720350	727957	MROH1	chr8	145192919	145319843	126924	maestro heat-like repeat family member 1
PA164720351	339766	MROH2A	chr2	234674376	234745069	70693	maestro heat-like repeat family member 2A
PA164720440	133558	MROH2B	chr5	40995122	41081444	86322	maestro heat-like repeat family member 2B
PA142672336	642475	MROH6	chr8	144645362	144664928	19566	maestro heat-like repeat family member 6
PA142672423	374977	MROH7	chr1	55097427	55178939	81512	maestro heat-like repeat family member 7
PA25674	140699	MROH8	chr20	35726629	35817974	91345	maestro heat-like repeat family member 8
PA142672447	80133	MROH9	chr1	170894612	171036906	142294	maestro heat-like repeat family member 9
PA30938	65008	MRPL1	chr4	78773805	78876944	103139	mitochondrial ribosomal protein L1
PA30939	124995	MRPL10	chr17	45897638	45918907	21269	mitochondrial ribosomal protein L10
PA30940	65003	MRPL11	chr11	66199550	66216310	16760	mitochondrial ribosomal protein L11
PA30941	6182	MRPL12	chr17	79660400	79677556	17156	mitochondrial ribosomal protein L12
PA30942	28998	MRPL13	chr8	121405083	121467647	62564	mitochondrial ribosomal protein L13
PA30943	64928	MRPL14	chr6	44078372	44105191	26819	mitochondrial ribosomal protein L14
PA30944	29088	MRPL15	chr8	55037781	55064074	26293	mitochondrial ribosomal protein L15
PA30945	54948	MRPL16	chr11	59570608	59588345	17737	mitochondrial ribosomal protein L16
PA30946	63875	MRPL17	chr11	6698616	6714632	16016	mitochondrial ribosomal protein L17
PA30947	29074	MRPL18	chr6	160201492	160222461	20969	mitochondrial ribosomal protein L18
PA30948	9801	MRPL19	chr2	75863909	75892334	28425	mitochondrial ribosomal protein L19
PA30949	51069	MRPL2	chr6	43018767	43038259	19492	mitochondrial ribosomal protein L2
PA30950	55052	MRPL20	chr1	1334276	1352693	18417	mitochondrial ribosomal protein L20
PA30951	219927	MRPL21	chr11	68655744	68681303	25559	mitochondrial ribosomal protein L21
PA30952	29093	MRPL22	chr5	154310633	154351971	41338	mitochondrial ribosomal protein L22
PA30953	6150	MRPL23	chr11	1958502	2010295	51793	mitochondrial ribosomal protein L23
PA30954	79590	MRPL24	chr1	156704094	156720923	16829	mitochondrial ribosomal protein L24
PA30957	51264	MRPL27	chr17	48442228	48460562	18334	mitochondrial ribosomal protein L27
PA30515	10573	MRPL28	chr16	414384	430584	16200	mitochondrial ribosomal protein L28
PA30960	11222	MRPL3	chr3	131178045	131231860	53815	mitochondrial ribosomal protein L3
PA30961	51263	MRPL30	chr2	99787542	99819020	31478	mitochondrial ribosomal protein L30
PA30963	64983	MRPL32	chr7	42961804	42980456	18652	mitochondrial ribosomal protein L32
PA30964	9553	MRPL33	chr2	27984584	28005608	21024	mitochondrial ribosomal protein L33
PA30965	64981	MRPL34	chr19	17403616	17420652	17036	mitochondrial ribosomal protein L34
PA30966	51318	MRPL35	chr2	86416478	86443913	27435	mitochondrial ribosomal protein L35
PA30967	64979	MRPL36	chr5	1795499	1809956	14457	mitochondrial ribosomal protein L36
PA30968	51253	MRPL37	chr1	54655840	54694407	38567	mitochondrial ribosomal protein L37
PA30969	64978	MRPL38	chr17	73891724	73911181	19457	mitochondrial ribosomal protein L38
PA30970	54148	MRPL39	chr21	26954968	26989801	34833	mitochondrial ribosomal protein L39
PA30971	51073	MRPL4	chr19	10352640	10373736	21096	mitochondrial ribosomal protein L4
PA30972	64976	MRPL40	chr22	19409302	19426600	17298	mitochondrial ribosomal protein L40
PA30973	64975	MRPL41	chr9	140436309	140450007	13698	mitochondrial ribosomal protein L41
PA30974	28977	MRPL42	chr12	93851266	93900548	49282	mitochondrial ribosomal protein L42
PA30975	84545	MRPL43	chr10	102734579	102757272	22693	mitochondrial ribosomal protein L43
PA30976	65080	MRPL44	chr2	224812121	224835431	23310	mitochondrial ribosomal protein L44
PA30977	84311	MRPL45	chr17	36442989	36482101	39112	mitochondrial ribosomal protein L45
PA30978	26589	MRPL46	chr15	88999709	89020633	20924	mitochondrial ribosomal protein L46
PA30979	57129	MRPL47	chr3	179303253	179332434	29181	mitochondrial ribosomal protein L47
PA30980	51642	MRPL48	chr11	73488917	73578656	89739	mitochondrial ribosomal protein L48
PA30981	740	MRPL49	chr11	64879655	64897841	18186	mitochondrial ribosomal protein L49
PA30983	54534	MRPL50	chr9	104148096	104170919	22823	mitochondrial ribosomal protein L50
PA30984	51258	MRPL51	chr12	6598316	6612471	14155	mitochondrial ribosomal protein L51
PA30985	122704	MRPL52	chr14	23289088	23307246	18158	mitochondrial ribosomal protein L52
PA30986	116540	MRPL53	chr2	74696085	74709942	13857	mitochondrial ribosomal protein L53
PA30987	116541	MRPL54	chr19	3752665	3770563	17898	mitochondrial ribosomal protein L54
PA30988	128308	MRPL55	chr1	228291380	228307037	15657	mitochondrial ribosomal protein L55
PA30937	78988	MRPL57	chr13	21740372	21756223	15851	mitochondrial ribosomal protein L57
PA30991	65005	MRPL9	chr1	151729119	151746040	16921	mitochondrial ribosomal protein L9
PA30993	55173	MRPS10	chr6	42171539	42195633	24094	mitochondrial ribosomal protein S10
PA30994	64963	MRPS11	chr15	89000684	89024861	24177	mitochondrial ribosomal protein S11
PA30996	6183	MRPS12	chr19	39411348	39426660	15312	mitochondrial ribosomal protein S12
PA30998	63931	MRPS14	chr1	174979094	175002591	23497	mitochondrial ribosomal protein S14
PA30999	64960	MRPS15	chr1	36918362	36940040	21678	mitochondrial ribosomal protein S15
PA31000	51021	MRPS16	chr10	75005601	75022451	16850	mitochondrial ribosomal protein S16
PA31002	51373	MRPS17	chr7	56009611	56026034	16423	mitochondrial ribosomal protein S17
PA31003	55168	MRPS18A	chr6	43635934	43665549	29615	mitochondrial ribosomal protein S18A
PA31004	28973	MRPS18B	chr6	30575275	30597174	21899	mitochondrial ribosomal protein S18B
PA31005	51023	MRPS18C	chr4	84367085	84385929	18844	mitochondrial ribosomal protein S18C
PA31007	51116	MRPS2	chr9	138382477	138399519	17042	mitochondrial ribosomal protein S2
PA31009	54460	MRPS21	chr1	150256262	150284414	28152	mitochondrial ribosomal protein S21
PA31010	56945	MRPS22	chr3	139052861	139078888	26027	mitochondrial ribosomal protein S22
PA31011	51649	MRPS23	chr17	55913287	55937433	24146	mitochondrial ribosomal protein S23
PA31012	64951	MRPS24	chr7	43903157	43919145	15988	mitochondrial ribosomal protein S24
PA31013	64432	MRPS25	chr3	15080758	15116839	36081	mitochondrial ribosomal protein S25
PA31014	64949	MRPS26	chr20	3016675	3031896	15221	mitochondrial ribosomal protein S26
PA31015	23107	MRPS27	chr5	71512236	71626084	113848	mitochondrial ribosomal protein S27
PA31016	28957	MRPS28	chr8	80827952	80952516	124564	mitochondrial ribosomal protein S28
PA31018	10884	MRPS30	chr5	44799027	44818616	19589	mitochondrial ribosomal protein S30
PA31019	10240	MRPS31	chr13	41300432	41355347	54915	mitochondrial ribosomal protein S31
PA31020	51650	MRPS33	chr7	140702961	140724781	21820	mitochondrial ribosomal protein S33
PA31021	65993	MRPS34	chr16	1818891	1833152	14261	mitochondrial ribosomal protein S34
PA31022	60488	MRPS35	chr12	27853706	27912237	58531	mitochondrial ribosomal protein S35
PA31023	92259	MRPS36	chr5	68503573	68528985	25412	mitochondrial ribosomal protein S36
PA31024	64969	MRPS5	chr2	95749952	95797754	47802	mitochondrial ribosomal protein S5
PA31025	64968	MRPS6	chr21	35435823	35518334	82511	mitochondrial ribosomal protein S6
PA31026	51081	MRPS7	chr17	73247749	73265457	17708	mitochondrial ribosomal protein S7
PA31028	64965	MRPS9	chr2	105644483	105719418	74935	mitochondrial ribosomal protein S9
PA31029	92399	MRRF	chr9	125016882	125088743	71861	mitochondrial ribosome recycling factor
PA162396189	57380	MRS2	chr6	24393141	24428816	35675	MRS2 magnesium transporter
PA162396216	51154	MRTO4	chr1	19568075	19589622	21547	mRNA turnover 4 homolog (S. cerevisiae)
PA31032	10335	MRVI1	chr11	10591638	10725535	133897	murine retrovirus integration site 1 homolog
PA31111	931	MS4A1	chr11	60213251	60241225	27974	membrane-spanning 4-domains, subfamily A, member 1
PA31110	341116	MS4A10	chr11	60542821	60571778	28957	membrane-spanning 4-domains, subfamily A, member 10
PA134971353	54860	MS4A12	chr11	60250251	60277903	27652	membrane-spanning 4-domains, subfamily A, member 12
PA142671314	503497	MS4A13	chr11	60272886	60313194	40308	membrane-spanning 4-domains, subfamily A, member 13
PA162396237	84689	MS4A14	chr11	60153487	60188229	34742	membrane-spanning 4-domains, subfamily A, member 14
PA134959869	219995	MS4A15	chr11	60514340	60547204	32864	membrane-spanning 4-domains, subfamily A, member 15
PA165543479	728588	MS4A18	chr11	60479669	60514467	34798	membrane-spanning 4-domains, subfamily A, member 18
PA31109	2206	MS4A2	chr11	59845734	59868940	23206	membrane-spanning 4-domains, subfamily A, member 2
PA31112	932	MS4A3	chr11	59814101	59841588	27487	membrane-spanning 4-domains, subfamily A, member 3 (hematopoietic cell-specific)
PA31113	51338	MS4A4A	chr11	60038014	60079445	41431	membrane-spanning 4-domains, subfamily A, member 4A
PA31117	643680	MS4A4E	chr11	59965726	60020561	54835	membrane-spanning 4-domains, subfamily A, member 4E
PA31118	64232	MS4A5	chr11	60187062	60218265	31203	membrane-spanning 4-domains, subfamily A, member 5
PA31119	64231	MS4A6A	chr11	59936080	59962139	26059	membrane-spanning 4-domains, subfamily A, member 6A
PA31123	245802	MS4A6E	chr11	60092355	60111441	19086	membrane-spanning 4-domains, subfamily A, member 6E
PA31124	58475	MS4A7	chr11	60135949	60166427	30478	membrane-spanning 4-domains, subfamily A, member 7
PA31126	83661	MS4A8	chr11	60457046	60486284	29238	membrane-spanning 4-domains, subfamily A, member 8
PA162379942	345222	MSANTD1	chr4	3240766	3276465	35699	Myb/SANT-like DNA-binding domain containing 1
PA143485356	79684	MSANTD2	chr11	124633388	124680868	47480	Myb/SANT-like DNA-binding domain containing 2
PA142672311	91283	MSANTD3	chr9	103179495	103217016	37521	Myb/SANT-like DNA-binding domain containing 3
PA143485519	84437	MSANTD4	chr11	105875629	105902981	27352	Myb/SANT-like DNA-binding domain containing 4 with coiled-coils
PA31130	9242	MSC	chr8	72750777	72766731	15954	musculin
PA142671315	343930	MSGN1	chr2	17987786	18001367	13581	mesogenin 1
PA31133	4436	MSH2	chr2	47620206	47742716	122510	mutS homolog 2
PA31134	4437	MSH3	chr5	79940467	80175634	235167	mutS homolog 3
PA31135	4438	MSH4	chr1	76252556	76382581	130025	mutS homolog 4
PA31136	4439	MSH5	chr6	31697725	31733455	35730	mutS homolog 5
PA184	2956	MSH6	chr2	48000221	48037092	36871	mutS homolog 6
PA31137	4440	MSI1	chr12	120776133	120816983	40850	musashi RNA-binding protein 1
PA38590	124540	MSI2	chr17	55323931	55765050	441119	musashi RNA-binding protein 2
PA164723127	339287	MSL1	chr17	38268235	38296047	27812	male-specific lethal 1 homolog (Drosophila)
PA164723152	55167	MSL2	chr3	135864760	135925522	60762	male-specific lethal 2 homolog (Drosophila)
PA164723161	10943	MSL3	chrX	11766278	11796872	30594	male-specific lethal 3 homolog (Drosophila)
PA31176	10232	MSLN	chr16	800765	821865	21100	mesothelin
PA162396252	401827	MSLNL	chr16	816428	842926	26498	mesothelin-like
PA31177	4477	MSMB	chr10	51539553	51565517	25964	microseminoprotein, beta-
PA34955	6307	MSMO1	chr4	166238818	166267316	28498	methylsterol monooxygenase 1
PA164723190	692094	MSMP	chr9	35749987	35764274	14287	microseminoprotein, prostate associated
PA31178	4478	MSN	chrX	64798257	64964793	166536	moesin
PA31181	4481	MSR1	chr8	15962387	16060300	97913	macrophage scavenger receptor 1
PA31182	4482	MSRA	chr8	9901830	10289401	387571	methionine sulfoxide reductase A
PA134979691	22921	MSRB2	chr10	23374427	23413942	39515	methionine sulfoxide reductase B2
PA134991350	253827	MSRB3	chr12	65662423	65863687	201264	methionine sulfoxide reductase B3
PA134886837	118490	MSS51	chr10	75180337	75203319	22982	MSS51 mitochondrial translational activator
PA31185	4485	MST1	chr3	49718380	49736196	17816	macrophage stimulating 1 (hepatocyte growth factor-like)
PA31186	4486	MST1R	chr3	49921435	49951311	29876	macrophage stimulating 1 receptor (c-met-related tyrosine kinase)
PA162396253	2660	MSTN	chr2	190917426	190937455	20029	myostatin
PA142671313	55154	MSTO1	chr1	155569961	155587758	17797	misato 1, mitochondrial distribution and morphology regulator
PA31196	4487	MSX1	chr4	4851392	4868663	17271	msh homeobox 1
PA31197	4488	MSX2	chr5	174141575	174160902	19327	msh homeobox 2
PA31225	4512	MT-CO1	chrM	2	10447	10445	mitochondrially encoded cytochrome c oxidase I
PA31264	4539	MT-ND4L	chrM	472	13768	13296	mitochondrially encoded NADH dehydrogenase 4L
PA31266	4541	MT-ND6	chrM	11151	24675	13524	mitochondrially encoded NADH dehydrogenase 6
PA31198	4489	MT1A	chr16	56662578	56676999	14421	metallothionein 1A
PA31199	4490	MT1B	chr16	56675811	56690116	14305	metallothionein 1B
PA31202	4493	MT1E	chr16	56649557	56664024	14467	metallothionein 1E
PA31203	4494	MT1F	chr16	56681855	56696215	14360	metallothionein 1F
PA31204	4495	MT1G	chr16	56697653	56711977	14324	metallothionein 1G
PA31205	4496	MT1H	chr16	56693726	56708041	14315	metallothionein 1H
PA142671312	4499	MT1M	chr16	56656534	56670898	14364	metallothionein 1M
PA31213	4501	MT1X	chr16	56706382	56721108	14726	metallothionein 1X
PA31214	4502	MT2A	chr16	56632478	56646409	13931	metallothionein 2A
PA31216	4504	MT3	chr16	56613267	56628000	14733	metallothionein 3
PA38649	84560	MT4	chr16	56588961	56605869	16908	metallothionein 4
PA31218	9112	MTA1	chr14	105876186	105940066	63880	metastasis associated 1
PA31219	9219	MTA2	chr11	62357675	62379312	21637	metastasis associated 1 family, member 2
PA134953540	57504	MTA3	chr2	42711709	43014080	302371	metastasis associated 1 family, member 3
PA31220	4507	MTAP	chr9	21792635	21944040	151405	methylthioadenosine phosphorylase
PA31224	27085	MTBP	chr8	121447638	121538875	91237	MDM2 binding protein
PA134958992	23787	MTCH1	chr6	36932911	36964327	31416	mitochondrial carrier 1
PA134951260	23788	MTCH2	chr11	47635858	47674206	38348	mitochondrial carrier 2
PA164742098	4515	MTCP1	chrX	154289309	154309547	20238	mature T-cell proliferation 1
PA142671307	92140	MTDH	chr8	98646375	98745488	99113	metadherin
PA142671308	7978	MTERF1	chr7	91499021	91520016	20995	mitochondrial transcription termination factor 1
PA142671311	80298	MTERF2	chr12	107368069	107390929	22860	mitochondrial transcription termination factor 2
PA142671309	51001	MTERF3	chr8	97248645	97283796	35151	mitochondrial transcription termination factor 3
PA142671310	130916	MTERF4	chr2	242023509	242051747	28238	mitochondrial transcription termination factor 4
PA31235	4520	MTF1	chr1	38272239	38335292	63053	metal-regulatory transcription factor 1
PA128394586	22823	MTF2	chr1	93534792	93607638	72846	metal response element binding transcription factor 2
PA142671304	123263	MTFMT	chr15	65290850	65331977	41127	mitochondrial methionyl-tRNA formyltransferase
PA142671305	9650	MTFR1	chr8	66546888	66625798	78910	mitochondrial fission regulator 1
PA142671888	56181	MTFR1L	chr1	26136397	26162433	26036	mitochondrial fission regulator 1-like
PA134871105	113115	MTFR2	chr6	136549168	136581449	32281	mitochondrial fission regulator 2
PA142671306	92170	MTG1	chr10	135197621	135237174	39553	mitochondrial ribosome-associated GTPase 1
PA29059	26164	MTG2	chr20	60748081	60781624	33543	mitochondrial ribosome-associated GTPase 2
PA31236	4522	MTHFD1	chr14	64844754	64929725	84971	methylenetetrahydrofolate dehydrogenase (NADP+ dependent) 1, methenyltetrahydrofolate cyclohydrolase, formyltetrahydrofolate synthetase
PA134927803	25902	MTHFD1L	chr6	151176815	151426023	249208	methylenetetrahydrofolate dehydrogenase (NADP+ dependent) 1-like
PA31238	10797	MTHFD2	chr2	74415690	74445425	29735	methylenetetrahydrofolate dehydrogenase (NADP+ dependent) 2, methenyltetrahydrofolate cyclohydrolase
PA134943916	441024	MTHFD2L	chr4	74979019	75171816	192797	methylenetetrahydrofolate dehydrogenase (NADP+ dependent) 2-like
PA245	4524	MTHFR	chr1	11842787	11876160	33373	methylenetetrahydrofolate reductase (NAD(P)H)
PA31239	10588	MTHFS	chr15	80132889	80199627	66738	5,10-methenyltetrahydrofolate synthetase (5-formyltetrahydrofolate cyclo-ligase)
PA144596408	64779	MTHFSD	chr16	86560782	86598841	38059	methenyltetrahydrofolate synthetase domain containing
PA31243	4528	MTIF2	chr2	55460756	55506384	45628	mitochondrial translational initiation factor 2
PA162396264	219402	MTIF3	chr13	28006776	28034739	27963	mitochondrial translational initiation factor 3
PA31249	9633	MTL5	chr11	68471908	68528988	57080	metallothionein-like 5, testis-specific (tesmin)
PA31251	4534	MTM1	chrX	149721104	149844616	123512	myotubularin 1
PA31252	8776	MTMR1	chrX	149851837	149936575	84738	myotubularin related protein 1
PA128394676	54893	MTMR10	chr15	31217854	31293807	75953	myotubularin related protein 10
PA142671303	10903	MTMR11	chr1	149897543	149918791	21248	myotubularin related protein 11
PA128394670	54545	MTMR12	chr5	32224111	32323114	99003	myotubularin related protein 12
PA162396265	64419	MTMR14	chr3	9681117	9747078	65961	myotubularin related protein 14
PA31253	8898	MTMR2	chr11	95563044	95667371	104327	myotubularin related protein 2
PA31254	8897	MTMR3	chr22	30269149	30429857	160708	myotubularin related protein 3
PA31255	9110	MTMR4	chr17	56563893	56605271	41378	myotubularin related protein 4
PA31256	9107	MTMR6	chr13	25817339	25871704	54365	myotubularin related protein 6
PA31257	9108	MTMR7	chr8	17151306	17281040	129734	myotubularin related protein 7
PA134942633	55613	MTMR8	chrX	63484961	63625333	140372	myotubularin related protein 8
PA37904	66036	MTMR9	chr8	11132000	11188655	56655	myotubularin related protein 9
PA31267	4543	MTNR1A	chr4	187451809	187486537	34728	melatonin receptor 1A
PA31268	4544	MTNR1B	chr11	92692789	92718948	26159	melatonin receptor 1B
PA134974199	25821	MTO1	chr6	74161454	74214179	52725	mitochondrial tRNA translation optimization 1
PA28360	2475	MTOR	chr1	11163588	11332614	169026	mechanistic target of rapamycin (serine/threonine kinase)
PA164723192	55149	MTPAP	chr10	30595730	30648267	52537	mitochondrial poly(A) polymerase
PA31271	136319	MTPN	chr7	135608503	135672204	63701	myotrophin
PA31272	4548	MTR	chr1	236948581	237070281	121700	5-methyltetrahydrofolate-homocysteine methyltransferase
PA31273	9617	MTRF1	chr13	41787505	41847731	60226	mitochondrial translational release factor 1
PA134870441	54516	MTRF1L	chr6	153305400	153333925	28525	mitochondrial translational release factor 1-like
PA165432208	100462977	MTRNR2L1	chr17	22012437	22026991	14554	MT-RNR2-like 1
PA165757021	100463488	MTRNR2L10	chrX	55204824	55218944	14120	MT-RNR2-like 10
PA165392403	100462983	MTRNR2L3	chr20	55930496	55944878	14382	MT-RNR2-like 3
PA165450236	100463285	MTRNR2L4	chr16	3418053	3432283	14230	MT-RNR2-like 4
PA165548889	100463289	MTRNR2L5	chr10	57348750	57363488	14738	MT-RNR2-like 5
PA165548890	100288485	MTRNR2L7	chr10	37887366	37901859	14493	MT-RNR2-like 7
PA165543496	100463486	MTRNR2L8	chr11	10526434	10540723	14289	MT-RNR2-like 8
PA31277	4552	MTRR	chr5	7841299	7904237	62938	5-methyltetrahydrofolate-homocysteine methyltransferase reductase
PA134892011	9788	MTSS1	chr8	125560025	125750730	190705	metastasis suppressor 1
PA164723215	92154	MTSS1L	chr16	70692107	70729954	37847	metastasis suppressor 1-like
PA164742099	4547	MTTP	chr4	100475240	100548154	72914	microsomal triglyceride transfer protein
PA147358571	222166	MTURN	chr7	30164552	30205381	40829	maturin, neural progenitor differentiation regulator homolog (Xenopus)
PA134968054	57509	MTUS1	chr8	17498303	17668729	170426	microtubule associated tumor suppressor 1
PA165505194	23281	MTUS2	chr13	29384485	30083084	698599	microtubule associated tumor suppressor candidate 2
PA31306	4580	MTX1	chr1	155168490	155186625	18135	metaxin 1
PA31308	10651	MTX2	chr2	177124123	177205753	81630	metaxin 2
PA134924631	345778	MTX3	chr5	79269539	79297088	27549	metaxin 3
PA31309	4582	MUC1	chr1	155155300	155172768	17468	mucin 1, cell surface associated
PA31311	10071	MUC12	chr7	100602904	100665230	62326	mucin 12, cell surface associated
PA31312	56667	MUC13	chr3	124621289	124663595	42306	mucin 13, cell surface associated
PA31313	143662	MUC15	chr11	26577579	26603815	26236	mucin 15, cell surface associated
PA31314	94025	MUC16	chr19	8956516	9102018	145502	mucin 16, cell surface associated
PA31315	140453	MUC17	chr7	100653364	100705140	51776	mucin 17, cell surface associated
PA134898689	283463	MUC19	chr12	40916786	40936366	19580	mucin 19, oligomeric
PA31316	4583	MUC2	chr11	1064875	1107417	42542	mucin 2, oligomeric mucus/gel-forming
PA134939730	200958	MUC20	chr3	195406293	195470004	63711	mucin 20, cell surface associated
PA162396305	394263	MUC21	chr6	30941485	30960675	19190	mucin 21, cell surface associated
PA31317	4584	MUC3A	chr7	100537257	100614619	77362	mucin 3A, cell surface associated
PA31318	57876	MUC3B	chr7	100372566	100400623	28057	mucin 3B, cell surface associated
PA31319	4585	MUC4	chr3	195470636	195549148	78512	mucin 4, cell surface associated
PA31321	727897	MUC5B	chr11	1234295	1286406	52111	mucin 5B, oligomeric mucus/gel-forming
PA31322	4588	MUC6	chr11	1009824	1046706	36882	mucin 6, oligomeric mucus/gel-forming
PA31323	4589	MUC7	chr4	71286209	71351714	65505	mucin 7, secreted
PA162396316	118430	MUCL1	chr12	55238299	55255177	16878	mucin-like 1
PA162396329	79594	MUL1	chr1	20822941	20844674	21733	mitochondrial E3 ubiquitin protein ligase 1
PA164742142	84939	MUM1	chr19	1344976	1381430	36454	melanoma associated antigen (mutated) 1
PA134880222	139221	MUM1L1	chrX	105402298	105455949	53651	melanoma associated antigen (mutated) 1-like 1
PA164723237	347273	MURC	chr9	103330361	103353671	23310	muscle-related coiled-coil protein
PA134881809	80198	MUS81	chr11	65617872	65636914	19042	MUS81 structure-specific endonuclease subunit
PA31326	4593	MUSK	chr9	113420935	113569386	148451	muscle, skeletal, receptor tyrosine kinase
PA134991411	389125	MUSTN1	chr3	52864131	52879235	15104	musculoskeletal, embryonic nuclear protein 1
PA31327	4594	MUT	chr6	49395073	49441041	45968	methylmalonyl CoA mutase
PA31328	4595	MUTYH	chr1	45791914	45816142	24228	mutY homolog
PA162385826	93343	MVB12A	chr19	17506512	17539141	32629	multivesicular body subunit 12A
PA162385827	89853	MVB12B	chr9	129079123	129272320	193197	multivesicular body subunit 12B
PA31330	4597	MVD	chr16	88715343	88739495	24152	mevalonate (diphospho) decarboxylase
PA31331	4598	MVK	chr12	110001500	110038071	36571	mevalonate kinase
PA31332	9961	MVP	chr16	29821715	29862360	40645	major vault protein
PA31333	4599	MX1	chr21	42782520	42834141	51621	MX dynamin-like GTPase 1
PA31334	4600	MX2	chr21	42723918	42783870	59952	MX dynamin-like GTPase 2
PA30520	4084	MXD1	chr2	70132173	70173077	40904	MAX dimerization protein 1
PA134892226	83463	MXD3	chr5	176729501	176751096	21595	MAX dimerization protein 3
PA134914966	10608	MXD4	chr4	2246160	2273739	27579	MAX dimerization protein 4
PA31335	4601	MXI1	chr10	111957288	112050123	92835	MAX interactor 1, dimerization protein
PA31340	25878	MXRA5	chrX	3223606	3275133	51527	matrix-remodelling associated 5
PA31342	439921	MXRA7	chr17	74666748	74717056	50308	matrix-remodelling associated 7
PA31343	54587	MXRA8	chr1	1285071	1307183	22112	matrix-remodelling associated 8
PA31344	91663	MYADM	chr19	54359611	54382689	23078	myeloid-associated differentiation marker
PA164723246	255275	MYADML2	chr17	79894521	79915109	20588	myeloid-associated differentiation marker-like 2
PA31345	4602	MYB	chr6	135492453	135543311	50858	v-myb avian myeloblastosis viral oncogene homolog
PA31346	10514	MYBBP1A	chr17	4439191	4468921	29730	MYB binding protein (P160) 1a
PA31347	4603	MYBL1	chr8	67471410	67535484	64074	v-myb avian myeloblastosis viral oncogene homolog-like 1
PA31348	4605	MYBL2	chr20	42285659	42348136	62477	v-myb avian myeloblastosis viral oncogene homolog-like 2
PA31349	4604	MYBPC1	chr12	101978709	102082658	103949	myosin binding protein C, slow type
PA31350	4606	MYBPC2	chr19	50926160	50972583	46423	myosin binding protein C, fast type
PA31351	4607	MYBPC3	chr11	47349957	47384253	34296	myosin binding protein C, cardiac
PA31352	4608	MYBPH	chr1	203133939	203154969	21030	myosin binding protein H
PA147357579	343263	MYBPHL	chr1	109831987	109859663	27676	myosin binding protein H-like
PA31353	4609	MYC	chr8	128738315	128756680	18365	v-myc avian myelocytomatosis viral oncogene homolog
PA31354	26292	MYCBP	chr1	39325162	39349050	23888	MYC binding protein
PA134871126	23077	MYCBP2	chr13	77615792	77911177	295385	MYC binding protein 2, E3 ubiquitin protein ligase
PA134886355	84073	MYCBPAP	chr17	48575745	48611863	36118	MYCBP associated protein
PA31355	4610	MYCL	chr1	40358096	40377687	19591	v-myc avian myelocytomatosis viral oncogene lung carcinoma derived homolog
PA31359	4613	MYCN	chr2	16070683	16090129	19446	v-myc avian myelocytomatosis viral oncogene neuroblastoma derived homolog
PA134908917	80177	MYCT1	chr6	153009030	153048717	39687	myc target 1
PA31361	4615	MYD88	chr3	38169969	38187513	17544	myeloid differentiation primary response 88
PA134877084	50804	MYEF2	chr15	48428629	48480714	52085	myelin expression factor 2
PA31362	26579	MYEOV	chr11	69051613	69067754	16141	myeloma overexpressed
PA142671302	150678	MYEOV2	chr2	241062980	241085764	22784	myeloma overexpressed 2
PA31363	4617	MYF5	chr12	81100708	81116447	15739	myogenic factor 5
PA31364	4618	MYF6	chr12	81091408	81106257	14849	myogenic factor 6 (herculin)
PA31365	4619	MYH1	chr17	10392624	10431859	39235	myosin, heavy chain 1, skeletal muscle, adult
PA31366	4628	MYH10	chr17	8374523	8544094	169571	myosin, heavy chain 10, non-muscle
PA31367	4629	MYH11	chr16	15793992	15960887	166895	myosin, heavy chain 11, smooth muscle
PA31368	8735	MYH13	chr17	10198401	10286322	87921	myosin, heavy chain 13, skeletal muscle
PA134935217	79784	MYH14	chr19	50696885	50816801	119916	myosin, heavy chain 14, non-muscle
PA134958635	22989	MYH15	chr3	108096216	108258169	161953	myosin, heavy chain 15
PA31369	4620	MYH2	chr17	10421465	10463017	41552	myosin, heavy chain 2, skeletal muscle, adult
PA31370	4621	MYH3	chr17	10528843	10570626	41783	myosin, heavy chain 3, skeletal muscle, embryonic
PA31371	4622	MYH4	chr17	10343607	10382876	39269	myosin, heavy chain 4, skeletal muscle
PA31373	4624	MYH6	chr14	23846942	23888836	41894	myosin, heavy chain 6, cardiac muscle, alpha
PA31374	4625	MYH7	chr14	23878947	23914870	35923	myosin, heavy chain 7, cardiac muscle, beta
PA31375	57644	MYH7B	chr20	33533704	33593240	59536	myosin, heavy chain 7B, cardiac muscle, beta
PA31376	4626	MYH8	chr17	10290642	10335267	44625	myosin, heavy chain 8, skeletal muscle, perinatal
PA31377	4627	MYH9	chr22	36674323	36794107	119784	myosin, heavy chain 9, non-muscle
PA31379	4632	MYL1	chr2	211151868	211189895	38027	myosin, light chain 1, alkali; skeletal, fast
PA164723254	93408	MYL10	chr7	101253605	101282576	28971	myosin, light chain 10, regulatory
PA164723273	10627	MYL12A	chr18	3237472	3259234	21762	myosin, light chain 12A, regulatory, non-sarcomeric
PA164723274	103910	MYL12B	chr18	3252111	3281282	29171	myosin, light chain 12B, regulatory
PA31380	4633	MYL2	chr12	111345623	111368404	22781	myosin, light chain 2, regulatory, cardiac, slow
PA31381	4634	MYL3	chr3	46896357	46914973	18616	myosin, light chain 3, alkali; ventricular, skeletal, slow
PA31382	4635	MYL4	chr17	45256728	45304045	47317	myosin, light chain 4, alkali; atrial, embryonic
PA31383	4636	MYL5	chr4	659717	678822	19105	myosin, light chain 5, regulatory
PA31384	4637	MYL6	chr12	56542045	56558366	16321	myosin, light chain 6, alkali, smooth muscle and non-muscle
PA144596407	140465	MYL6B	chr12	56536040	56554771	18731	myosin, light chain 6B, alkali, smooth muscle and non-muscle
PA134939476	58498	MYL7	chr7	44175463	44190974	15511	myosin, light chain 7, regulatory
PA31387	10398	MYL9	chr20	35159887	35181226	21339	myosin, light chain 9, regulatory
PA134942677	29116	MYLIP	chr6	16119277	16151479	32202	myosin regulatory light chain interacting protein
PA31388	4638	MYLK	chr3	123328143	123613149	285006	myosin light chain kinase
PA31389	85366	MYLK2	chr20	30397115	30425500	28385	myosin light chain kinase 2
PA162396375	91807	MYLK3	chr16	46733194	46807201	74007	myosin light chain kinase 3
PA162396406	340156	MYLK4	chr6	2660863	2775615	114752	myosin light chain kinase family, member 4
PA164723287	29895	MYLPF	chr16	30376123	30392310	16187	myosin light chain, phosphorylatable, fast skeletal muscle
PA31393	55892	MYNN	chr3	169480619	169510504	29885	myoneurin
PA31394	4651	MYO10	chr5	16659016	16946385	287369	myosin X
PA31395	51168	MYO15A	chr17	18002020	18086116	84096	myosin XVA
PA162396437	23026	MYO16	chr13	109238500	109863355	624855	myosin XVI
PA134978348	399687	MYO18A	chr17	27397528	27517432	119904	myosin XVIIIA
PA38300	84700	MYO18B	chr22	26128117	26456345	328228	myosin XVIIIB
PA162396512	80179	MYO19	chr17	34848599	34901305	52706	myosin XIX
PA31397	4640	MYO1A	chr12	57419301	57454549	35248	myosin IA
PA31398	4430	MYO1B	chr2	192100107	192293115	193008	myosin IB
PA31399	4641	MYO1C	chr17	1364480	1406001	41521	myosin IC
PA31400	4642	MYO1D	chr17	30816628	31213902	397274	myosin ID
PA31401	4643	MYO1E	chr15	59425168	59675071	249903	myosin IE
PA31402	4542	MYO1F	chr19	8582674	8652331	69657	myosin IF
PA31403	64005	MYO1G	chr7	44999260	45028704	29444	myosin IG
PA31404	283446	MYO1H	chr12	109816439	109889176	72737	myosin IH
PA31405	53904	MYO3A	chr10	26213002	26504465	291463	myosin IIIA
PA31406	140469	MYO3B	chr2	171024655	171514674	490019	myosin IIIB
PA31407	4644	MYO5A	chr15	52596480	52831247	234767	myosin VA (heavy chain 12, myoxin)
PA31408	4645	MYO5B	chr18	47346156	47731542	385386	myosin VB
PA31409	55930	MYO5C	chr15	52481515	52597995	116480	myosin VC
PA31410	4646	MYO6	chr6	76448893	76632254	183361	myosin VI
PA31411	4647	MYO7A	chr11	76829302	76929286	99984	myosin VIIA
PA31412	4648	MYO7B	chr2	128283378	128398303	114925	myosin VIIB
PA31413	4649	MYO9A	chr15	72111632	72420440	308808	myosin IXA
PA31414	4650	MYO9B	chr19	17176591	17327104	150513	myosin IXB
PA31415	4653	MYOC	chr1	171601557	171631773	30216	myocilin, trabecular meshwork inducible glucocorticoid response
PA134946896	93649	MYOCD	chr17	12559207	12675266	116059	myocardin
PA31416	4654	MYOD1	chr11	17731110	17746678	15568	myogenic differentiation 1
PA164723288	26509	MYOF	chr10	95063186	95252190	189004	myoferlin
PA31417	4656	MYOG	chr1	203049257	203065166	15909	myogenin (myogenic factor 4)
PA31418	8736	MYOM1	chr18	3063805	3230106	166301	myomesin 1
PA31419	9172	MYOM2	chr8	1983082	2096380	113298	myomesin 2
PA134899390	127294	MYOM3	chr1	24379531	24448665	69134	myomesin 3
PA37064	9499	MYOT	chr5	137193536	137226540	33004	myotilin
PA31420	58529	MYOZ1	chr10	75388370	75411515	23145	myozenin 1
PA31421	51778	MYOZ2	chr4	120046939	120111944	65005	myozenin 2
PA38577	91977	MYOZ3	chr5	150030403	150061930	31527	myozenin 3
PA134944534	84665	MYPN	chr10	69855874	69974774	118900	myopalladin
PA164723403	339344	MYPOP	chr19	46390281	46415862	25581	Myb-related transcription factor, partner of profilin
PA25500	745	MYRF	chr11	61510121	61558990	48869	myelin regulatory factor
PA142672299	196446	MYRFL	chr12	70316322	70355504	39182	myelin regulatory factor-like
PA38800	25924	MYRIP	chr3	39840405	40304812	464407	myosin VIIA and Rab interacting protein
PA142671301	114803	MYSM1	chr1	59117411	59175747	58336	Myb-like, SWIRM and MPN domains 1
PA31426	4661	MYT1	chr20	62785827	62876606	90779	myelin transcription factor 1
PA31427	23040	MYT1L	chr2	1789885	2345147	555262	myelin transcription factor 1-like
PA37683	7593	MZF1	chr19	59070284	59095757	25473	myeloid zinc finger 1
PA165505227	440145	MZT1	chr13	73279495	73311938	32443	mitotic spindle organizing protein 1
PA165696923	653784	MZT2A	chr2	132224298	132260312	36014	mitotic spindle organizing protein 2A
PA165696943	80097	MZT2B	chr2	130929248	130965365	36117	mitotic spindle organizing protein 2B
PA162396561	9683	N4BP1	chr16	48569637	48654125	84488	NEDD4 binding protein 1
PA162396580	55728	N4BP2	chr4	40048524	40162872	114348	NEDD4 binding protein 2
PA162396617	90634	N4BP2L1	chr13	32971860	33012490	40630	NEDD4 binding protein 2-like 1
PA162396632	10443	N4BP2L2	chr13	33003625	33126839	123214	NEDD4 binding protein 2-like 2
PA162396656	29104	N6AMT1	chr21	30241513	30267695	26182	N-6 adenine-specific DNA methyltransferase 1 (putative)
PA162396671	221143	N6AMT2	chr13	21299036	21358095	59059	N-6 adenine-specific DNA methyltransferase 2 (putative)
PA38648	8260	NAA10	chrX	153192280	153210607	18327	N(alpha)-acetyltransferase 10, NatA catalytic subunit
PA165664264	84779	NAA11	chr4	80235272	80257171	21899	N(alpha)-acetyltransferase 11, NatA catalytic subunit
PA165664293	80155	NAA15	chr4	140212621	140314935	102314	N(alpha)-acetyltransferase 15, NatA auxiliary subunit
PA165505266	79612	NAA16	chr13	41875341	41954166	78825	N(alpha)-acetyltransferase 16, NatA auxiliary subunit
PA31449	51126	NAA20	chr20	19987934	20017273	29339	N(alpha)-acetyltransferase 20, NatB catalytic subunit
PA165513030	80018	NAA25	chr12	112461493	112556826	95333	N(alpha)-acetyltransferase 25, NatB auxiliary subunit
PA165479187	122830	NAA30	chr14	57847271	57882466	35195	N(alpha)-acetyltransferase 30, NatC catalytic subunit
PA165585932	60560	NAA35	chr9	88546009	88641350	95341	N(alpha)-acetyltransferase 35, NatC auxiliary subunit
PA142671503	84316	NAA38	chr7	117814086	117847093	33007	N(alpha)-acetyltransferase 38, NatC auxiliary subunit
PA165543497	79829	NAA40	chr11	63696442	63727799	31357	N(alpha)-acetyltransferase 40, NatD catalytic subunit
PA165697846	80218	NAA50	chr3	113432307	113475120	42813	N(alpha)-acetyltransferase 50, NatE catalytic subunit
PA164723438	79903	NAA60	chr16	3483611	3539963	56352	N(alpha)-acetyltransferase 60, NatF catalytic subunit
PA162396672	27163	NAAA	chr4	76828808	76872166	43358	N-acylethanolamine acid amidase
PA31430	10003	NAALAD2	chr11	89857772	89929062	71290	N-acetylated alpha-linked acidic dipeptidase 2
PA134867982	10004	NAALADL1	chr11	64809295	64836009	26714	N-acetylated alpha-linked acidic dipeptidase-like 1
PA142671295	254827	NAALADL2	chr3	174567095	175526428	959333	N-acetylated alpha-linked acidic dipeptidase-like 2
PA31431	4664	NAB1	chr2	191503621	191560492	56871	NGFI-A binding protein 1 (EGR1 binding protein 1)
PA31432	4665	NAB2	chr12	57472677	57492259	19582	NGFI-A binding protein 2 (EGR1 binding protein 2)
PA143485566	64859	NABP1	chr2	192532798	192556248	23450	nucleic acid binding protein 1
PA143485567	79035	NABP2	chr12	56605813	56626638	20825	nucleic acid binding protein 2
PA31433	4666	NACA	chr12	57103211	57129326	26115	nascent polypeptide-associated complex alpha subunit
PA162396699	342538	NACA2	chr17	59664794	59678563	13769	nascent polypeptide-associated complex alpha subunit 2
PA162396706	23148	NACAD	chr7	45117036	45138493	21457	NAC alpha domain containing
PA164723404	112939	NACC1	chr19	13218813	13254961	36148	nucleus accumbens associated 1, BEN and BTB (POZ) domain containing
PA164723421	138151	NACC2	chr9	138895383	138997131	101748	NACC family member 2, BEN and BTB (POZ) domain containing
PA142671298	65220	NADK	chr1	1679671	1721508	41837	NAD kinase
PA162380039	133686	NADK2	chr5	36189694	36252258	62564	NAD kinase 2, mitochondrial
PA142671299	55191	NADSYN1	chr11	71154217	71215586	61369	NAD synthetase 1
PA162396730	8883	NAE1	chr16	66833781	66874880	41099	NEDD8 activating enzyme E1 subunit 1
PA162396775	92345	NAF1	chr4	164044860	164098073	53213	nuclear assembly factor 1 ribonucleoprotein
PA31435	4668	NAGA	chr22	42451338	42476852	25514	N-acetylgalactosaminidase, alpha-
PA31436	55577	NAGK	chr2	71285408	71308998	23590	N-acetylglucosamine kinase
PA31437	4669	NAGLU	chr17	40677951	40699467	21516	N-acetylglucosaminidase, alpha
PA134940049	51172	NAGPA	chr16	5071845	5093942	22097	N-acetylglucosamine-1-phosphodiester alpha-N-acetylglucosaminidase
PA134968729	162417	NAGS	chr17	42072032	42089436	17404	N-acetylglutamate synthase
PA162396796	203245	NAIF1	chr9	130820512	130839600	19088	nuclear apoptosis inducing factor 1
PA162396805	4671	NAIP	chr5	70261310	70330941	69631	NLR family, apoptosis inhibitory protein
PA162396840	259232	NALCN	chr13	101703130	102078813	375683	sodium leak channel, non-selective
PA162396933	10135	NAMPT	chr7	105885731	105936373	50642	nicotinamide phosphoribosyltransferase
PA134864904	79923	NANOG	chr12	7931995	7951655	19660	Nanog homeobox
PA165513123	360030	NANOGNB	chr12	7907812	7929717	21905	NANOG neighbor homeobox
PA134876543	340719	NANOS1	chr10	120779228	120796854	17626	nanos homolog 1 (Drosophila)
PA134909776	339345	NANOS2	chr19	46413472	46428036	14564	nanos homolog 2 (Drosophila)
PA134867615	342977	NANOS3	chr19	13978063	13994571	16508	nanos homolog 3 (Drosophila)
PA25689	140838	NANP	chr20	25590571	25614648	24077	N-acetylneuraminic acid phosphatase
PA134978885	54187	NANS	chr9	100808959	100848365	39406	N-acetylneuraminic acid synthase
PA31439	4673	NAP1L1	chr12	76435672	76488738	53066	nucleosome assembly protein 1-like 1
PA31440	4674	NAP1L2	chrX	72429135	72444710	15575	nucleosome assembly protein 1-like 2
PA31441	4675	NAP1L3	chrX	92922925	92938682	15757	nucleosome assembly protein 1-like 3
PA31442	4676	NAP1L4	chr11	2962660	3023607	60947	nucleosome assembly protein 1-like 4
PA134921404	266812	NAP1L5	chr4	89614066	89629023	14957	nucleosome assembly protein 1-like 5
PA31443	8775	NAPA	chr19	47987891	48028515	40624	N-ethylmaleimide-sensitive factor attachment protein, alpha
PA31444	63908	NAPB	chr20	23352156	23412156	60000	N-ethylmaleimide-sensitive factor attachment protein, beta
PA162396960	222236	NAPEPLD	chr7	102737023	102801081	64058	N-acyl phosphatidylethanolamine phospholipase D
PA31445	8774	NAPG	chr18	10515873	10555766	39893	N-ethylmaleimide-sensitive factor attachment protein, gamma
PA142671293	93100	NAPRT	chr8	144653955	144670513	16558	nicotinate phosphoribosyltransferase
PA134891814	9476	NAPSA	chr19	50858734	50878931	20197	napsin A aspartic peptidase
PA142671294	26502	NARF	chr17	80405611	80449143	43532	nuclear prelamin A recognition factor
PA128394707	64428	NARFL	chr16	776753	800997	24244	nuclear prelamin A recognition factor-like
PA31447	4677	NARS	chr18	55264888	55299177	34289	asparaginyl-tRNA synthetase
PA143485554	79731	NARS2	chr11	78144007	78295909	151902	asparaginyl-tRNA synthetase 2, mitochondrial (putative)
PA31448	4678	NASP	chr1	46039660	46087578	47918	nuclear autoantigenic sperm protein (histone-binding)
PA17	9	NAT1	chr8	18017971	18084198	66227	N-acetyltransferase 1 (arylamine N-acetyltransferase)
PA143485555	55226	NAT10	chr11	34117111	34175581	58470	N-acetyltransferase 10 (GCN5-related)
PA162396977	57106	NAT14	chr19	55986557	56001935	15378	N-acetyltransferase 14 (GCN5-related, putative)
PA162380580	375607	NAT16	chr7	100810774	100833557	22783	N-acetyltransferase 16 (GCN5-related, putative)
PA18	10	NAT2	chr8	18238755	18261723	22968	N-acetyltransferase 2 (arylamine N-acetyltransferase)
PA134979782	24142	NAT6	chr3	50330833	50346852	16019	N-acetyltransferase 6 (GCN5-related)
PA31450	9027	NAT8	chr2	73864850	73879537	14687	N-acetyltransferase 8 (GCN5-related, putative)
PA162396985	339983	NAT8L	chr4	2051239	2073816	22577	N-acetyltransferase 8-like (GCN5-related, putative)
PA142671281	26151	NAT9	chr17	72763686	72782534	18848	N-acetyltransferase 9 (GCN5-related, putative)
PA164716941	256302	NATD1	chr17	21139183	21166578	27395	N-acetyltransferase domain containing 1
PA31451	89796	NAV1	chr1	201498243	201799102	300859	neuron navigator 1
PA31452	89797	NAV2	chr11	19362271	20146147	783876	neuron navigator 2
PA31453	89795	NAV3	chr12	78214685	78609790	395105	neuron navigator 3
PA164723457	51594	NBAS	chr2	15304032	15711472	407440	neuroblastoma amplified sequence
PA31454	26960	NBEA	chr13	35506424	36249874	743450	neurobeachin
PA24740	65065	NBEAL1	chr2	203869597	204094101	224504	neurobeachin-like 1
PA128394612	23218	NBEAL2	chr3	47011173	47054194	43021	neurobeachin-like 2
PA31456	4681	NBL1	chr1	19959723	19987949	28226	neuroblastoma 1, DAN family BMP antagonist
PA31457	4683	NBN	chr8	90942564	91006952	64388	nibrin
PA142671290	100132406	NBPF10	chr1	145283371	145371684	88313	neuroblastoma breakpoint family, member 10
PA142671291	200030	NBPF11	chr1	146029542	146092633	63091	neuroblastoma breakpoint family, member 11
PA142671273	25832	NBPF14	chr1	5343798	5423012	79214	neuroblastoma breakpoint family, member 14
PA142671274	284565	NBPF15	chr1	148545986	148599267	53281	neuroblastoma breakpoint family, member 15
PA142671275	728936	NBPF16	chr1	148729442	148761311	31869	neuroblastoma breakpoint family, member 16
PA165752039	728912	NBPF24	chr1	147571323	147634601	63278	neuroblastoma breakpoint family, member 24
PA142671283	84224	NBPF3	chr1	21756583	21814393	57810	neuroblastoma breakpoint family, member 3
PA142671284	148545	NBPF4	chr1	108762902	108796720	33818	neuroblastoma breakpoint family, member 4
PA142671286	653149	NBPF6	chr1	108982887	109016639	33752	neuroblastoma breakpoint family, member 6
PA142671288	728841	NBPF8	chr1	476609	542418	65809	neuroblastoma breakpoint family, member 8
PA142671289	400818	NBPF9	chr1	144801743	144833407	31664	neuroblastoma breakpoint family, member 9
PA30510	4077	NBR1	chr17	41312498	41366707	54209	neighbor of BRCA1 gene 1
PA31458	83988	NCALD	chr8	102695770	103147135	451365	neurocalcin delta
PA31459	4684	NCAM1	chr11	112821969	113152158	330189	neural cell adhesion molecule 1
PA31460	4685	NCAM2	chr21	22360633	22916892	556259	neural cell adhesion molecule 2
PA162396986	1463	NCAN	chr19	19312773	19366061	53288	neurocan
PA162397021	9918	NCAPD2	chr12	6592547	6644132	51585	non-SMC condensin I complex, subunit D2
PA162397090	23310	NCAPD3	chr11	134019337	134104426	85089	non-SMC condensin II complex, subunit D3
PA162397165	64151	NCAPG	chr4	17802436	17849488	47052	non-SMC condensin I complex, subunit G
PA162397212	54892	NCAPG2	chr7	158421002	158507520	86518	non-SMC condensin II complex, subunit G2
PA162397273	23397	NCAPH	chr2	96991479	97045833	54354	non-SMC condensin I complex, subunit H
PA162397314	29781	NCAPH2	chr22	50936645	50966209	29564	non-SMC condensin II complex, subunit H2
PA31461	4686	NCBP1	chr9	100385705	100439030	53325	nuclear cap binding protein subunit 1, 80kDa
PA31462	22916	NCBP2	chr3	196659273	196679464	20191	nuclear cap binding protein subunit 2, 20kDa
PA164723566	342897	NCCRP1	chr19	39677604	39695522	17918	non-specific cytotoxic cell receptor protein 1 homolog (zebrafish)
PA134963729	23154	NCDN	chr1	36013311	36035380	22069	neurochondrin
PA165697847	57552	NCEH1	chr3	172345435	172439207	93772	neutral cholesterol ester hydrolase 1
PA31463	653361	NCF1	chr7	74178309	74206720	28411	neutrophil cytosolic factor 1
PA31464	4688	NCF2	chr1	183521697	183570056	48359	neutrophil cytosolic factor 2
PA31465	4689	NCF4	chr22	37247030	37277059	30029	neutrophil cytosolic factor 4, 40kDa
PA31466	4690	NCK1	chr3	136571050	136673446	102396	NCK adaptor protein 1
PA31467	8440	NCK2	chr2	106351520	106513730	162210	NCK adaptor protein 2
PA31468	10787	NCKAP1	chr2	183786579	183913586	127007	NCK-associated protein 1
PA29239	3071	NCKAP1L	chr12	54881495	54939899	58404	NCK-associated protein 1-like
PA165696957	344148	NCKAP5	chr2	133426361	134409118	982757	NCK-associated protein 5
PA165513124	57701	NCKAP5L	chr12	50181929	50232208	50279	NCK-associated protein 5-like
PA134872724	51517	NCKIPSD	chr3	48697419	48733366	35947	NCK interacting protein with SH3 domain
PA31469	4691	NCL	chr2	232316459	232339208	22749	nucleolin
PA134898417	56926	NCLN	chr19	3175875	3212573	36698	nicalin
PA142672448	400746	NCMAP	chr1	24872567	24938819	66252	noncompact myelin associated protein
PA31470	8648	NCOA1	chr2	24704919	24996571	291652	nuclear receptor coactivator 1
PA31471	10499	NCOA2	chr8	71018997	71326062	307065	nuclear receptor coactivator 2
PA31472	8202	NCOA3	chr20	46120601	46288621	168020	nuclear receptor coactivator 3
PA31473	8031	NCOA4	chr10	51555108	51593734	38626	nuclear receptor coactivator 4
PA31474	57727	NCOA5	chr20	44686624	44728580	41956	nuclear receptor coactivator 5
PA31475	23054	NCOA6	chr20	33299578	33423433	123855	nuclear receptor coactivator 6
PA134905581	135112	NCOA7	chr6	126092307	126256176	163869	nuclear receptor coactivator 7
PA31477	9611	NCOR1	chr17	15930408	16128874	198466	nuclear receptor corepressor 1
PA31478	9612	NCOR2	chr12	124805957	125062079	256122	nuclear receptor corepressor 2
PA30495	9437	NCR1	chr19	55407504	55427454	19950	natural cytotoxicity triggering receptor 1
PA30496	9436	NCR2	chr6	41293528	41321625	28097	natural cytotoxicity triggering receptor 2
PA134883693	259197	NCR3	chr6	31553660	31570762	17102	natural cytotoxicity triggering receptor 3
PA38578	55410	NCRNA00185	chrY	21031387	21050114	18727	non-protein coding RNA 185
PA28371	23413	NCS1	chr9	132924857	133002583	77726	neuronal calcium sensor 1
PA142671271	23385	NCSTN	chr1	160303063	160331742	28679	nicastrin
PA142670764	55706	NDC1	chr1	54228133	54314225	86092	NDC1 transmembrane nucleoporin
PA162397359	10403	NDC80	chr18	2561510	2619634	58124	NDC80 kinetochore complex component
PA128394673	54820	NDE1	chr16	15727124	15823210	96086	nudE neurodevelopment protein 1
PA134887314	81565	NDEL1	chr17	8306447	8374495	68048	nudE neurodevelopment protein 1-like 1
PA134943402	80762	NDFIP1	chr5	141478324	141537008	58684	Nedd4 family interacting protein 1
PA134953250	54602	NDFIP2	chr13	80045259	80133212	87953	Nedd4 family interacting protein 2
PA31479	4692	NDN	chr15	23927554	23942450	14896	necdin, melanoma antigen (MAGE) family member
PA147358639	79625	NDNF	chr4	121953782	122003673	49891	neuron-derived neurotrophic factor
PA31480	56160	NDNL2	chr15	29557353	29572020	14667	necdin-like 2
PA134885020	27158	NDOR1	chr9	140090119	140116813	26694	NADPH dependent diflavin oxidoreductase 1
PA31481	4693	NDP	chrX	43805022	43842921	37899	Norrie disease (pseudoglioma)
PA31482	10397	NDRG1	chr8	134246414	134319835	73421	N-myc downstream regulated 1
PA31483	57447	NDRG2	chr14	21481922	21549098	67176	NDRG family member 2
PA31484	57446	NDRG3	chr20	35277169	35384541	107372	NDRG family member 3
PA31485	65009	NDRG4	chr16	58487549	58550523	62974	NDRG family member 4
PA31486	3340	NDST1	chr5	149855365	149940773	85408	N-deacetylase/N-sulfotransferase (heparan glucosaminyl) 1
PA31487	8509	NDST2	chr10	75558669	75581589	22920	N-deacetylase/N-sulfotransferase (heparan glucosaminyl) 2
PA31488	9348	NDST3	chr4	118945500	119182789	237289	N-deacetylase/N-sulfotransferase (heparan glucosaminyl) 3
PA134875549	64579	NDST4	chr4	115745931	116045032	299101	N-deacetylase/N-sulfotransferase (heparan glucosaminyl) 4
PA31489	4694	NDUFA1	chrX	118995734	119013629	17895	NADH dehydrogenase (ubiquinone) 1 alpha subcomplex, 1, 7.5kDa
PA31490	4705	NDUFA10	chr2	240893789	240974819	81030	NADH dehydrogenase (ubiquinone) 1 alpha subcomplex, 10, 42kDa
PA134914606	126328	NDUFA11	chr19	5888287	5914024	25737	NADH dehydrogenase (ubiquinone) 1 alpha subcomplex, 11, 14.7kDa
PA142671269	55967	NDUFA12	chr12	95362104	95407489	45385	NADH dehydrogenase (ubiquinone) 1 alpha subcomplex, 12
PA142671270	51079	NDUFA13	chr19	19616550	19642858	26308	NADH dehydrogenase (ubiquinone) 1 alpha subcomplex, 13
PA31491	4695	NDUFA2	chr5	140021948	140037370	15422	NADH dehydrogenase (ubiquinone) 1 alpha subcomplex, 2, 8kDa
PA31492	4696	NDUFA3	chr19	54596160	54613281	17121	NADH dehydrogenase (ubiquinone) 1 alpha subcomplex, 3, 9kDa
PA31493	4697	NDUFA4	chr7	10968580	10989813	21233	NDUFA4, mitochondrial complex associated
PA144596402	56901	NDUFA4L2	chr12	57625686	57644545	18859	NADH dehydrogenase (ubiquinone) 1 alpha subcomplex, 4-like 2
PA31494	4698	NDUFA5	chr7	123178083	123207958	29875	NADH dehydrogenase (ubiquinone) 1 alpha subcomplex, 5
PA31496	4700	NDUFA6	chr22	42478530	42496888	18358	NADH dehydrogenase (ubiquinone) 1 alpha subcomplex, 6, 14kDa
PA31497	4701	NDUFA7	chr19	8370492	8396452	25960	NADH dehydrogenase (ubiquinone) 1 alpha subcomplex, 7, 14.5kDa
PA31498	4702	NDUFA8	chr9	124891745	124932098	40353	NADH dehydrogenase (ubiquinone) 1 alpha subcomplex, 8, 19kDa
PA31499	4704	NDUFA9	chr12	4748264	4799720	51456	NADH dehydrogenase (ubiquinone) 1 alpha subcomplex, 9, 39kDa
PA31500	4706	NDUFAB1	chr16	23589335	23617639	28304	NADH dehydrogenase (ubiquinone) 1, alpha/beta subcomplex, 1, 8kDa
PA134934729	51103	NDUFAF1	chr15	41676547	41704658	28111	NADH dehydrogenase (ubiquinone) complex I, assembly factor 1
PA162397398	91942	NDUFAF2	chr5	60230956	60451864	220908	NADH dehydrogenase (ubiquinone) complex I, assembly factor 2
PA164723795	25915	NDUFAF3	chr3	49047908	49063928	16020	NADH dehydrogenase (ubiquinone) complex I, assembly factor 3
PA164723808	29078	NDUFAF4	chr6	97334187	97355767	21580	NADH dehydrogenase (ubiquinone) complex I, assembly factor 4
PA25780	79133	NDUFAF5	chr20	13755672	13802067	46395	NADH dehydrogenase (ubiquinone) complex I, assembly factor 5
PA142672357	137682	NDUFAF6	chr8	96027209	96118685	91476	NADH dehydrogenase (ubiquinone) complex I, assembly factor 6
PA162379266	55471	NDUFAF7	chr2	37448774	37479303	30529	NADH dehydrogenase (ubiquinone) complex I, assembly factor 7
PA31501	4707	NDUFB1	chr14	92579467	92598153	18686	NADH dehydrogenase (ubiquinone) 1 beta subcomplex, 1, 7kDa
PA31502	4716	NDUFB10	chr16	1999517	2014976	15459	NADH dehydrogenase (ubiquinone) 1 beta subcomplex, 10, 22kDa
PA134924203	54539	NDUFB11	chrX	46998615	47014609	15994	NADH dehydrogenase (ubiquinone) 1 beta subcomplex, 11, 17.3kDa
PA31503	4708	NDUFB2	chr7	140386481	140409446	22965	NADH dehydrogenase (ubiquinone) 1 beta subcomplex, 2, 8kDa
PA31504	4709	NDUFB3	chr2	201926462	201953473	27011	NADH dehydrogenase (ubiquinone) 1 beta subcomplex, 3, 12kDa
PA31510	4710	NDUFB4	chr3	120305128	120324258	19130	NADH dehydrogenase (ubiquinone) 1 beta subcomplex, 4, 15kDa
PA31511	4711	NDUFB5	chr3	179312575	179345288	32713	NADH dehydrogenase (ubiquinone) 1 beta subcomplex, 5, 16kDa
PA31512	4712	NDUFB6	chr9	32550524	32583182	32658	NADH dehydrogenase (ubiquinone) 1 beta subcomplex, 6, 17kDa
PA31513	4713	NDUFB7	chr19	14673890	14692889	18999	NADH dehydrogenase (ubiquinone) 1 beta subcomplex, 7, 18kDa
PA31514	4714	NDUFB8	chr10	102280497	102299640	19143	NADH dehydrogenase (ubiquinone) 1 beta subcomplex, 8, 19kDa
PA31515	4715	NDUFB9	chr8	125541343	125583751	42408	NADH dehydrogenase (ubiquinone) 1 beta subcomplex, 9, 22kDa
PA31516	4717	NDUFC1	chr4	140208071	140233705	25634	NADH dehydrogenase (ubiquinone) 1, subcomplex unknown, 1, 6kDa
PA31517	4718	NDUFC2	chr11	77776393	77801265	24872	NADH dehydrogenase (ubiquinone) 1, subcomplex unknown, 2, 14.5kDa
PA31518	4719	NDUFS1	chr2	206984803	207034243	49440	NADH dehydrogenase (ubiquinone) Fe-S protein 1, 75kDa (NADH-coenzyme Q reductase)
PA31519	4720	NDUFS2	chr1	161157209	161187185	29976	NADH dehydrogenase (ubiquinone) Fe-S protein 2, 49kDa (NADH-coenzyme Q reductase)
PA31520	4722	NDUFS3	chr11	47590562	47609115	18553	NADH dehydrogenase (ubiquinone) Fe-S protein 3, 30kDa (NADH-coenzyme Q reductase)
PA31521	4724	NDUFS4	chr5	52846464	52982171	135707	NADH dehydrogenase (ubiquinone) Fe-S protein 4, 18kDa (NADH-coenzyme Q reductase)
PA31522	4725	NDUFS5	chr1	39481967	39503308	21341	NADH dehydrogenase (ubiquinone) Fe-S protein 5, 15kDa (NADH-coenzyme Q reductase)
PA31523	4726	NDUFS6	chr5	1791496	1819165	27669	NADH dehydrogenase (ubiquinone) Fe-S protein 6, 13kDa (NADH-coenzyme Q reductase)
PA31524	374291	NDUFS7	chr19	1373526	1398588	25062	NADH dehydrogenase (ubiquinone) Fe-S protein 7, 20kDa (NADH-coenzyme Q reductase)
PA31525	4728	NDUFS8	chr11	67788084	67807114	19030	NADH dehydrogenase (ubiquinone) Fe-S protein 8, 23kDa (NADH-coenzyme Q reductase)
PA31526	4723	NDUFV1	chr11	67364323	67383012	18689	NADH dehydrogenase (ubiquinone) flavoprotein 1, 51kDa
PA31527	4729	NDUFV2	chr18	9092628	9137343	44715	NADH dehydrogenase (ubiquinone) flavoprotein 2, 24kDa
PA31529	4731	NDUFV3	chr21	44303378	44332773	29395	NADH dehydrogenase (ubiquinone) flavoprotein 3, 10kDa
PA31530	4703	NEB	chr2	152338853	152601001	262148	nebulin
PA134981177	10529	NEBL	chr10	21065900	21473116	407216	nebulette
PA162397411	64168	NECAB1	chr8	91793921	91974630	180709	N-terminal EF-hand calcium binding protein 1
PA162397412	54550	NECAB2	chr16	83992237	84039379	47142	N-terminal EF-hand calcium binding protein 2
PA24871	63941	NECAB3	chr20	32241893	32272264	30371	N-terminal EF-hand calcium binding protein 3
PA142671267	25977	NECAP1	chr12	8224807	8253373	28566	NECAP endocytosis associated 1
PA142671268	55707	NECAP2	chr1	16757167	16789585	32418	NECAP endocytosis associated 2
PA31531	121441	NEDD1	chr12	97291001	97350474	59473	neural precursor cell expressed, developmentally down-regulated 1
PA31533	4734	NEDD4	chr15	56116120	56295835	179715	neural precursor cell expressed, developmentally down-regulated 4, E3 ubiquitin protein ligase
PA31534	23327	NEDD4L	chr18	55701580	56071772	370192	neural precursor cell expressed, developmentally down-regulated 4-like, E3 ubiquitin protein ligase
PA31537	4738	NEDD8	chr14	24683057	24711576	28519	neural precursor cell expressed, developmentally down-regulated 8
PA31538	4739	NEDD9	chr6	11180531	11392581	212050	neural precursor cell expressed, developmentally down-regulated 9
PA31540	4744	NEFH	chr22	29866181	29890279	24098	neurofilament, heavy polypeptide
PA31542	4747	NEFL	chr8	24805468	24824383	18915	neurofilament, light polypeptide
PA162397442	4741	NEFM	chr8	24760712	24779607	18895	neurofilament, medium polypeptide
PA134862452	257194	NEGR1	chr1	71865625	72758533	892908	neuronal growth regulator 1
PA38334	79661	NEIL1	chr15	75629331	75650592	21261	nei endonuclease VIII-like 1 (E. coli)
PA38769	252969	NEIL2	chr8	11617172	11647854	30682	nei endonuclease VIII-like 2 (E. coli)
PA134889634	55247	NEIL3	chr4	178220991	178287092	66101	nei endonuclease VIII-like 3 (E. coli)
PA31545	4750	NEK1	chr4	170311421	170543778	232357	NIMA-related kinase 1
PA38594	152110	NEK10	chr3	27254097	27420912	166815	NIMA-related kinase 10
PA38595	79858	NEK11	chr3	130735694	131072309	336615	NIMA-related kinase 11
PA31546	4751	NEK2	chr1	211828598	211858972	30374	NIMA-related kinase 2
PA31547	4752	NEK3	chr13	52703779	52743996	40217	NIMA-related kinase 3
PA31548	6787	NEK4	chr3	52741796	52814965	73169	NIMA-related kinase 4
PA31549	341676	NEK5	chr13	52635898	52713214	77316	NIMA-related kinase 5
PA31550	10783	NEK6	chr9	127009885	127117721	107836	NIMA-related kinase 6
PA31551	140609	NEK7	chr1	198116108	198294550	178442	NIMA-related kinase 7
PA38361	284086	NEK8	chr17	27045822	27072784	26962	NIMA-related kinase 8
PA38593	91754	NEK9	chr14	75545818	75603778	57960	NIMA-related kinase 9
PA37371	7469	NELFA	chr4	1981441	2020962	39521	negative elongation factor complex member A
PA162382703	25920	NELFB	chr9	140139759	140171000	31241	negative elongation factor complex member B
PA38055	51497	NELFCD	chr20	57546263	57573400	27137	negative elongation factor complex member C/D
PA134974984	7936	NELFE	chr6	31916864	31936864	20000	negative elongation factor complex member E
PA31552	4745	NELL1	chr11	20681117	21600232	919115	NEL-like 1 (chicken)
PA31553	4753	NELL2	chr12	44899058	45317711	418653	NEL-like 2 (chicken)
PA35593	9147	NEMF	chr14	50247528	50329763	82235	nuclear export mediator factor
PA142671266	29937	NENF	chr1	212596229	212622721	26492	neudesin neurotrophic factor
PA31555	4756	NEO1	chr15	73334056	73600547	266491	neogenin 1
PA31556	10763	NES	chr1	156635555	156657189	21634	nestin
PA164742175	10276	NET1	chr10	5444514	5504019	59505	neuroepithelial cell transforming 1
PA31558	81832	NETO1	chr18	70406549	70544828	138279	neuropilin (NRP) and tolloid (TLL)-like 1
PA31559	81831	NETO2	chr16	47112431	47187936	75505	neuropilin (NRP) and tolloid (TLL)-like 2
PA31560	4758	NEU1	chr6	31823829	31840709	16880	sialidase 1 (lysosomal sialidase)
PA31561	4759	NEU2	chr2	233887382	233902767	15385	sialidase 2 (cytosolic sialidase)
PA31562	10825	NEU3	chr11	74689950	74721743	31793	sialidase 3 (membrane sialidase)
PA134917116	129807	NEU4	chr2	242739920	242761742	21822	sialidase 4
PA31563	9148	NEURL1	chr10	105243735	105355309	111574	neuralized E3 ubiquitin protein ligase 1
PA164723819	54492	NEURL1B	chr5	172058266	172121543	63277	neuralized E3 ubiquitin protein ligase 1B
PA25705	140825	NEURL2	chr20	44514111	44529926	15815	neuralized E3 ubiquitin protein ligase 2
PA164723835	84461	NEURL4	chr17	7215947	7242644	26697	neuralized E3 ubiquitin protein ligase 4
PA31564	4760	NEUROD1	chr2	182537833	182555392	17559	neuronal differentiation 1
PA31565	4761	NEUROD2	chr17	37757021	37774175	17154	neuronal differentiation 2
PA31566	58158	NEUROD4	chr12	55403729	55426801	23072	neuronal differentiation 4
PA31568	63974	NEUROD6	chr7	31374075	31390538	16463	neuronal differentiation 6
PA31569	4762	NEUROG1	chr5	134866972	134881639	14667	neurogenin 1
PA31570	63973	NEUROG2	chr4	113431672	113447328	15656	neurogenin 2
PA31571	50674	NEUROG3	chr10	71328791	71343210	14419	neurogenin 3
PA134974801	91624	NEXN	chr1	78344200	78415009	70809	nexilin (F actin binding protein)
PA31572	4763	NF1	chr17	29411945	29707695	295750	neurofibromin 1
PA31580	4771	NF2	chr22	29989545	30097589	108044	neurofibromin 2 (merlin)
PA134949664	150372	NFAM1	chr22	42773413	42843086	69673	NFAT activating protein with ITAM motif 1
PA128395771	23114	NFASC	chr1	204787782	204994950	207168	neurofascin
PA31581	10725	NFAT5	chr16	69589869	69741569	151700	nuclear factor of activated T-cells 5, tonicity-responsive
PA31582	4772	NFATC1	chr18	77145772	77292323	146551	nuclear factor of activated T-cells, cytoplasmic, calcineurin-dependent 1
PA31583	4773	NFATC2	chr20	50000494	50189370	188876	nuclear factor of activated T-cells, cytoplasmic, calcineurin-dependent 2
PA134887712	84901	NFATC2IP	chr16	28952318	28980786	28468	nuclear factor of activated T-cells, cytoplasmic, calcineurin-dependent 2 interacting protein
PA247	4775	NFATC3	chr16	68108654	68266162	157508	nuclear factor of activated T-cells, cytoplasmic, calcineurin-dependent 3
PA31584	4776	NFATC4	chr14	24824885	24851810	26925	nuclear factor of activated T-cells, cytoplasmic, calcineurin-dependent 4
PA31586	4778	NFE2	chr12	54682891	54728869	45978	nuclear factor, erythroid 2
PA31587	4779	NFE2L1	chr17	46115686	46141907	26221	nuclear factor, erythroid 2-like 1
PA31588	4780	NFE2L2	chr2	178092031	178139859	47828	nuclear factor, erythroid 2-like 2
PA31589	9603	NFE2L3	chr7	26181847	26229757	47910	nuclear factor, erythroid 2-like 3
PA31590	4774	NFIA	chr1	61532946	61931460	398514	nuclear factor I/A
PA31591	4781	NFIB	chr9	14078842	14408982	330140	nuclear factor I/B
PA31592	4782	NFIC	chr19	3349561	3472215	122654	nuclear factor I/C (CCAAT-binding transcription factor)
PA31593	4783	NFIL3	chr9	94168327	94196908	28581	nuclear factor, interleukin 3 regulated
PA31594	4784	NFIX	chr19	13096584	13212610	116026	nuclear factor I/X (CCAAT-binding transcription factor)
PA248	4790	NFKB1	chr4	103412486	103541459	128973	nuclear factor of kappa light polypeptide gene enhancer in B-cells 1
PA31600	4791	NFKB2	chr10	104143867	104165286	21419	nuclear factor of kappa light polypeptide gene enhancer in B-cells 2 (p49/p100)
PA31601	4792	NFKBIA	chr14	35867716	35883960	16244	nuclear factor of kappa light polypeptide gene enhancer in B-cells inhibitor, alpha
PA31602	4793	NFKBIB	chr19	39380340	39402534	22194	nuclear factor of kappa light polypeptide gene enhancer in B-cells inhibitor, beta
PA162397453	84807	NFKBID	chr19	36375854	36403205	27351	nuclear factor of kappa light polypeptide gene enhancer in B-cells inhibitor, delta
PA31603	4794	NFKBIE	chr6	44222903	44243525	20622	nuclear factor of kappa light polypeptide gene enhancer in B-cells inhibitor, epsilon
PA31604	4795	NFKBIL1	chr6	31504628	31529606	24978	nuclear factor of kappa light polypeptide gene enhancer in B-cells inhibitor-like 1
PA134990505	64332	NFKBIZ	chr3	101536834	101582869	46035	nuclear factor of kappa light polypeptide gene enhancer in B-cells inhibitor, zeta
PA31606	4798	NFRKB	chr11	129730670	129775490	44820	nuclear factor related to kappaB binding protein
PA31607	9054	NFS1	chr20	34253610	34297287	43677	NFS1 cysteine desulfurase
PA162397454	27247	NFU1	chr2	69620245	69674760	54515	NFU1 iron-sulfur cluster scaffold
PA31608	4799	NFX1	chr9	33280418	33374155	93737	nuclear transcription factor, X-box binding 1
PA38661	152518	NFXL1	chr4	47846250	47926684	80434	nuclear transcription factor, X-box binding-like 1
PA31609	4800	NFYA	chr6	41030707	41073146	42439	nuclear transcription factor Y, alpha
PA31610	4801	NFYB	chr12	104507858	104542040	34182	nuclear transcription factor Y, beta
PA31611	4802	NFYC	chr1	41147242	41240275	93033	nuclear transcription factor Y, gamma
PA31612	58157	NGB	chr14	77728834	77747655	18821	neuroglobin
PA134957933	25983	NGDN	chr14	23928898	23950402	21504	neuroguidin, EIF4E binding protein
PA31613	25791	NGEF	chr2	233740396	233887951	147555	neuronal guanine nucleotide exchange factor
PA162397475	4803	NGF	chr1	115825537	115890857	65320	nerve growth factor (beta polypeptide)
PA31615	4804	NGFR	chr17	47562655	47595382	32727	nerve growth factor receptor
PA31616	27018	NGFRAP1	chrX	102621268	102636001	14733	nerve growth factor receptor (TNFRSF16) associated protein 1
PA38462	55768	NGLY1	chr3	25757435	25841530	84095	N-glycanase 1
PA142671265	51335	NGRN	chr15	90798895	90818443	19548	neugrin, neurite outgrowth associated
PA144596401	79840	NHEJ1	chr2	219937046	220035587	98541	nonhomologous end-joining factor 1
PA31619	4807	NHLH1	chr1	160326861	160345638	18777	nescient helix loop helix 1
PA31620	4808	NHLH2	chr1	116375998	116393747	17749	nescient helix loop helix 2
PA134916338	378884	NHLRC1	chr6	18117718	18132851	15133	NHL repeat containing E3 ubiquitin protein ligase 1
PA134883896	374354	NHLRC2	chr10	115604391	115675265	70874	NHL repeat containing 2
PA162397544	387921	NHLRC3	chr13	39602448	39627246	24798	NHL repeat containing 3
PA165450302	283948	NHLRC4	chr16	607032	622495	15463	NHL repeat containing 4
PA164723898	55651	NHP2	chr5	177573464	177590961	17497	NHP2 ribonucleoprotein
PA31621	4809	NHP2L1	chr22	42066937	42095296	28359	NHP2 non-histone chromosome protein 2-like 1 (S. cerevisiae)
PA31622	4810	NHS	chrX	17383357	17757114	373757	Nance-Horan syndrome (congenital cataracts and dental anomalies)
PA134929320	57224	NHSL1	chr6	138740180	138903726	163546	NHS-like 1
PA162397561	340527	NHSL2	chrX	71120938	71366424	245486	NHS-like 2
PA31623	84276	NICN1	chr3	49456766	49476777	20011	nicolin 1
PA31625	4811	NID1	chr1	236136130	236238481	102351	nidogen 1
PA31626	22795	NID2	chr14	52468520	52545949	77429	nidogen 2 (osteonidogen)
PA31629	60491	NIF3L1	chr2	201744050	201771655	27605	NIF3 NGG1 interacting factor 3-like 1 (S. cerevisiae)
PA38470	84365	NIFK	chr2	122481521	122504503	22982	nucleolar protein interacting with the FHA domain of MKI67
PA31630	51199	NIN	chr14	51183481	51307839	124358	ninein (GSK3B interacting protein)
PA31631	4814	NINJ1	chr9	95880771	95906570	25799	ninjurin 1
PA31632	4815	NINJ2	chr12	670462	782755	112293	ninjurin 2
PA165392435	22981	NINL	chr20	25430333	25576167	145834	ninein-like
PA142671264	51388	NIP7	chr16	69363415	69380014	16599	NIP7, nucleolar pre-rRNA processing protein
PA134967361	123606	NIPA1	chr15	23040279	23096843	56564	non imprinted in Prader-Willi/Angelman syndrome 1
PA134911294	81614	NIPA2	chr15	23001684	23044427	42743	non imprinted in Prader-Willi/Angelman syndrome 2
PA164723925	152519	NIPAL1	chr4	48008791	48042084	33293	NIPA-like domain containing 1
PA164723926	79815	NIPAL2	chr8	99199054	99317444	118390	NIPA-like domain containing 2
PA164723927	57185	NIPAL3	chr1	24732245	24802473	70228	NIPA-like domain containing 3
PA164723956	348938	NIPAL4	chr5	156877027	156904730	27703	NIPA-like domain containing 4
PA134962343	25836	NIPBL	chr5	36866861	37068926	202065	Nipped-B homolog (Drosophila)
PA31634	8508	NIPSNAP1	chr22	29947797	29987326	39529	nipsnap homolog 1 (C. elegans)
PA134954501	25934	NIPSNAP3A	chr9	107499969	107525403	25434	nipsnap homolog 3A (C. elegans)
PA134947095	55335	NIPSNAP3B	chr9	107516022	107543045	27023	nipsnap homolog 3B (C. elegans)
PA31635	11188	NISCH	chr3	52479524	52530088	50564	nischarin
PA31636	4817	NIT1	chr1	161077862	161098235	20373	nitrilase 1
PA134882857	56954	NIT2	chr3	100043483	100078844	35361	nitrilase family, member 2
PA162397562	79570	NKAIN1	chr1	31649592	31722734	73142	Na+/K+ transporting ATPase interacting 1
PA162397563	154215	NKAIN2	chr6	124114991	125149786	1034795	Na+/K+ transporting ATPase interacting 2
PA162397582	286183	NKAIN3	chr8	63151501	63915211	763710	Na+/K+ transporting ATPase interacting 3
PA162397583	128414	NKAIN4	chr20	61869136	61895892	26756	Na+/K+ transporting ATPase interacting 4
PA162397584	79576	NKAP	chrX	119056013	119087735	31722	NFKB activating protein
PA162397607	222698	NKAPL	chr6	28217075	28231736	14661	NFKB activating protein-like
PA31637	85407	NKD1	chr16	50572241	50677771	105530	naked cuticle homolog 1 (Drosophila)
PA31638	85409	NKD2	chr5	998941	1041927	42986	naked cuticle homolog 2 (Drosophila)
PA31639	4818	NKG7	chr19	51871874	51885976	14102	natural killer cell granule protein 7
PA134958823	28512	NKIRAS1	chr3	23930552	23968537	37985	NFKB inhibitor interacting Ras-like 1
PA134968907	28511	NKIRAS2	chr17	40159594	40180659	21065	NFKB inhibitor interacting Ras-like 2
PA134993651	284353	NKPD1	chr19	45650008	45673408	23400	NTPase, KAP family P-loop domain containing 1
PA134990602	55922	NKRF	chrX	118719300	118749846	30546	NFKB repressing factor
PA31641	4820	NKTR	chr3	42632147	42693233	61086	natural killer cell triggering receptor
PA145148380	54729	NKX1-1	chr4	1393721	1410120	16399	NK1 homeobox 1
PA134977174	390010	NKX1-2	chr10	126132998	126148550	15552	NK1 homeobox 2
PA36531	7080	NKX2-1	chr14	36982602	37000894	18292	NK2 homeobox 1
PA31642	4821	NKX2-2	chr20	21488655	21504664	16009	NK2 homeobox 2
PA31643	159296	NKX2-3	chr10	101282690	101299281	16591	NK2 homeobox 3
PA31644	644524	NKX2-4	chr20	21373005	21388047	15042	NK2 homeobox 4
PA24202	1482	NKX2-5	chr5	172656107	172672315	16208	NK2 homeobox 5
PA145148392	137814	NKX2-6	chr8	23556964	23574111	17147	NK2 homeobox 6
PA38402	26257	NKX2-8	chr14	37046216	37061786	15570	NK2 homeobox 8
PA31645	4824	NKX3-1	chr8	23533206	23550450	17244	NK3 homeobox 1
PA162397617	579	NKX3-2	chr4	13539454	13556114	16660	NK3 homeobox 2
PA31646	4825	NKX6-1	chr4	85411436	85429387	17951	NK6 homeobox 1
PA134896334	84504	NKX6-2	chr10	134595320	134609537	14217	NK6 homeobox 2
PA145148400	157848	NKX6-3	chr8	41500829	41518011	17182	NK6 homeobox 3
PA142671263	54475	NLE1	chr17	33455368	33479322	23954	notchless homolog 1 (Drosophila)
PA31647	22871	NLGN1	chr3	173105570	174007434	901864	neuroligin 1
PA31648	57555	NLGN2	chr17	7301502	7326183	24681	neuroligin 2
PA31649	54413	NLGN3	chrX	70354681	70394682	40001	neuroligin 3
PA31650	57502	NLGN4X	chrX	5805067	6156916	351849	neuroligin 4, X-linked
PA38386	22829	NLGN4Y	chrY	16624488	16959825	335337	neuroligin 4, Y-linked
PA134914500	51701	NLK	chr17	26359009	26526407	167398	nemo-like kinase
PA31651	57486	NLN	chr5	65008023	65128111	120088	neurolysin (metallopeptidase M3 family)
PA162397626	197358	NLRC3	chr16	3586033	3637392	51359	NLR family, CARD domain containing 3
PA162397671	58484	NLRC4	chr2	32446518	32500812	54294	NLR family, CARD domain containing 4
PA162397694	84166	NLRC5	chr16	57013469	57120438	106969	NLR family, CARD domain containing 5
PA162397797	22861	NLRP1	chr17	5401719	5497832	96113	NLR family, pyrin domain containing 1
PA162397832	338322	NLRP10	chr11	7978156	7995059	16903	NLR family, pyrin domain containing 10
PA162397841	204801	NLRP11	chr19	56293763	56358128	64365	NLR family, pyrin domain containing 11
PA162397866	91662	NLRP12	chr19	54293838	54337657	43819	NLR family, pyrin domain containing 12
PA162397891	126204	NLRP13	chr19	56400058	56453702	53644	NLR family, pyrin domain containing 13
PA162397917	338323	NLRP14	chr11	7031700	7095757	64057	NLR family, pyrin domain containing 14
PA162397946	55655	NLRP2	chr19	55466652	55515510	48858	NLR family, pyrin domain containing 2
PA26512	114548	NLRP3	chr1	247569247	247615410	46163	NLR family, pyrin domain containing 3
PA162397947	147945	NLRP4	chr19	56337944	56396221	58277	NLR family, pyrin domain containing 4
PA162397970	126206	NLRP5	chr19	56501092	56576176	75084	NLR family, pyrin domain containing 5
PA162398002	171389	NLRP6	chr11	268570	288388	19818	NLR family, pyrin domain containing 6
PA162398003	199713	NLRP7	chr19	55431857	55487611	55754	NLR family, pyrin domain containing 7
PA162398028	126205	NLRP8	chr19	56449198	56502995	53797	NLR family, pyrin domain containing 8
PA162398029	338321	NLRP9	chr19	56216798	56259768	42970	NLR family, pyrin domain containing 9
PA162398052	79671	NLRX1	chr11	119029036	119057725	28689	NLR family member X1
PA31654	4828	NMB	chr15	85195360	85211802	16442	neuromedin B
PA31655	4829	NMBR	chr6	142393745	142419936	26191	neuromedin B receptor
PA134884140	51068	NMD3	chr3	160929050	160973082	44032	NMD3 ribosome export adaptor
PA249	4830	NME1	chr17	49220920	49242450	21530	NME/NM23 nucleoside diphosphate kinase 1
PA162398077	654364	NME1-NME2	chr17	49220897	49252105	31208	NME1-NME2 readthrough
PA250	4831	NME2	chr17	49232796	49252105	19309	NME/NM23 nucleoside diphosphate kinase 2
PA31656	4832	NME3	chr16	1817321	1831743	14422	NME/NM23 nucleoside diphosphate kinase 3
PA31657	4833	NME4	chr16	436752	453754	17002	NME/NM23 nucleoside diphosphate kinase 4
PA31658	8382	NME5	chr5	137447861	137485132	37271	NME/NM23 family member 5
PA134873104	10201	NME6	chr3	48332485	48353719	21234	NME/NM23 nucleoside diphosphate kinase 6
PA134962167	29922	NME7	chr1	169098258	169347186	248928	NME/NM23 family member 7
PA134925065	51314	NME8	chr7	37877930	37943003	65073	NME/NM23 family member 8
PA31659	9111	NMI	chr2	152123982	152156430	32448	N-myc (and STAT) interactor
PA31660	64802	NMNAT1	chr1	9993486	10048556	55070	nicotinamide nucleotide adenylyltransferase 1
PA25604	23057	NMNAT2	chr1	183214372	183397634	183262	nicotinamide nucleotide adenylyltransferase 2
PA134952303	349565	NMNAT3	chr3	139276022	139406885	130863	nicotinamide nucleotide adenylyltransferase 3
PA145007922	57407	NMRAL1	chr16	4508690	4534896	26206	NmrA-like family domain containing 1
PA134946592	54981	NMRK1	chr9	77673116	77713133	40017	nicotinamide riboside kinase 1
PA134938442	27231	NMRK2	chr19	3923101	3945414	22313	nicotinamide riboside kinase 2
PA142671260	129521	NMS	chr2	101076944	101102742	25798	neuromedin S
PA31661	4836	NMT1	chr17	43128322	43189384	61062	N-myristoyltransferase 1
PA31662	9397	NMT2	chr10	15144771	15220703	75932	N-myristoyltransferase 2
PA31663	10874	NMU	chr4	56458396	56512465	54069	neuromedin U
PA28910	10316	NMUR1	chr2	232384871	232405182	20311	neuromedin U receptor 1
PA31664	56923	NMUR2	chr5	151768102	151794840	26738	neuromedin U receptor 2
PA31665	4826	NNAT	chr20	36139607	36155092	15485	neuronatin
PA251	4837	NNMT	chr11	114156535	114186238	29703	nicotinamide N-methyltransferase
PA31667	23530	NNT	chr5	43592791	43708668	115877	nicotinamide nucleotide transhydrogenase
PA134878853	84273	NOA1	chr4	57826516	57853826	27310	nitric oxide associated 1
PA143485585	28987	NOB1	chr16	69772757	69798871	26114	NIN1/RPN12 binding protein 1 homolog (S. cerevisiae)
PA145007938	135935	NOBOX	chr7	144091333	144117320	25987	NOBOX oogenesis homeobox
PA142671261	26155	NOC2L	chr1	876583	904679	28096	nucleolar complex associated 2 homolog (S. cerevisiae)
PA134887727	64318	NOC3L	chr10	96089989	96132715	42726	nucleolar complex associated 3 homolog (S. cerevisiae)
PA142671262	79050	NOC4L	chr12	132618993	132639986	20993	nucleolar complex associated 4 homolog (S. cerevisiae)
PA162398098	10392	NOD1	chr7	30461143	30528426	67283	nucleotide-binding oligomerization domain containing 1
PA26074	64127	NOD2	chr16	50717507	50769990	52483	nucleotide-binding oligomerization domain containing 2
PA31669	4838	NODAL	chr10	72188692	72211465	22773	nodal growth differentiation factor
PA31670	9241	NOG	chr17	54661060	54675951	14891	noggin
PA142671257	79954	NOL10	chr2	10707892	10840113	132221	nucleolar protein 10
PA142671258	25926	NOL11	chr17	65703949	65743319	39370	nucleolar protein 11
PA145148362	79159	NOL12	chr22	38067680	38092718	25038	nucleolar protein 12
PA31673	8996	NOL3	chr16	67194400	67212640	18240	nucleolar protein 3 (apoptosis repressor with CARD domain)
PA31674	8715	NOL4	chr18	31428064	31813515	385451	nucleolar protein 4
PA25652	140688	NOL4L	chr20	31027862	31081288	53426	nucleolar protein 4-like
PA134979388	65083	NOL6	chr9	33458351	33483941	25590	nucleolar protein 6 (RNA-associated)
PA134881915	51406	NOL7	chr6	13602531	13636089	33558	nucleolar protein 7, 27kDa
PA134918056	55035	NOL8	chr9	95056640	95097876	41236	nucleolar protein 8
PA142671256	79707	NOL9	chr1	6578407	6624658	46251	nucleolar protein 9
PA31679	9221	NOLC1	chr10	103901933	103926627	24694	nucleolar and coiled-body phosphoprotein 1
PA25946	64434	NOM1	chr7	156732417	156768876	36459	nucleolar protein with MIF4G domain 1
PA134934458	23420	NOMO1	chr16	14917643	14993014	75371	NODAL modulator 1
PA134958124	283820	NOMO2	chr16	18508182	18583434	75252	NODAL modulator 2
PA134950400	408050	NOMO3	chr16	16316389	16391668	75279	NODAL modulator 3
PA31680	4841	NONO	chrX	70493042	70524018	30976	non-POU domain containing, octamer-binding
PA164723973	55505	NOP10	chr15	34630917	34645362	14445	NOP10 ribonucleoprotein
PA164723982	8602	NOP14	chr4	2936663	2975233	38570	NOP14 nucleolar protein
PA164724025	51491	NOP16	chr5	175807940	175825763	17823	NOP16 nucleolar protein
PA164724026	4839	NOP2	chr12	6663036	6687498	24462	NOP2 nucleolar protein
PA164724063	10528	NOP56	chr20	2623178	2642039	18861	NOP56 ribonucleoprotein
PA164724092	51602	NOP58	chr2	203120515	203171384	50869	NOP58 ribonucleoprotein
PA134867241	161424	NOP9	chr14	24759075	24780379	21304	NOP9 nucleolar protein
PA252	4842	NOS1	chr12	117642921	117809607	166686	nitric oxide synthase 1 (neuronal)
PA142671259	9722	NOS1AP	chr1	162029581	162342813	313232	nitric oxide synthase 1 (neuronal) adaptor protein
PA164724093	4843	NOS2	chr17	26080792	26137555	56763	nitric oxide synthase 2, inducible
PA254	4846	NOS3	chr7	150678144	150714687	36543	nitric oxide synthase 3 (endothelial cell)
PA134989259	51070	NOSIP	chr19	50055725	50093845	38120	nitric oxide synthase interacting protein
PA134992787	115677	NOSTRIN	chr2	169633049	169724849	91800	nitric oxide synthase trafficking
PA31683	4851	NOTCH1	chr9	139385896	139450238	64342	notch 1
PA31684	4853	NOTCH2	chr1	120451176	120649880	198704	notch 2
PA134983899	388677	NOTCH2NL	chr1	145166379	145289270	122891	notch 2 N-terminal like
PA31685	4854	NOTCH3	chr19	15267444	15321792	54348	notch 3
PA31686	4855	NOTCH4	chr6	32159620	32201844	42224	notch 4
PA134895171	344022	NOTO	chr2	73419386	73441340	21954	notochord homeobox
PA142671250	147111	NOTUM	chr17	79907383	79929057	21674	notum pectinacetylesterase homolog (Drosophila)
PA31687	4856	NOV	chr8	120418552	120439678	21126	nephroblastoma overexpressed
PA31688	4857	NOVA1	chr14	26912089	27077239	165150	neuro-oncological ventral antigen 1
PA31689	4858	NOVA2	chr19	46439771	46486657	46886	neuro-oncological ventral antigen 2
PA31690	27035	NOX1	chrX	100095313	100139334	44021	NADPH oxidase 1
PA31691	50508	NOX3	chr6	155713502	155787037	73535	NADPH oxidase 3
PA31692	50507	NOX4	chr11	89054521	89332779	278258	NADPH oxidase 4
PA31693	79400	NOX5	chr15	69212839	69352501	139662	NADPH oxidase, EF-hand calcium binding domain 5
PA35598	10811	NOXA1	chr9	140307847	140331858	24011	NADPH oxidase activator 1
PA134896072	124056	NOXO1	chr16	2025918	2041704	15786	NADPH oxidase organizer 1
PA134935429	122945	NOXRED1	chr14	77856827	77900225	43398	NADP-dependent oxidoreductase domain containing 1
PA25519	23742	NPAP1	chr15	24910541	24931593	21052	nuclear pore associated protein 1
PA31695	4861	NPAS1	chr19	47513077	47552033	38956	neuronal PAS domain protein 1
PA31696	4862	NPAS2	chr2	101426613	101616289	189676	neuronal PAS domain protein 2
PA134968746	64067	NPAS3	chr14	33394115	34276382	882267	neuronal PAS domain protein 3
PA142671254	266743	NPAS4	chr11	66178475	66197177	18702	neuronal PAS domain protein 4
PA31697	4863	NPAT	chr11	108025117	108103365	78248	nuclear protein, ataxia-telangiectasia locus
PA142671255	256933	NPB	chr17	79850072	79863781	13709	neuropeptide B
PA28912	2831	NPBWR1	chr8	53842468	53856454	13986	neuropeptides B/W receptor 1
PA28923	2832	NPBWR2	chr20	62734183	62748184	14001	neuropeptides B/W receptor 2
PA31698	4864	NPC1	chr18	21083148	21176581	93433	Niemann-Pick disease, type C1
PA31699	29881	NPC1L1	chr7	44549134	44590914	41780	NPC1-like 1
PA31700	10577	NPC2	chr14	74939900	74970084	30184	Niemann-Pick disease, type C2
PA31701	56654	NPDC1	chr9	139930909	139951147	20238	neural proliferation, differentiation and control, 1
PA31702	79716	NPEPL1	chr20	57254187	57293900	39713	aminopeptidase-like 1
PA31703	9520	NPEPPS	chr17	45590316	45703642	113326	aminopeptidase puromycin sensitive
PA31704	8620	NPFF	chr12	53897472	53911422	13950	neuropeptide FF-amide peptide precursor
PA134934991	64106	NPFFR1	chr10	72011713	72053450	41737	neuropeptide FF receptor 1
PA28918	10886	NPFFR2	chr4	72887521	73016918	129397	neuropeptide FF receptor 2
PA31706	4867	NPHP1	chr2	110877913	110972639	94726	nephronophthisis 1 (juvenile)
PA31708	27031	NPHP3	chr3	132396453	132451303	54850	nephronophthisis 3 (adolescent)
PA134927048	261734	NPHP4	chr1	5919870	6062618	142748	nephronophthisis 4
PA31709	4868	NPHS1	chr19	36313274	36352895	39621	nephrosis 1, congenital, Finnish type (nephrin)
PA31710	7827	NPHS2	chr1	179516674	179555086	38412	nephrosis 2, idiopathic, steroid-resistant (podocin)
PA31711	9284	NPIPA1	chr16	15017316	15048931	31615	nuclear pore complex interacting protein family, member A1
PA164724166	440348	NPIPB15	chr16	74401872	74429013	27141	nuclear pore complex interacting protein family, member B15
PA164724182	23117	NPIPB3	chr16	21410455	21446658	36203	nuclear pore complex interacting protein family, member B3
PA25602	80896	NPL	chr1	182748584	182802519	53935	N-acetylneuraminate pyruvate lyase (dihydrodipicolinate synthase)
PA143485558	55666	NPLOC4	chr17	79520913	79614138	93225	nuclear protein localization 4 homolog (S. cerevisiae)
PA31712	4869	NPM1	chr5	170804652	170840888	36236	nucleophosmin (nucleolar phosphoprotein B23, numatrin)
PA31732	10361	NPM2	chr8	21871621	21897408	25787	nucleophosmin/nucleoplasmin 2
PA31733	10360	NPM3	chr10	103538082	103553170	15088	nucleophosmin/nucleoplasmin 3
PA142671247	255743	NPNT	chr4	106806588	106895828	89240	nephronectin
PA256	4878	NPPA	chr1	11902766	11917840	15074	natriuretic peptide A
PA31734	4879	NPPB	chr1	11914521	11928992	14471	natriuretic peptide B
PA31735	4880	NPPC	chr2	232783805	232801038	17233	natriuretic peptide C
PA31736	4881	NPR1	chr1	153641093	153669468	28375	natriuretic peptide receptor 1
PA257	4882	NPR2	chr9	35779962	35812728	32766	natriuretic peptide receptor 2
PA31737	4883	NPR3	chr5	32700284	32794830	94546	natriuretic peptide receptor 3
PA165697981	10641	NPRL2	chr3	50381918	50398486	16568	nitrogen permease regulator-like 2 (S. cerevisiae)
PA25550	8131	NPRL3	chr16	132800	198697	65897	nitrogen permease regulator-like 3 (S. cerevisiae)
PA162398160	594857	NPS	chr10	129337613	129353935	16322	neuropeptide S
PA134951416	387129	NPSR1	chr7	34687897	34920944	233047	neuropeptide S receptor 1
PA134927704	27020	NPTN	chr15	73849344	73935753	86409	neuroplastin
PA31738	4884	NPTX1	chr17	78437633	78460404	22771	neuronal pentraxin I
PA31739	4885	NPTX2	chr7	98236597	98262181	25584	neuronal pentraxin II
PA31740	23467	NPTXR	chr22	39211456	39250017	38561	neuronal pentraxin receptor
PA162398161	64111	NPVF	chr7	25261189	25278105	16916	neuropeptide VF precursor
PA142671248	283869	NPW	chr16	2059521	2073756	14235	neuropeptide W
PA255	4852	NPY	chr7	24313807	24334484	20677	neuropeptide Y
PA258	4886	NPY1R	chr4	164242116	164275984	33868	neuropeptide Y receptor Y1
PA31741	4887	NPY2R	chr4	156084924	156141248	56324	neuropeptide Y receptor Y2
PA33692	5540	NPY4R	chr10	47073534	47091320	17786	neuropeptide Y receptor Y4
PA31742	4889	NPY5R	chr4	164255062	164276540	21478	neuropeptide Y receptor Y5
PA31744	1728	NQO1	chr16	69740304	69770849	30545	NAD(P)H dehydrogenase, quinone 1
PA31745	4835	NQO2	chr6	2990067	3022997	32930	NAD(P)H dehydrogenase, quinone 2
PA31746	190	NR0B1	chrX	30319539	30337495	17956	nuclear receptor subfamily 0, group B, member 1
PA31747	8431	NR0B2	chr1	27234975	27250567	15592	nuclear receptor subfamily 0, group B, member 2
PA31748	9572	NR1D1	chr17	38246037	38266978	20941	nuclear receptor subfamily 1, group D, member 1
PA31749	9975	NR1D2	chr3	23976751	24025109	48358	nuclear receptor subfamily 1, group D, member 2
PA31750	7376	NR1H2	chr19	50869680	50889285	19605	nuclear receptor subfamily 1, group H, member 2
PA31751	10062	NR1H3	chr11	47259851	47293584	33733	nuclear receptor subfamily 1, group H, member 3
PA31752	9971	NR1H4	chr12	100857486	100960645	103159	nuclear receptor subfamily 1, group H, member 4
PA378	8856	NR1I2	chr3	119489331	119555295	65964	nuclear receptor subfamily 1, group I, member 2
PA391	9970	NR1I3	chr1	161196456	161218432	21976	nuclear receptor subfamily 1, group I, member 3
PA31754	7181	NR2C1	chr12	95411005	95477404	66399	nuclear receptor subfamily 2, group C, member 1
PA31755	7182	NR2C2	chr3	14979091	15093780	114689	nuclear receptor subfamily 2, group C, member 2
PA162398172	126382	NR2C2AP	chr19	19309223	19324238	15015	nuclear receptor 2C2-associated protein
PA31756	7101	NR2E1	chr6	108477215	108513013	35798	nuclear receptor subfamily 2, group E, member 1
PA31757	10002	NR2E3	chr15	72092888	72113600	20712	nuclear receptor subfamily 2, group E, member 3
PA31758	7025	NR2F1	chr5	92909043	92933319	24276	nuclear receptor subfamily 2, group F, member 1
PA31759	7026	NR2F2	chr15	96859157	96886492	27335	nuclear receptor subfamily 2, group F, member 2
PA31760	2063	NR2F6	chr19	17339692	17366744	27052	nuclear receptor subfamily 2, group F, member 6
PA181	2908	NR3C1	chr5	142654496	143123322	468826	nuclear receptor subfamily 3, group C, member 1 (glucocorticoid receptor)
PA242	4306	NR3C2	chr4	148996915	149375850	378935	nuclear receptor subfamily 3, group C, member 2
PA31761	3164	NR4A1	chr12	52406616	52456291	49675	nuclear receptor subfamily 4, group A, member 1
PA31762	4929	NR4A2	chr2	157177944	157199287	21343	nuclear receptor subfamily 4, group A, member 2
PA31763	8013	NR4A3	chr9	102574137	102632173	58036	nuclear receptor subfamily 4, group A, member 3
PA31764	2516	NR5A1	chr9	127240515	127279769	39254	nuclear receptor subfamily 5, group A, member 1
PA31765	2494	NR5A2	chr1	199986730	200149552	162822	nuclear receptor subfamily 5, group A, member 2
PA31766	2649	NR6A1	chr9	127276554	127543589	267035	nuclear receptor subfamily 6, group A, member 1
PA31767	4892	NRAP	chr10	115345583	115433829	88246	nebulin-related anchoring protein
PA164724205	441478	NRARP	chr9	140191083	140206703	15620	NOTCH-regulated ankyrin repeat protein
PA31768	4893	NRAS	chr1	115244085	115269515	25430	neuroblastoma RAS viral (v-ras) oncogene homolog
PA134946285	29982	NRBF2	chr10	64883007	64917786	34779	nuclear receptor binding factor 2
PA31772	29959	NRBP1	chr2	27641473	27668126	26653	nuclear receptor binding protein 1
PA134891143	340371	NRBP2	chr8	144912755	144934200	21445	nuclear receptor binding protein 2
PA31773	4897	NRCAM	chr7	107785071	108106841	321770	neuronal cell adhesion molecule
PA31774	4898	NRD1	chr1	52251864	52354609	102745	nardilysin (N-arginine dibasic convertase)
PA134926790	55051	NRDE2	chr14	90741398	90808481	67083	NRDE-2, necessary for RNA interference, domain containing
PA128394547	9315	NREP	chr5	111062000	111322628	260628	neuronal regeneration related protein
PA31775	4899	NRF1	chr7	129241555	129399922	158367	nuclear respiratory factor 1
PA31776	3084	NRG1	chr8	31486820	32625558	1138738	neuregulin 1
PA31777	9542	NRG2	chr5	139223364	139432884	209520	neuregulin 2
PA31778	10718	NRG3	chr10	83625070	84749935	1124865	neuregulin 3
PA142671246	145957	NRG4	chr15	76231314	76314785	83471	neuregulin 4
PA31779	4900	NRGN	chr11	124599829	124620102	20273	neurogranin (protein kinase C substrate, RC3)
PA31780	8204	NRIP1	chr21	16330556	16448224	117668	nuclear receptor interacting protein 1
PA134978127	83714	NRIP2	chr12	2931514	2954372	22858	nuclear receptor interacting protein 2
PA25481	56675	NRIP3	chr11	8999123	9035596	36473	nuclear receptor interacting protein 3
PA134869113	203447	NRK	chrX	105056536	105205602	149066	Nik related kinase
PA31781	4901	NRL	chr14	24544902	24594223	49321	neural retina leucine zipper
PA31782	11270	NRM	chr6	30652824	30669197	16373	nurim (nuclear envelope membrane protein)
PA38477	51299	NRN1	chr6	5995232	6017838	22606	neuritin 1
PA162398187	123904	NRN1L	chr16	67908781	67923271	14490	neuritin 1-like
PA31783	8829	NRP1	chr10	33463419	33633833	170414	neuropilin 1
PA31784	8828	NRP2	chr2	206537184	206665857	128673	neuropilin 2
PA142671521	375387	NRROS	chr3	196356656	196391875	35219	negative regulator of reactive oxygen species
PA38254	140767	NRSN1	chr6	24116414	24150757	34343	neurensin 1
PA25805	80023	NRSN2	chr20	316789	338512	21723	neurensin 2
PA31785	4902	NRTN	chr19	5813818	5831335	17517	neurturin
PA31786	9378	NRXN1	chr2	50142643	51269674	1127031	neurexin 1
PA31787	9379	NRXN2	chr11	64370646	64500660	130014	neurexin 2
PA31788	9369	NRXN3	chr14	78626716	80337633	1710917	neurexin 3
PA165660390	10412	NSA2	chr5	74052816	74075737	22921	NSA2 ribosome biogenesis homolog (S. cerevisiae)
PA31790	64324	NSD1	chr5	176550026	176730214	180188	nuclear receptor binding SET domain protein 1
PA134959020	50814	NSDHL	chrX	151989511	152040907	51396	NAD(P) dependent steroid dehydrogenase-like
PA31793	4905	NSF	chr17	44658035	44837830	179795	N-ethylmaleimide-sensitive factor
PA31794	55968	NSFL1C	chr20	1419807	1458345	38538	NSFL1 (p97) cofactor (p47)
PA162398188	25936	NSL1	chr1	212896495	212975139	78644	NSL1, MIS12 kinetochore complex component
PA31795	8439	NSMAF	chr8	59493063	59582404	89341	neutral sphingomyelinase (N-SMase) activation associated factor
PA134943761	197370	NSMCE1	chr16	27233315	27290113	56798	non-SMC element 1 homolog (S. cerevisiae)
PA142672355	286053	NSMCE2	chr8	126094083	126382367	288284	non-SMC element 2, MMS21 homolog (S. cerevisiae)
PA162398205	54780	NSMCE4A	chr10	123713603	123744743	31140	non-SMC element 4 homolog A (S. cerevisiae)
PA134917144	26012	NSMF	chr9	140339022	140363808	24786	NMDA receptor synaptonuclear signaling and neuronal migration factor
PA142672171	84081	NSRP1	chr17	28433821	28516493	82672	nuclear speckle splicing regulatory protein 1
PA134953940	54888	NSUN2	chr5	6596352	6643473	47121	NOP2/Sun RNA methyltransferase family, member 2
PA134961151	63899	NSUN3	chr3	93771855	93848630	76775	NOP2/Sun domain family, member 3
PA134953046	387338	NSUN4	chr1	46795849	46833824	37975	NOP2/Sun domain family, member 4
PA134993779	55695	NSUN5	chr7	72713513	72732864	19351	NOP2/Sun domain family, member 5
PA143485559	155400	NSUN5P1	chr7	75029605	75049071	19466	NOP2/Sun domain family, member 5 pseudogene 1
PA143485560	260294	NSUN5P2	chr7	72415832	72435302	19470	NOP2/Sun domain family, member 5 pseudogene 2
PA134986220	221078	NSUN6	chr10	18831264	18958180	126916	NOP2/Sun domain family, member 6
PA145007896	79730	NSUN7	chr4	40741914	40815002	73088	NOP2/Sun domain family, member 7
PA31798	30833	NT5C	chr17	73123320	73137890	14570	5', 3'-nucleotidase, cytosolic
PA31799	84618	NT5C1A	chr1	40121793	40147710	25917	5'-nucleotidase, cytosolic IA
PA31800	93034	NT5C1B	chr2	18741137	18781359	40222	5'-nucleotidase, cytosolic IB
PA31801	22978	NT5C2	chr10	104844774	104963063	118289	5'-nucleotidase, cytosolic II
PA31802	51251	NT5C3A	chr7	33050725	33112409	61684	5'-nucleotidase, cytosolic IIIA
PA142671245	115024	NT5C3B	chr17	39978334	40002523	24189	5'-nucleotidase, cytosolic IIIB
PA134892962	221294	NT5DC1	chr6	116411999	116569853	157854	5'-nucleotidase domain containing 1
PA143485561	64943	NT5DC2	chr3	52555385	52579093	23708	5'-nucleotidase domain containing 2
PA143485562	51559	NT5DC3	chr12	104163081	104244975	81894	5'-nucleotidase domain containing 3
PA143485563	284958	NT5DC4	chr2	113470541	113492250	21709	5'-nucleotidase domain containing 4
PA31804	4907	NT5E	chr6	86149302	86208509	59207	5'-nucleotidase, ecto (CD73)
PA31805	56953	NT5M	chr17	17196680	17253977	57297	5',3'-nucleotidase, mitochondrial
PA134863573	123803	NTAN1	chr16	15128710	15159936	31226	N-terminal asparagine amidase
PA31806	4908	NTF3	chr12	5531280	5607465	76185	neurotrophin 3
PA162398206	4909	NTF4	chr19	49561323	49578333	17010	neurotrophin 4
PA31811	4913	NTHL1	chr16	2086816	2107931	21115	nth endonuclease III-like 1 (E. coli)
PA164724212	50863	NTM	chr11	131230371	132209716	979345	neurotrimin
PA162395788	28989	NTMT1	chr9	132361036	132400879	39843	N-terminal Xaa-Pro-Lys N-methyltransferase 1
PA31813	9423	NTN1	chr17	8914859	9150317	235458	netrin 1
PA164724231	4917	NTN3	chr16	2511500	2527146	15646	netrin 3
PA31815	59277	NTN4	chr12	96048583	96194565	145982	netrin 4
PA164724232	126147	NTN5	chr19	49161664	49186264	24600	netrin 5
PA164742200	22854	NTNG1	chr1	107672540	108027477	354937	netrin G1
PA134962540	84628	NTNG2	chr9	135027334	135121224	93890	netrin G2
PA142672508	84284	NTPCR	chr1	233076277	233117548	41271	nucleoside-triphosphatase, cancer-related
PA31817	4914	NTRK1	chr1	156775542	156854642	79100	neurotrophic tyrosine kinase, receptor, type 1
PA31818	4915	NTRK2	chr9	87273417	87644985	371568	neurotrophic tyrosine kinase, receptor, type 2
PA31819	4916	NTRK3	chr15	88416948	88810026	393078	neurotrophic tyrosine kinase, receptor, type 3
PA31820	4922	NTS	chr12	86258073	86279770	21697	neurotensin
PA31821	4923	NTSR1	chr20	61330189	61397123	66934	neurotensin receptor 1 (high affinity)
PA31822	23620	NTSR2	chr2	11795304	11820329	25025	neurotensin receptor 2
PA142671242	9891	NUAK1	chr12	106454125	106543811	89686	NUAK family, SNF1-like kinase, 1
PA142671243	81788	NUAK2	chr1	205268191	205300883	32692	NUAK family, SNF1-like kinase, 2
PA147357533	51667	NUB1	chr7	151028785	151078547	49762	negative regulator of ubiquitin-like proteins 1
PA31823	4682	NUBP1	chr16	10827643	10866208	38565	nucleotide binding protein 1
PA31824	10101	NUBP2	chr16	1822931	1842192	19261	nucleotide binding protein 2
PA134907818	80224	NUBPL	chr14	32020591	32333430	312839	nucleotide binding protein-like
PA31825	4924	NUCB1	chr19	49393307	49429540	36233	nucleobindin 1
PA31826	4925	NUCB2	chr11	17271884	17374510	102626	nucleobindin 2
PA142671244	64710	NUCKS1	chr1	205678947	205729372	50425	nuclear casein kinase and cyclin-dependent kinase substrate 1
PA31827	10726	NUDC	chr1	27238187	27276362	38175	nudC nuclear distribution protein
PA134985670	84955	NUDCD1	chr8	110250148	110356486	106338	NudC domain containing 1
PA134991349	134492	NUDCD2	chr5	162877586	162897143	19557	NudC domain containing 2
PA134989375	23386	NUDCD3	chr7	44418965	44540474	121509	NudC domain containing 3
PA31830	4521	NUDT1	chr7	2271857	2293780	21923	nudix (nucleoside diphosphate linked moiety X)-type motif 1
PA31831	170685	NUDT10	chrX	51065083	51083377	18294	nudix (nucleoside diphosphate linked moiety X)-type motif 10
PA31832	55190	NUDT11	chrX	51229863	51249459	19596	nudix (nucleoside diphosphate linked moiety X)-type motif 11
PA38699	83594	NUDT12	chr5	102881556	102908493	26937	nudix (nucleoside diphosphate linked moiety X)-type motif 12
PA38700	25961	NUDT13	chr10	74860133	74894583	34450	nudix (nucleoside diphosphate linked moiety X)-type motif 13
PA134971372	256281	NUDT14	chr14	105636274	105657660	21386	nudix (nucleoside diphosphate linked moiety X)-type motif 14
PA134963132	55270	NUDT15	chr13	48601703	48624282	22579	nudix (nucleoside diphosphate linked moiety X)-type motif 15
PA134955224	131870	NUDT16	chr3	131090515	131110674	20159	nudix (nucleoside diphosphate linked moiety X)-type motif 16
PA134977238	84309	NUDT16L1	chr16	4733526	4748860	15334	nudix (nucleoside diphosphate linked moiety X)-type motif 16-like 1
PA144596399	152195	NUDT16P1	chr3	131070689	131086966	16277	nudix (nucleoside diphosphate linked moiety X)-type motif 16 pseudogene 1
PA134890899	200035	NUDT17	chr1	145583491	145599435	15944	nudix (nucleoside diphosphate linked moiety X)-type motif 17
PA142671238	79873	NUDT18	chr8	21961383	21976932	15549	nudix (nucleoside diphosphate linked moiety X)-type motif 18
PA142671239	390916	NUDT19	chr19	33147186	33207702	60516	nudix (nucleoside diphosphate linked moiety X)-type motif 19
PA31833	318	NUDT2	chr9	34319504	34346711	27207	nudix (nucleoside diphosphate linked moiety X)-type motif 2
PA26845	11051	NUDT21	chr16	56460048	56495261	35213	nudix (nucleoside diphosphate linked moiety X)-type motif 21
PA142671240	84304	NUDT22	chr11	63983730	64000491	16761	nudix (nucleoside diphosphate linked moiety X)-type motif 22
PA31834	11165	NUDT3	chr6	34251971	34370457	118486	nudix (nucleoside diphosphate linked moiety X)-type motif 3
PA31835	11163	NUDT4	chr12	93761701	93800024	38323	nudix (nucleoside diphosphate linked moiety X)-type motif 4
PA31838	11164	NUDT5	chr10	12206573	12248143	41570	nudix (nucleoside diphosphate linked moiety X)-type motif 5
PA31839	11162	NUDT6	chr4	123810799	123854159	43360	nudix (nucleoside diphosphate linked moiety X)-type motif 6
PA31840	283927	NUDT7	chr16	77746389	77812332	65943	nudix (nucleoside diphosphate linked moiety X)-type motif 7
PA31841	254552	NUDT8	chr11	67392409	67407408	14999	nudix (nucleoside diphosphate linked moiety X)-type motif 8
PA31842	53343	NUDT9	chr4	88333728	88383606	49878	nudix (nucleoside diphosphate linked moiety X)-type motif 9
PA162398215	83540	NUF2	chr1	163281723	163328553	46830	NUF2, NDC80 kinetochore complex component
PA31843	26747	NUFIP1	chr13	45510384	45573613	63229	nuclear fragile X mental retardation protein interacting protein 1
PA143485564	57532	NUFIP2	chr17	27579854	27631166	51312	nuclear fragile X mental retardation protein interacting protein 2
PA162380784	389643	NUGGC	chr8	27876481	27951431	74950	nuclear GTPase, germinal center associated
PA31844	4926	NUMA1	chr11	71710910	71801732	90822	nuclear mitotic apparatus protein 1
PA31845	8650	NUMB	chr14	73738858	73935288	196430	numb homolog (Drosophila)
PA31846	9253	NUMBL	chr19	41168810	41206556	37746	numb homolog (Drosophila)-like
PA134890486	57122	NUP107	chr12	69070731	69139473	68742	nucleoporin 107kDa
PA31847	55746	NUP133	chr1	229574044	229654088	80044	nucleoporin 133kDa
PA31848	9972	NUP153	chr6	17612266	17717065	104799	nucleoporin 153kDa
PA31849	9631	NUP155	chr5	37288735	37381228	92493	nucleoporin 155kDa
PA31850	23279	NUP160	chr11	47796670	47880057	83387	nucleoporin 160kDa
PA134908952	23511	NUP188	chr9	131699972	131772375	72403	nucleoporin 188kDa
PA38624	23165	NUP205	chr7	135232662	135336501	103839	nucleoporin 205kDa
PA128394614	23225	NUP210	chr3	13354730	13471819	117089	nucleoporin 210kDa
PA134984604	91181	NUP210L	chr1	153962166	154137592	175426	nucleoporin 210kDa-like
PA31851	8021	NUP214	chr9	133990948	134113057	122109	nucleoporin 214kDa
PA134861481	129401	NUP35	chr2	183972247	184029408	57161	nucleoporin 35kDa
PA134948997	79023	NUP37	chr12	102464967	102524025	59058	nucleoporin 37kDa
PA134930788	348995	NUP43	chr6	150042457	150077688	35231	nucleoporin 43kDa
PA31852	10762	NUP50	chr22	45549726	45586892	37166	nucleoporin 50kDa
PA31853	53371	NUP54	chr4	77032812	77079668	46856	nucleoporin 54kDa
PA31854	23636	NUP62	chr19	50407082	50442988	35906	nucleoporin 62kDa
PA145148360	54830	NUP62CL	chrX	106363657	106459670	96013	nucleoporin 62kDa C-terminal like
PA142671241	79902	NUP85	chr17	73191597	73234854	43257	nucleoporin 85kDa
PA31855	4927	NUP88	chr17	5286346	5333400	47054	nucleoporin 88kDa
PA134912759	9688	NUP93	chr16	56754017	56885637	131620	nucleoporin 93kDa
PA31856	4928	NUP98	chr11	3693240	3829022	135782	nucleoporin 98kDa
PA134981903	9818	NUPL1	chr13	25865222	25919561	54339	nucleoporin like 1
PA134990469	11097	NUPL2	chr7	23211446	23243630	32184	nucleoporin like 2
PA165450395	26471	NUPR1	chr16	28545662	28560495	14833	nuclear protein, transcriptional regulator, 1
PA162398248	116150	NUS1	chr6	117986617	118034890	48273	nuclear undecaprenyl pyrophosphate synthase 1 homolog (S. cerevisiae)
PA134987502	51203	NUSAP1	chr15	41614892	41676248	61356	nucleolar and spindle associated protein 1
PA38365	10204	NUTF2	chr16	67870819	67909470	38651	nuclear transport factor 2
PA162378206	256646	NUTM1	chr15	34625458	34652936	27478	NUT midline carcinoma, family member 1
PA134875735	728118	NUTM2A	chr10	88973616	88998645	25029	NUT family member 2A
PA134908712	729262	NUTM2B	chr10	81450192	81475722	25530	NUT family member 2B
PA134912178	728130	NUTM2D	chr10	89107477	89133452	25975	NUT family member 2D
PA134988973	283008	NUTM2E	chr10	81591114	81613632	22518	NUT family member 2E
PA134981634	54754	NUTM2F	chr9	97077478	97100926	23448	NUT family member 2F
PA134899635	441457	NUTM2G	chr9	99681286	99707572	26286	NUT family member 2G
PA31857	4931	NVL	chr1	224412036	224527891	115855	nuclear VCP-like
PA162398263	284434	NWD1	chr19	16820787	16931774	110987	NACHT and WD repeat domain containing 1
PA145148614	57495	NWD2	chr4	37236690	37454087	217397	NACHT and WD repeat domain containing 2
PA31858	10482	NXF1	chr11	62556597	62582964	26367	nuclear RNA export factor 1
PA31859	56001	NXF2	chrX	101492094	101584634	92540	nuclear RNA export factor 2
PA162398310	728343	NXF2B	chrX	101612316	101704929	92613	nuclear RNA export factor 2B
PA31860	56000	NXF3	chrX	102327749	102358022	30273	nuclear RNA export factor 3
PA31862	55998	NXF5	chrX	101084085	101122549	38464	nuclear RNA export factor 5
PA31863	64359	NXN	chr17	699553	893017	193464	nucleoredoxin
PA162398383	115861	NXNL1	chr19	17563234	17581725	18491	nucleoredoxin-like 1
PA162398384	158046	NXNL2	chr9	91139203	91193704	54501	nucleoredoxin-like 2
PA134910690	120400	NXPE1	chr11	114389423	114440580	51157	neurexophilin and PC-esterase domain family, member 1
PA134861439	120406	NXPE2	chr11	114539200	114582357	43157	neurexophilin and PC-esterase domain family, member 2
PA134977295	91775	NXPE3	chr3	101488029	101550075	62046	neurexophilin and PC-esterase domain family, member 3
PA134871713	54827	NXPE4	chr11	114438313	114476484	38171	neurexophilin and PC-esterase domain family, member 4
PA134961263	30010	NXPH1	chr7	8463585	8795593	332008	neurexophilin 1
PA31864	11249	NXPH2	chr2	139423727	139547811	124084	neurexophilin 2
PA31865	11248	NXPH3	chr17	47643298	47664172	20874	neurexophilin 3
PA31866	11247	NXPH4	chr12	57600578	57623232	22654	neurexophilin 4
PA31867	29107	NXT1	chr20	23321373	23338408	17035	nuclear transport factor 2-like export factor 1
PA134928861	55916	NXT2	chrX	108769010	108790927	21917	nuclear transport factor 2-like export factor 2
PA162380561	222950	NYAP1	chr7	100071550	100095425	23875	neuronal tyrosine-phosphorylated phosphoinositide-3-kinase adaptor 1
PA165696738	57624	NYAP2	chr2	226254426	226521734	267308	neuronal tyrosine-phosphorylated phosphoinositide-3-kinase adaptor 2
PA165479228	57523	NYNRIN	chr14	24857992	24891494	33502	NYN domain and retroviral integrase containing
PA31871	60506	NYX	chrX	41296713	41337905	41192	nyctalopin
PA142671234	220323	OAF	chr11	120071747	120103650	31903	OAF homolog (Drosophila)
PA134879529	221443	OARD1	chr6	41031526	41050207	18681	O-acyl-ADP-ribose deacylase 1
PA31875	4938	OAS1	chr12	113334739	113360712	25973	2'-5'-oligoadenylate synthetase 1, 40/46kDa
PA31876	4939	OAS2	chr12	113406274	113452528	46254	2'-5'-oligoadenylate synthetase 2, 69/71kDa
PA31877	4940	OAS3	chr12	113366249	113414056	47807	2'-5'-oligoadenylate synthetase 3, 100kDa
PA31879	8638	OASL	chr12	121455095	121487045	31950	2'-5'-oligoadenylate synthetase-like
PA31880	4942	OAT	chr10	126082872	126117545	34673	ornithine aminotransferase
PA31884	4946	OAZ1	chr19	2259520	2276487	16967	ornithine decarboxylase antizyme 1
PA31885	4947	OAZ2	chr15	64976773	65005462	28689	ornithine decarboxylase antizyme 2
PA31886	51686	OAZ3	chr1	151725445	151746806	21361	ornithine decarboxylase antizyme 3
PA134987118	79991	OBFC1	chr10	105634316	105688045	53729	oligonucleotide/oligosaccharide-binding fold containing 1
PA134915019	29991	OBP2A	chr9	138427885	138444815	16930	odorant binding protein 2A
PA134883553	29989	OBP2B	chr9	136077666	136094714	17048	odorant binding protein 2B
PA31888	84033	OBSCN	chr1	228385740	228569577	183837	obscurin, cytoskeletal calmodulin and titin-interacting RhoGEF
PA142671235	23363	OBSL1	chr2	220412450	220446357	33907	obscurin-like 1
PA31889	729330	OC90	chr8	133033467	133081627	48160	otoconin 90
PA31890	4948	OCA2	chr15	27997021	28354483	357462	oculocutaneous albinism II
PA162398385	79629	OCEL1	chr19	17327040	17343028	15988	occludin/ELL domain containing 1
PA134898158	54940	OCIAD1	chr4	48822599	48866834	44235	OCIA domain containing 1
PA128394755	132299	OCIAD2	chr4	48884405	48918815	34410	OCIA domain containing 2
PA31892	10896	OCLM	chr1	186359704	186373587	13883	oculomedin
PA31893	100506658	OCLN	chr5	68778119	68856931	78812	occludin
PA31894	654231	OCM	chr7	5910429	5928994	18565	oncomodulin
PA164724233	4951	OCM2	chr7	97611012	97629416	18404	oncomodulin 2
PA31896	4952	OCRL	chrX	128663826	128729533	65707	oculocerebrorenal syndrome of Lowe
PA25664	128506	OCSTAMP	chr20	45166670	45189213	22543	osteoclast stimulatory transmembrane protein
PA145148342	54959	ODAM	chr4	71051441	71073293	21852	odontogenic, ameloblast asssociated
PA31897	4953	ODC1	chr2	10577507	10598680	21173	ornithine decarboxylase 1
PA31901	4956	ODF1	chr8	103553848	103576245	22397	outer dense fiber of sperm tails 1
PA31902	4957	ODF2	chr9	131207434	131266571	59137	outer dense fiber of sperm tails 2
PA142671232	57489	ODF2L	chr1	86809507	86872025	62518	outer dense fiber of sperm tails 2-like
PA134952791	113746	ODF3	chr11	186761	203273	16512	outer dense fiber of sperm tails 3
PA162398386	440836	ODF3B	chr22	50965836	50981008	15172	outer dense fiber of sperm tails 3B
PA134930463	161753	ODF3L1	chr15	76006319	76023027	16708	outer dense fiber of sperm tails 3-like 1
PA162398387	284451	ODF3L2	chr19	460346	484983	24637	outer dense fiber of sperm tails 3-like 2
PA134978853	146852	ODF4	chr17	8233158	8252364	19206	outer dense fiber of sperm tails 4
PA31909	8481	OFD1	chrX	13723549	13790480	66931	oral-facial-digital syndrome 1
PA31910	4967	OGDH	chr7	44636104	44751669	115565	oxoglutarate (alpha-ketoglutarate) dehydrogenase (lipoamide)
PA134878907	55753	OGDHL	chr10	50939687	50980425	40738	oxoglutarate dehydrogenase-like
PA143485568	55239	OGFOD1	chr16	56475424	56514407	38983	2-oxoglutarate and iron-dependent oxygenase domain containing 1
PA143485569	79676	OGFOD2	chr12	123449354	123467588	18234	2-oxoglutarate and iron-dependent oxygenase domain containing 2
PA164716907	79701	OGFOD3	chr17	80344086	80386513	42427	2-oxoglutarate and iron-dependent oxygenase domain containing 3
PA31911	11054	OGFR	chr20	61426156	61448352	22196	opioid growth factor receptor
PA128394713	79627	OGFRL1	chr6	71988477	72016267	27790	opioid growth factor receptor-like 1
PA31912	4968	OGG1	chr3	9781628	9832468	50840	8-oxoguanine DNA glycosylase
PA31913	4969	OGN	chr9	95143249	95176976	33727	osteoglycin
PA31914	8473	OGT	chrX	70742912	70798747	55835	O-linked N-acetylglucosamine (GlcNAc) transferase
PA134887641	11339	OIP5	chr15	41598466	41634819	36353	Opa interacting protein 5
PA142671231	170392	OIT3	chr10	74643339	74695787	52448	oncoprotein induced transcript 3
PA162398388	29789	OLA1	chr2	174934175	175123365	189190	Obg-like ATPase 1
PA134955731	55301	OLAH	chr10	15075895	15118851	42956	oleoyl-ACP hydrolase
PA31915	10439	OLFM1	chr9	137957089	138016030	58941	olfactomedin 1
PA31916	93145	OLFM2	chr19	9961394	10057070	95676	olfactomedin 2
PA31917	118427	OLFM3	chr1	102265126	102472790	207664	olfactomedin 3
PA134984745	10562	OLFM4	chr13	53592876	53629196	36320	olfactomedin 4
PA134904379	283298	OLFML1	chr11	7496600	7536128	39528	olfactomedin-like 1
PA134967883	169611	OLFML2A	chr9	127529435	127580161	50726	olfactomedin-like 2A
PA134990758	25903	OLFML2B	chr1	161949982	162004172	54190	olfactomedin-like 2B
PA134913777	56944	OLFML3	chr1	114512030	114527875	15845	olfactomedin-like 3
PA31918	116448	OLIG1	chr21	34432450	34447728	15278	oligodendrocyte transcription factor 1
PA31919	10215	OLIG2	chr21	34388216	34404504	16288	oligodendrocyte lineage transcription factor 2
PA134945348	167826	OLIG3	chr6	137810336	137825531	15195	oligodendrocyte transcription factor 3
PA31920	4973	OLR1	chr12	10307899	10334790	26891	oxidized low density lipoprotein (lectin-like) receptor 1
PA134911478	115209	OMA1	chr1	58878052	59022469	144417	OMA1 zinc metallopeptidase
PA31921	4958	OMD	chr9	95173527	95196836	23309	osteomodulin
PA31922	4974	OMG	chr17	29618668	29634380	15712	oligodendrocyte myelin glycoprotein
PA31923	4975	OMP	chr11	76803886	76817377	13491	olfactory marker protein
PA31924	3175	ONECUT1	chr15	53046160	53092209	46049	one cut homeobox 1
PA31925	9480	ONECUT2	chr18	55092917	55161530	68613	one cut homeobox 2
PA31926	390874	ONECUT3	chr19	1743662	1778444	34782	one cut homeobox 3
PA162398414	441161	OOEP	chr6	74075278	74089515	14237	oocyte expressed protein
PA162399666	219990	OOSP2	chr11	59797748	59818517	20769	oocyte secreted protein 2
PA31927	4976	OPA1	chr3	193300933	193418600	117667	optic atrophy 1 (autosomal dominant)
PA31929	80207	OPA3	chr19	46028025	46098122	70097	optic atrophy 3 (autosomal recessive, with chorea and spastic paraplegia)
PA162398424	93377	OPALIN	chr10	98099973	98129092	29119	oligodendrocytic myelin paranodal and inner loop protein
PA31930	4978	OPCML	chr11	132281875	133412403	1130528	opioid binding protein/cell adhesion molecule-like
PA31934	4983	OPHN1	chrX	67259186	67663369	404183	oligophrenin 1
PA31935	26873	OPLAH	chr8	145103167	145125584	22417	5-oxoprolinase (ATP-hydrolysing)
PA31936	5956	OPN1LW	chrX	153399725	153427507	27782	opsin 1 (cone pigments), long-wave-sensitive
PA31937	2652	OPN1MW	chrX	153438085	153465352	27267	opsin 1 (cone pigments), medium-wave-sensitive
PA142671229	728458	OPN1MW2	chrX	153475203	153501755	26552	opsin 1 (cone pigments), medium-wave-sensitive 2
PA31938	611	OPN1SW	chr7	128409543	128425844	16301	opsin 1 (cone pigments), short-wave-sensitive
PA31939	23596	OPN3	chr1	241753452	241813701	60249	opsin 3
PA31940	94233	OPN4	chr10	88404314	88429217	24903	opsin 4
PA134942887	221391	OPN5	chr6	47739775	47797117	57342	opsin 5
PA31942	4985	OPRD1	chr1	29128654	29193208	64554	opioid receptor, delta 1
PA31943	4986	OPRK1	chr8	54135276	54174257	38981	opioid receptor, kappa 1
PA31944	4987	OPRL1	chr20	62701451	62734996	33545	opiate receptor-like 1
PA31945	4988	OPRM1	chr6	154321631	154571001	249370	opioid receptor, mu 1
PA31947	26254	OPTC	chr1	203453271	203481077	27806	opticin
PA31948	10133	OPTN	chr10	13131425	13183291	51866	optineurin
PA31950	341276	OR10A2	chr11	6880986	6894897	13911	olfactory receptor, family 10, subfamily A, member 2
PA31951	26496	OR10A3	chr11	7957123	7971067	13944	olfactory receptor, family 10, subfamily A, member 3
PA31952	283297	OR10A4	chr11	6887856	6901850	13994	olfactory receptor, family 10, subfamily A, member 4
PA31953	144124	OR10A5	chr11	6856914	6870867	13953	olfactory receptor, family 10, subfamily A, member 5
PA31954	390093	OR10A6	chr11	7946265	7960209	13944	olfactory receptor, family 10, subfamily A, member 6
PA31955	121364	OR10A7	chr12	55604809	55618759	13950	olfactory receptor, family 10, subfamily A, member 7
PA31959	121275	OR10AD1	chr12	48592620	48609103	16483	olfactory receptor, family 10, subfamily AD, member 1
PA134929321	282770	OR10AG1	chr11	55732034	55745939	13905	olfactory receptor, family 10, subfamily AG, member 1
PA31962	442194	OR10C1	chr6	29397716	29411754	14038	olfactory receptor, family 10, subfamily C, member 1 (gene/pseudogene)
PA31964	26497	OR10D3	chr11	124045978	124059913	13935	olfactory receptor, family 10, subfamily D, member 3 (non-functional)
PA31969	26534	OR10G2	chr14	22099066	22112998	13932	olfactory receptor, family 10, subfamily G, member 2
PA31970	26533	OR10G3	chr14	22034934	22048875	13941	olfactory receptor, family 10, subfamily G, member 3
PA31971	390264	OR10G4	chr11	123876282	123890217	13935	olfactory receptor, family 10, subfamily G, member 4
PA31974	390265	OR10G7	chr11	123905773	123919708	13935	olfactory receptor, family 10, subfamily G, member 7
PA31975	219869	OR10G8	chr11	123890330	123904265	13935	olfactory receptor, family 10, subfamily G, member 8
PA31976	219870	OR10G9	chr11	123883720	123897655	13935	olfactory receptor, family 10, subfamily G, member 9
PA31977	26539	OR10H1	chr19	15914817	15928936	14119	olfactory receptor, family 10, subfamily H, member 1
PA31978	26538	OR10H2	chr19	15828834	15842862	14028	olfactory receptor, family 10, subfamily H, member 2
PA31979	26532	OR10H3	chr19	15842203	15856153	13950	olfactory receptor, family 10, subfamily H, member 3
PA31980	126541	OR10H4	chr19	16049818	16063768	13950	olfactory receptor, family 10, subfamily H, member 4
PA31981	284433	OR10H5	chr19	15894859	15908806	13947	olfactory receptor, family 10, subfamily H, member 5
PA31982	26476	OR10J1	chr1	159399512	159413600	14088	olfactory receptor, family 10, subfamily J, member 1
PA31984	441911	OR10J3	chr1	159280460	159294449	13989	olfactory receptor, family 10, subfamily J, member 3
PA31986	127385	OR10J5	chr1	159501868	159515797	13929	olfactory receptor, family 10, subfamily J, member 5
PA31988	391109	OR10K1	chr1	158425352	158439293	13941	olfactory receptor, family 10, subfamily K, member 1
PA31989	391107	OR10K2	chr1	158386718	158400656	13938	olfactory receptor, family 10, subfamily K, member 2
PA31991	121130	OR10P1	chr12	56020676	56034617	13941	olfactory receptor, family 10, subfamily P, member 1
PA31994	219960	OR10Q1	chr11	57992354	58006390	14036	olfactory receptor, family 10, subfamily Q, member 1
PA31997	343406	OR10R2	chr1	158439668	158453675	14007	olfactory receptor, family 10, subfamily R, member 2
PA31999	219873	OR10S1	chr11	123844403	123858398	13995	olfactory receptor, family 10, subfamily S, member 1
PA32001	128360	OR10T2	chr1	158365312	158379256	13944	olfactory receptor, family 10, subfamily T, member 2
PA32003	390201	OR10V1	chr11	59477389	59491318	13929	olfactory receptor, family 10, subfamily V, member 1
PA32006	81341	OR10W1	chr11	58031264	58045732	14468	olfactory receptor, family 10, subfamily W, member 1
PA32007	128367	OR10X1	chr1	158545709	158559689	13980	olfactory receptor, family 10, subfamily X, member 1 (gene/pseudogene)
PA32009	128368	OR10Z1	chr1	158566229	158580170	13941	olfactory receptor, family 10, subfamily Z, member 1
PA32010	26531	OR11A1	chr6	29390281	29434848	44567	olfactory receptor, family 11, subfamily A, member 1
PA32012	390439	OR11G2	chr14	20655495	20669532	14037	olfactory receptor, family 11, subfamily G, member 2
PA32013	81061	OR11H1	chr22	16445824	16459804	13980	olfactory receptor, family 11, subfamily H, member 1
PA142671220	440153	OR11H12	chr14	19367594	19381574	13980	olfactory receptor, family 11, subfamily H, member 12
PA32016	390442	OR11H4	chr14	20700951	20714925	13974	olfactory receptor, family 11, subfamily H, member 4
PA32018	122748	OR11H6	chr14	20681869	20695861	13992	olfactory receptor, family 11, subfamily H, member 6
PA32025	391189	OR11L1	chr1	248001230	248015198	13968	olfactory receptor, family 11, subfamily L, member 1
PA32028	26529	OR12D2	chr6	29354416	29368448	14032	olfactory receptor, family 12, subfamily D, member 2 (gene/pseudogene)
PA32029	81797	OR12D3	chr6	29338200	29353068	14868	olfactory receptor, family 12, subfamily D, member 3
PA32030	79290	OR13A1	chr10	45795102	45821056	25954	olfactory receptor, family 13, subfamily A, member 1
PA32032	392376	OR13C2	chr9	107363952	107377908	13956	olfactory receptor, family 13, subfamily C, member 2
PA32033	138803	OR13C3	chr9	107295051	107309094	14043	olfactory receptor, family 13, subfamily C, member 3
PA32034	138804	OR13C4	chr9	107285534	107299490	13956	olfactory receptor, family 13, subfamily C, member 4
PA32035	138799	OR13C5	chr9	107357738	107371694	13956	olfactory receptor, family 13, subfamily C, member 5
PA32038	138802	OR13C8	chr9	107321449	107335411	13962	olfactory receptor, family 13, subfamily C, member 8
PA32039	286362	OR13C9	chr9	107376529	107390485	13956	olfactory receptor, family 13, subfamily C, member 9
PA32040	286365	OR13D1	chr9	107446703	107460743	14040	olfactory receptor, family 13, subfamily D, member 1
PA32045	138805	OR13F1	chr9	107256544	107270503	13959	olfactory receptor, family 13, subfamily F, member 1
PA32046	441933	OR13G1	chr1	247832420	247846343	13923	olfactory receptor, family 13, subfamily G, member 1
PA32047	347468	OR13H1	chrX	130668048	130681974	13926	olfactory receptor, family 13, subfamily H, member 1
PA32049	392309	OR13J1	chr9	35866460	35880398	13938	olfactory receptor, family 13, subfamily J, member 1
PA162398441	284532	OR14A16	chr1	247975102	247989031	13929	olfactory receptor, family 14, subfamily A, member 16
PA162398442	127066	OR14C36	chr1	248502077	248516015	13938	olfactory receptor, family 14, subfamily C, member 36
PA162398443	401994	OR14I1	chr1	248841580	248872258	30678	olfactory receptor, family 14, subfamily I, member 1
PA162398444	442191	OR14J1	chr6	29264467	29278432	13965	olfactory receptor, family 14, subfamily J, member 1
PA32478	343170	OR14K1	chr1	247891917	247905861	13944	olfactory receptor, family 14, subfamily K, member 1
PA32051	8383	OR1A1	chr17	3108915	3122844	13929	olfactory receptor, family 1, subfamily A, member 1
PA32052	26189	OR1A2	chr17	3090813	3104742	13929	olfactory receptor, family 1, subfamily A, member 2
PA32055	347169	OR1B1	chr9	125387858	125401814	13956	olfactory receptor, family 1, subfamily B, member 1
PA32056	26188	OR1C1	chr1	247917764	247931708	13944	olfactory receptor, family 1, subfamily C, member 1
PA32057	4991	OR1D2	chr17	2992352	3006290	13938	olfactory receptor, family 1, subfamily D, member 2
PA32060	8386	OR1D5	chr17	2962963	2976901	13938	olfactory receptor, family 1, subfamily D, member 5
PA32062	8387	OR1E1	chr17	3297760	3311704	13944	olfactory receptor, family 1, subfamily E, member 1
PA32063	8388	OR1E2	chr17	3333164	3347135	13971	olfactory receptor, family 1, subfamily E, member 2
PA32070	4992	OR1F1	chr16	3244247	3258185	13938	olfactory receptor, family 1, subfamily F, member 1
PA32073	442179	OR1F12	chr6	28031026	28045002	13976	olfactory receptor, family 1, subfamily F, member 12
PA32076	8390	OR1G1	chr17	3026904	3040845	13941	olfactory receptor, family 1, subfamily G, member 1
PA32078	126370	OR1I1	chr19	15187877	15201944	14067	olfactory receptor, family 1, subfamily I, member 1
PA32079	347168	OR1J1	chr9	125236237	125250205	13968	olfactory receptor, family 1, subfamily J, member 1
PA32080	26740	OR1J2	chr9	125221369	125279376	58007	olfactory receptor, family 1, subfamily J, member 2
PA32081	26219	OR1J4	chr9	125271420	125285361	13941	olfactory receptor, family 1, subfamily J, member 4
PA32083	392392	OR1K1	chr9	125552402	125566352	13950	olfactory receptor, family 1, subfamily K, member 1
PA32084	26737	OR1L1	chr9	125413995	125427927	13932	olfactory receptor, family 1, subfamily L, member 1
PA32085	26735	OR1L3	chr9	125427409	125441383	13974	olfactory receptor, family 1, subfamily L, member 3
PA32086	254973	OR1L4	chr9	125476269	125490204	13935	olfactory receptor, family 1, subfamily L, member 4
PA32087	392390	OR1L6	chr9	125502127	125516062	13935	olfactory receptor, family 1, subfamily L, member 6
PA32088	138881	OR1L8	chr9	125326827	125340756	13929	olfactory receptor, family 1, subfamily L, member 8
PA32089	125963	OR1M1	chr19	9193921	9207862	13941	olfactory receptor, family 1, subfamily M, member 1
PA32090	138883	OR1N1	chr9	125285637	125299572	13935	olfactory receptor, family 1, subfamily N, member 1
PA32091	138882	OR1N2	chr9	125305449	125319441	13992	olfactory receptor, family 1, subfamily N, member 2
PA32094	158131	OR1Q1	chr9	125367017	125380961	13944	olfactory receptor, family 1, subfamily Q, member 1
PA32098	219959	OR1S1	chr11	57972217	57986194	13977	olfactory receptor, family 1, subfamily S, member 1
PA32099	219958	OR1S2	chr11	57967676	57981653	13977	olfactory receptor, family 1, subfamily S, member 2
PA32101	346528	OR2A1	chr7	143999039	144020558	21519	olfactory receptor, family 2, subfamily A, member 1
PA32104	346525	OR2A12	chr7	143782201	143796133	13932	olfactory receptor, family 2, subfamily A, member 12
PA32106	135941	OR2A14	chr7	143816206	143830138	13932	olfactory receptor, family 2, subfamily A, member 14
PA32115	442361	OR2A2	chr7	143796676	143810632	13956	olfactory receptor, family 2, subfamily A, member 2
PA134892120	392138	OR2A25	chr7	143761313	143775245	13932	olfactory receptor, family 2, subfamily A, member 25
PA32117	79541	OR2A4	chr6	132018609	132032541	13932	olfactory receptor, family 2, subfamily A, member 4
PA134971566	402317	OR2A42	chr7	143925876	143946126	20250	olfactory receptor, family 2, subfamily A, member 42
PA32118	393046	OR2A5	chr7	143737495	143751430	13935	olfactory receptor, family 2, subfamily A, member 5
PA32120	401427	OR2A7	chr7	143952789	143966721	13932	olfactory receptor, family 2, subfamily A, member 7
PA32123	81392	OR2AE1	chr7	99470685	99484656	13971	olfactory receptor, family 2, subfamily AE, member 1
PA32126	144125	OR2AG1	chr11	6796248	6810245	13997	olfactory receptor, family 2, subfamily AG, member 1
PA32127	338755	OR2AG2	chr11	6786238	6800188	13950	olfactory receptor, family 2, subfamily AG, member 2
PA134921949	391191	OR2AK2	chr1	248118634	248132641	14007	olfactory receptor, family 2, subfamily AK, member 2
PA134941860	341152	OR2AT4	chr11	74796796	74810758	13962	olfactory receptor, family 2, subfamily AT, member 4
PA134961529	127623	OR2B11	chr1	247611331	247625284	13953	olfactory receptor, family 2, subfamily B, member 11
PA32141	81697	OR2B2	chr6	27875963	27890174	14211	olfactory receptor, family 2, subfamily B, member 2
PA32142	442184	OR2B3	chr6	29050985	29065090	14105	olfactory receptor, family 2, subfamily B, member 3
PA32144	26212	OR2B6	chr6	27915019	27928960	13941	olfactory receptor, family 2, subfamily B, member 6
PA32147	4993	OR2C1	chr16	3395889	3409924	14035	olfactory receptor, family 2, subfamily C, member 1
PA32149	81472	OR2C3	chr1	247690434	247707141	16707	olfactory receptor, family 2, subfamily C, member 3
PA32152	120776	OR2D2	chr11	6909805	6923731	13926	olfactory receptor, family 2, subfamily D, member 2
PA32153	120775	OR2D3	chr11	6932233	6946225	13992	olfactory receptor, family 2, subfamily D, member 3
PA32155	26211	OR2F1	chr7	143647020	143661108	14088	olfactory receptor, family 2, subfamily F, member 1 (gene/pseudogene)
PA32156	135948	OR2F2	chr7	143622326	143636279	13953	olfactory receptor, family 2, subfamily F, member 2
PA32159	81470	OR2G2	chr1	247741662	247755615	13953	olfactory receptor, family 2, subfamily G, member 2
PA32160	81469	OR2G3	chr1	247758888	247772817	13929	olfactory receptor, family 2, subfamily G, member 3
PA142671228	391211	OR2G6	chr1	248674948	248688898	13950	olfactory receptor, family 2, subfamily G, member 6
PA32161	26716	OR2H1	chr6	29414947	29435099	20152	olfactory receptor, family 2, subfamily H, member 1
PA32162	7932	OR2H2	chr6	29543818	29559745	15927	olfactory receptor, family 2, subfamily H, member 2
PA32177	26707	OR2J2	chr6	29131311	29145351	14040	olfactory receptor, family 2, subfamily J, member 2
PA32178	442186	OR2J3	chr6	29069587	29083661	14074	olfactory receptor, family 2, subfamily J, member 3
PA32181	26248	OR2K2	chr9	114086763	114101952	15189	olfactory receptor, family 2, subfamily K, member 2
PA134982185	284521	OR2L13	chr1	248090493	248267224	176731	olfactory receptor, family 2, subfamily L, member 13
PA32183	26246	OR2L2	chr1	248191474	248205607	14133	olfactory receptor, family 2, subfamily L, member 2
PA32184	391192	OR2L3	chr1	248213984	248227922	13938	olfactory receptor, family 2, subfamily L, member 3
PA32189	391190	OR2L8	chr1	248102160	248116098	13938	olfactory receptor, family 2, subfamily L, member 8 (gene/pseudogene)
PA32192	391194	OR2M2	chr1	248333288	248347331	14043	olfactory receptor, family 2, subfamily M, member 2
PA32193	127062	OR2M3	chr1	248356370	248370308	13938	olfactory receptor, family 2, subfamily M, member 3
PA32194	26245	OR2M4	chr1	248392231	248406166	13935	olfactory receptor, family 2, subfamily M, member 4
PA134871998	127059	OR2M5	chr1	248298450	248312388	13938	olfactory receptor, family 2, subfamily M, member 5
PA134874354	391196	OR2M7	chr1	248483932	248497870	13938	olfactory receptor, family 2, subfamily M, member 7
PA32200	56656	OR2S2	chr9	35954105	35968151	14046	olfactory receptor, family 2, subfamily S, member 2
PA32201	26696	OR2T1	chr1	248559296	248573405	14109	olfactory receptor, family 2, subfamily T, member 1
PA134982857	127069	OR2T10	chr1	248753131	248767069	13938	olfactory receptor, family 2, subfamily T, member 10
PA134948800	127077	OR2T11	chr1	248786479	248800429	13950	olfactory receptor, family 2, subfamily T, member 11 (gene/pseudogene)
PA134941840	127064	OR2T12	chr1	248454918	248468880	13962	olfactory receptor, family 2, subfamily T, member 12
PA32202	401992	OR2T2	chr1	248606099	248620073	13974	olfactory receptor, family 2, subfamily T, member 2
PA134945560	403239	OR2T27	chr1	248810232	248824185	13953	olfactory receptor, family 2, subfamily T, member 27
PA134876557	343563	OR2T29	chr1	248718845	248732792	13947	olfactory receptor, family 2, subfamily T, member 29
PA32203	343173	OR2T3	chr1	248626652	248640608	13956	olfactory receptor, family 2, subfamily T, member 3
PA134889138	391195	OR2T33	chr1	248433154	248447116	13962	olfactory receptor, family 2, subfamily T, member 33
PA134944535	127068	OR2T34	chr1	248734102	248748058	13956	olfactory receptor, family 2, subfamily T, member 34
PA134968902	403244	OR2T35	chr1	248798588	248812559	13971	olfactory receptor, family 2, subfamily T, member 35
PA32204	127074	OR2T4	chr1	248514883	248528929	14046	olfactory receptor, family 2, subfamily T, member 4
PA32205	401993	OR2T5	chr1	248641890	248655837	13947	olfactory receptor, family 2, subfamily T, member 5
PA32206	254879	OR2T6	chr1	248540910	248554836	13926	olfactory receptor, family 2, subfamily T, member 6
PA32208	343172	OR2T8	chr1	248070963	248088258	17295	olfactory receptor, family 2, subfamily T, member 8
PA32212	285659	OR2V2	chr5	180571943	180585890	13947	olfactory receptor, family 2, subfamily V, member 2
PA32214	26692	OR2W1	chr6	29008990	29022952	13962	olfactory receptor, family 2, subfamily W, member 1
PA32216	343171	OR2W3	chr1	248048889	248062833	13944	olfactory receptor, family 2, subfamily W, member 3
PA32220	134083	OR2Y1	chr5	180163123	180177058	13935	olfactory receptor, family 2, subfamily Y, member 1
PA32221	284383	OR2Z1	chr19	8831391	8845335	13944	olfactory receptor, family 2, subfamily Z, member 1
PA32223	4994	OR3A1	chr17	3191929	3205876	13947	olfactory receptor, family 3, subfamily A, member 1
PA32224	4995	OR3A2	chr17	3178184	3192268	14084	olfactory receptor, family 3, subfamily A, member 2
PA32225	8392	OR3A3	chr17	3313862	3327827	13965	olfactory receptor, family 3, subfamily A, member 3
PA32234	81328	OR4A15	chr11	55125360	55139394	14034	olfactory receptor, family 4, subfamily A, member 15
PA32235	81327	OR4A16	chr11	55100677	55114663	13986	olfactory receptor, family 4, subfamily A, member 16
PA134952685	403253	OR4A47	chr11	48500345	48514274	13929	olfactory receptor, family 4, subfamily A, member 47
PA32245	81318	OR4A5	chr11	51408378	51422448	14070	olfactory receptor, family 4, subfamily A, member 5
PA32250	119765	OR4B1	chr11	48228362	48242291	13929	olfactory receptor, family 4, subfamily B, member 1
PA32253	219429	OR4C11	chr11	55367830	55381874	14044	olfactory receptor, family 4, subfamily C, member 11
PA32254	283093	OR4C12	chr11	50000009	50014071	14062	olfactory receptor, family 4, subfamily C, member 12
PA32255	283092	OR4C13	chr11	49963943	49977971	14028	olfactory receptor, family 4, subfamily C, member 13
PA32257	81309	OR4C15	chr11	55311783	55325895	14112	olfactory receptor, family 4, subfamily C, member 15
PA32258	219428	OR4C16	chr11	55329604	55343536	13932	olfactory receptor, family 4, subfamily C, member 16 (gene/pseudogene)
PA32261	256144	OR4C3	chr11	48336493	48350482	13989	olfactory receptor, family 4, subfamily C, member 3
PA134910149	119749	OR4C46	chr11	51505282	51519211	13929	olfactory receptor, family 4, subfamily C, member 46
PA32264	219432	OR4C6	chr11	55422643	55436572	13929	olfactory receptor, family 4, subfamily C, member 6
PA32267	26689	OR4D1	chr17	56222515	56236447	13932	olfactory receptor, family 4, subfamily D, member 1
PA32268	390197	OR4D10	chr11	59234903	59248838	13935	olfactory receptor, family 4, subfamily D, member 10
PA32269	219986	OR4D11	chr11	59261049	59274984	13935	olfactory receptor, family 4, subfamily D, member 11
PA32270	124538	OR4D2	chr17	56237017	56250940	13923	olfactory receptor, family 4, subfamily D, member 2
PA32272	219875	OR4D5	chr11	123800324	123814280	13956	olfactory receptor, family 4, subfamily D, member 5
PA32273	219983	OR4D6	chr11	59214434	59228378	13944	olfactory receptor, family 4, subfamily D, member 6
PA32276	390199	OR4D9	chr11	59272386	59286330	13944	olfactory receptor, family 4, subfamily D, member 9
PA32278	26686	OR4E2	chr14	22123297	22137238	13941	olfactory receptor, family 4, subfamily E, member 2
PA32283	390649	OR4F15	chr15	102348390	102362328	13938	olfactory receptor, family 4, subfamily F, member 15
PA32284	81399	OR4F16	chr1	618096	632034	13938	olfactory receptor, family 4, subfamily F, member 16
PA32285	81099	OR4F17	chr19	97152	114690	17538	olfactory receptor, family 4, subfamily F, member 17
PA134918173	441308	OR4F21	chr8	113086	127024	13938	olfactory receptor, family 4, subfamily F, member 21
PA134963748	729759	OR4F29	chr1	357659	371597	13938	olfactory receptor, family 4, subfamily F, member 29
PA32289	26683	OR4F3	chr5	180784288	180798226	13938	olfactory receptor, family 4, subfamily F, member 3
PA32290	26682	OR4F4	chr15	102459345	102473262	13917	olfactory receptor, family 4, subfamily F, member 4
PA32291	79501	OR4F5	chr1	59091	73008	13917	olfactory receptor, family 4, subfamily F, member 5
PA32292	390648	OR4F6	chr15	102335923	102349861	13938	olfactory receptor, family 4, subfamily F, member 6
PA32308	79544	OR4K1	chr14	20393767	20407842	14075	olfactory receptor, family 4, subfamily K, member 1
PA32312	390433	OR4K13	chr14	20499003	20512917	13914	olfactory receptor, family 4, subfamily K, member 13
PA32313	122740	OR4K14	chr14	20479420	20493352	13932	olfactory receptor, family 4, subfamily K, member 14
PA32314	81127	OR4K15	chr14	20433678	20447724	14046	olfactory receptor, family 4, subfamily K, member 15
PA32316	390436	OR4K17	chr14	20575566	20589597	14031	olfactory receptor, family 4, subfamily K, member 17
PA32317	390431	OR4K2	chr14	20334427	20348371	13944	olfactory receptor, family 4, subfamily K, member 2
PA32320	79317	OR4K5	chr14	20378766	20392737	13971	olfactory receptor, family 4, subfamily K, member 5
PA32325	122742	OR4L1	chr14	20518204	20532142	13938	olfactory receptor, family 4, subfamily L, member 1
PA32327	441670	OR4M1	chr14	20238482	20252423	13941	olfactory receptor, family 4, subfamily M, member 1
PA32328	390538	OR4M2	chr15	22358478	22372561	14083	olfactory receptor, family 4, subfamily M, member 2
PA32330	390429	OR4N2	chr14	20285608	20299531	13923	olfactory receptor, family 4, subfamily N, member 2
PA32332	283694	OR4N4	chr15	22372473	22386815	14342	olfactory receptor, family 4, subfamily N, member 4
PA32333	390437	OR4N5	chr14	20601895	20615821	13926	olfactory receptor, family 4, subfamily N, member 5
PA32337	81300	OR4P4	chr11	55395834	55409772	13938	olfactory receptor, family 4, subfamily P, member 4
PA32340	441669	OR4Q3	chr14	20205587	20219528	13941	olfactory receptor, family 4, subfamily Q, member 3
PA32344	256148	OR4S1	chr11	48317775	48331704	13929	olfactory receptor, family 4, subfamily S, member 1
PA32345	219431	OR4S2	chr11	55408380	55422315	13935	olfactory receptor, family 4, subfamily S, member 2
PA32350	390113	OR4X1	chr11	48275413	48289330	13917	olfactory receptor, family 4, subfamily X, member 1 (gene/pseudogene)
PA32351	119764	OR4X2	chr11	48256656	48270567	13911	olfactory receptor, family 4, subfamily X, member 2
PA32355	401667	OR51A2	chr11	4973002	4986943	13941	olfactory receptor, family 51, subfamily A, member 2
PA32357	401666	OR51A4	chr11	4964389	4978330	13941	olfactory receptor, family 51, subfamily A, member 4
PA32360	119687	OR51A7	chr11	4918600	4932538	13938	olfactory receptor, family 51, subfamily A, member 7
PA32364	79345	OR51B2	chr11	5341528	5355582	14054	olfactory receptor, family 51, subfamily B, member 2
PA32366	79339	OR51B4	chr11	5319244	5333176	13932	olfactory receptor, family 51, subfamily B, member 4
PA134907440	282763	OR51B5	chr11	5359113	5378140	19027	olfactory receptor, family 51, subfamily B, member 5
PA134989095	390058	OR51B6	chr11	5362738	5376676	13938	olfactory receptor, family 51, subfamily B, member 6
PA32370	390038	OR51D1	chr11	4650945	4665068	14123	olfactory receptor, family 51, subfamily D, member 1
PA32371	143503	OR51E1	chr11	4655156	4679718	24562	olfactory receptor, family 51, subfamily E, member 1
PA32372	81285	OR51E2	chr11	4698401	4729076	30675	olfactory receptor, family 51, subfamily E, member 2
PA32374	256892	OR51F1	chr11	4787209	4801147	13938	olfactory receptor, family 51, subfamily F, member 1
PA32375	119694	OR51F2	chr11	4832616	4846644	14028	olfactory receptor, family 51, subfamily F, member 2
PA32376	79324	OR51G1	chr11	4941604	4955569	13965	olfactory receptor, family 51, subfamily G, member 1
PA32377	81282	OR51G2	chr11	4932949	4946893	13944	olfactory receptor, family 51, subfamily G, member 2
PA32380	390063	OR51I1	chr11	5458772	5472783	14011	olfactory receptor, family 51, subfamily I, member 1
PA32381	390064	OR51I2	chr11	5464638	5478707	14069	olfactory receptor, family 51, subfamily I, member 2
PA32384	119682	OR51L1	chr11	5010213	5024160	13947	olfactory receptor, family 51, subfamily L, member 1
PA32385	390059	OR51M1	chr11	5400607	5414664	14057	olfactory receptor, family 51, subfamily M, member 1
PA32388	390061	OR51Q1	chr11	5433341	5447436	14095	olfactory receptor, family 51, subfamily Q, member 1 (gene/pseudogene)
PA32390	119692	OR51S1	chr11	4866467	4880438	13971	olfactory receptor, family 51, subfamily S, member 1
PA32391	401665	OR51T1	chr11	4893049	4907113	14064	olfactory receptor, family 51, subfamily T, member 1
PA134873075	283111	OR51V1	chr11	5217965	5231930	13965	olfactory receptor, family 51, subfamily V, member 1
PA32392	23538	OR52A1	chr11	5169661	5183599	13938	olfactory receptor, family 52, subfamily A, member 1
PA134969174	390053	OR52A4	chr11	5138894	5152808	13914	olfactory receptor, family 52, subfamily A, member 4
PA134991603	390054	OR52A5	chr11	5149922	5163872	13950	olfactory receptor, family 52, subfamily A, member 5
PA32396	255725	OR52B2	chr11	6187585	6201556	13971	olfactory receptor, family 52, subfamily B, member 2
PA32398	143496	OR52B4	chr11	4385493	4399616	14123	olfactory receptor, family 52, subfamily B, member 4
PA32400	340980	OR52B6	chr11	5592107	5606114	14007	olfactory receptor, family 52, subfamily B, member 6
PA32401	390066	OR52D1	chr11	5499915	5513979	14064	olfactory receptor, family 52, subfamily D, member 1
PA32403	119678	OR52E2	chr11	5076880	5090857	13977	olfactory receptor, family 52, subfamily E, member 2
PA32405	390081	OR52E4	chr11	5895523	5909461	13938	olfactory receptor, family 52, subfamily E, member 4
PA32407	390078	OR52E6	chr11	5859186	5873127	13941	olfactory receptor, family 52, subfamily E, member 6
PA32409	390079	OR52E8	chr11	5874979	5888932	13953	olfactory receptor, family 52, subfamily E, member 8
PA32410	390067	OR52H1	chr11	5562791	5576753	13962	olfactory receptor, family 52, subfamily H, member 1
PA32412	390037	OR52I1	chr11	4605269	4619243	13974	olfactory receptor, family 52, subfamily I, member 1
PA32413	143502	OR52I2	chr11	4598021	4612135	14114	olfactory receptor, family 52, subfamily I, member 2
PA32416	119679	OR52J3	chr11	5057756	5071691	13935	olfactory receptor, family 52, subfamily J, member 3
PA32417	390036	OR52K1	chr11	4500109	4514138	14029	olfactory receptor, family 52, subfamily K, member 1
PA32418	119774	OR52K2	chr11	4460525	4474591	14066	olfactory receptor, family 52, subfamily K, member 2
PA32420	338751	OR52L1	chr11	6004122	6018215	14093	olfactory receptor, family 52, subfamily L, member 1
PA32422	119772	OR52M1	chr11	4556421	4570374	13953	olfactory receptor, family 52, subfamily M, member 1
PA32425	79473	OR52N1	chr11	5806084	5820046	13962	olfactory receptor, family 52, subfamily N, member 1
PA32426	390077	OR52N2	chr11	5815018	5845572	30554	olfactory receptor, family 52, subfamily N, member 2
PA32428	390072	OR52N4	chr11	5747228	5780162	32934	olfactory receptor, family 52, subfamily N, member 4 (gene/pseudogene)
PA32429	390075	OR52N5	chr11	5795864	5809897	14033	olfactory receptor, family 52, subfamily N, member 5
PA32433	119695	OR52R1	chr11	4821663	4835610	13947	olfactory receptor, family 52, subfamily R, member 1
PA32438	120787	OR52W1	chr11	6210454	6224416	13962	olfactory receptor, family 52, subfamily W, member 1
PA32443	120796	OR56A1	chr11	6044901	6058971	14070	olfactory receptor, family 56, subfamily A, member 1
PA32445	390083	OR56A3	chr11	5958577	5972524	13947	olfactory receptor, family 56, subfamily A, member 3
PA32446	120793	OR56A4	chr11	6020281	6034378	14097	olfactory receptor, family 56, subfamily A, member 4
PA32450	387748	OR56B1	chr11	5747678	5761768	14090	olfactory receptor, family 56, subfamily B, member 1
PA32453	196335	OR56B4	chr11	6119009	6132968	13959	olfactory receptor, family 56, subfamily B, member 4
PA32454	219982	OR5A1	chr11	59200642	59214589	13947	olfactory receptor, family 5, subfamily A, member 1
PA32455	219981	OR5A2	chr11	59186452	59200426	13974	olfactory receptor, family 5, subfamily A, member 2
PA32457	81050	OR5AC2	chr3	97796017	97809946	13929	olfactory receptor, family 5, subfamily AC, member 2
PA32460	390181	OR5AK2	chr11	56746389	56760318	13929	olfactory receptor, family 5, subfamily AK, member 2
PA32466	390195	OR5AN1	chr11	59121932	59135867	13935	olfactory receptor, family 5, subfamily AN, member 1
PA32469	338675	OR5AP2	chr11	56405965	56419915	13950	olfactory receptor, family 5, subfamily AP, member 2
PA32471	219493	OR5AR1	chr11	56421162	56435094	13932	olfactory receptor, family 5, subfamily AR, member 1 (gene/pseudogene)
PA32472	219447	OR5AS1	chr11	55787895	55801869	13974	olfactory receptor, family 5, subfamily AS, member 1
PA32474	390445	OR5AU1	chr14	21620096	21634184	14088	olfactory receptor, family 5, subfamily AU, member 1
PA32481	390191	OR5B12	chr11	58203593	58217646	14053	olfactory receptor, family 5, subfamily B, member 12
PA32486	219965	OR5B17	chr11	58122598	58136542	13944	olfactory receptor, family 5, subfamily B, member 17
PA32490	390190	OR5B2	chr11	58186738	58200786	14048	olfactory receptor, family 5, subfamily B, member 2
PA134867164	219968	OR5B21	chr11	58271649	58285578	13929	olfactory receptor, family 5, subfamily B, member 21
PA32491	441608	OR5B3	chr11	58166938	58180882	13944	olfactory receptor, family 5, subfamily B, member 3
PA32511	392391	OR5C1	chr9	125541212	125555174	13962	olfactory receptor, family 5, subfamily C, member 1
PA32516	390142	OR5D13	chr11	55530914	55544858	13944	olfactory receptor, family 5, subfamily D, member 13
PA32517	219436	OR5D14	chr11	55553032	55566976	13944	olfactory receptor, family 5, subfamily D, member 14
PA32519	390144	OR5D16	chr11	55596228	55610214	13986	olfactory receptor, family 5, subfamily D, member 16
PA32521	219438	OR5D18	chr11	55577106	55591047	13941	olfactory receptor, family 5, subfamily D, member 18
PA32526	338674	OR5F1	chr11	55758157	55772101	13944	olfactory receptor, family 5, subfamily F, member 1
PA32532	26341	OR5H1	chr3	97841542	97855483	13941	olfactory receptor, family 5, subfamily H, member 1
PA134948167	403273	OR5H14	chr3	97858230	97872162	13932	olfactory receptor, family 5, subfamily H, member 14
PA134956122	403274	OR5H15	chr3	97877544	97891485	13941	olfactory receptor, family 5, subfamily H, member 15
PA32533	79310	OR5H2	chr3	97991732	98005676	13944	olfactory receptor, family 5, subfamily H, member 2
PA32537	79295	OR5H6	chr3	97973129	97987106	13977	olfactory receptor, family 5, subfamily H, member 6 (gene/pseudogene)
PA32540	10798	OR5I1	chr11	55699932	55713876	13944	olfactory receptor, family 5, subfamily I, member 1
PA134982020	282775	OR5J2	chr11	55934094	55948032	13938	olfactory receptor, family 5, subfamily J, member 2
PA32542	26339	OR5K1	chr3	98178421	98192372	13951	olfactory receptor, family 5, subfamily K, member 1
PA32543	402135	OR5K2	chr3	98206525	98220475	13950	olfactory receptor, family 5, subfamily K, member 2
PA134984948	403277	OR5K3	chr3	98099510	98113475	13965	olfactory receptor, family 5, subfamily K, member 3
PA134945625	403278	OR5K4	chr3	98062698	98076663	13965	olfactory receptor, family 5, subfamily K, member 4
PA32544	219437	OR5L1	chr11	55568943	55582878	13935	olfactory receptor, family 5, subfamily L, member 1
PA32545	26338	OR5L2	chr11	55584695	55598630	13935	olfactory receptor, family 5, subfamily L, member 2
PA32546	390168	OR5M1	chr11	56377031	56390978	13947	olfactory receptor, family 5, subfamily M, member 1
PA32547	390167	OR5M10	chr11	56341250	56355197	13947	olfactory receptor, family 5, subfamily M, member 10
PA32548	219487	OR5M11	chr11	56306816	56320733	13917	olfactory receptor, family 5, subfamily M, member 11
PA32553	219482	OR5M3	chr11	56233964	56248014	14050	olfactory receptor, family 5, subfamily M, member 3
PA32558	219484	OR5M8	chr11	56254911	56268846	13935	olfactory receptor, family 5, subfamily M, member 8
PA32559	390162	OR5M9	chr11	56226945	56240877	13932	olfactory receptor, family 5, subfamily M, member 9
PA32561	120065	OR5P2	chr11	7814521	7828489	13968	olfactory receptor, family 5, subfamily P, member 2
PA32562	120066	OR5P3	chr11	7843584	7857519	13935	olfactory receptor, family 5, subfamily P, member 3
PA32564	219479	OR5R1	chr11	56181734	56195708	13974	olfactory receptor, family 5, subfamily R, member 1
PA32566	390155	OR5T1	chr11	56033115	56047095	13980	olfactory receptor, family 5, subfamily T, member 1
PA32567	219464	OR5T2	chr11	55996582	56010661	14079	olfactory receptor, family 5, subfamily T, member 2
PA32568	390154	OR5T3	chr11	56009676	56023698	14022	olfactory receptor, family 5, subfamily T, member 3
PA32570	81696	OR5V1	chr6	29320007	29334054	14047	olfactory receptor, family 5, subfamily V, member 1
PA32572	390148	OR5W2	chr11	55678126	55692058	13932	olfactory receptor, family 5, subfamily W, member 2
PA32574	8590	OR6A2	chr11	6812756	6827139	14383	olfactory receptor, family 6, subfamily A, member 2
PA32576	135946	OR6B1	chr7	143691090	143705025	13935	olfactory receptor, family 6, subfamily B, member 1
PA32577	389090	OR6B2	chr2	240965382	240982324	16942	olfactory receptor, family 6, subfamily B, member 2
PA32578	150681	OR6B3	chr2	240981494	240995489	13995	olfactory receptor, family 6, subfamily B, member 3
PA32579	390321	OR6C1	chr12	55704384	55718322	13938	olfactory receptor, family 6, subfamily C, member 1
PA32580	341416	OR6C2	chr12	55835998	55849936	13938	olfactory receptor, family 6, subfamily C, member 2
PA32581	254786	OR6C3	chr12	55715485	55729420	13935	olfactory receptor, family 6, subfamily C, member 3
PA134970819	341418	OR6C4	chr12	55935011	55948940	13929	olfactory receptor, family 6, subfamily C, member 4
PA134937223	283365	OR6C6	chr12	55685072	55699016	13944	olfactory receptor, family 6, subfamily C, member 6
PA134924624	403282	OR6C65	chr12	55784313	55798251	13938	olfactory receptor, family 6, subfamily C, member 65
PA134911831	403284	OR6C68	chr12	55876162	55890100	13938	olfactory receptor, family 6, subfamily C, member 68
PA134915898	390327	OR6C70	chr12	55859984	55873922	13938	olfactory receptor, family 6, subfamily C, member 70
PA134897737	254783	OR6C74	chr12	55631072	55645010	13938	olfactory receptor, family 6, subfamily C, member 74
PA134873229	390323	OR6C75	chr12	55748895	55762833	13938	olfactory receptor, family 6, subfamily C, member 75
PA134906466	390326	OR6C76	chr12	55810038	55823976	13938	olfactory receptor, family 6, subfamily C, member 76
PA32585	343169	OR6F1	chr1	247872131	247886057	13926	olfactory receptor, family 6, subfamily F, member 1
PA32589	81448	OR6K2	chr1	158666468	158680442	13974	olfactory receptor, family 6, subfamily K, member 2
PA32590	391114	OR6K3	chr1	158683958	158697905	13947	olfactory receptor, family 6, subfamily K, member 3
PA32593	128371	OR6K6	chr1	158714606	158728637	14031	olfactory receptor, family 6, subfamily K, member 6
PA32596	390261	OR6M1	chr11	123673116	123687057	13941	olfactory receptor, family 6, subfamily M, member 1
PA32599	128372	OR6N1	chr1	158732534	158746472	13938	olfactory receptor, family 6, subfamily N, member 1
PA32600	81442	OR6N2	chr1	158743472	158757425	13953	olfactory receptor, family 6, subfamily N, member 2
PA32601	128366	OR6P1	chr1	158529441	158543394	13953	olfactory receptor, family 6, subfamily P, member 1
PA32602	219952	OR6Q1	chr11	57788425	57802378	13953	olfactory receptor, family 6, subfamily Q, member 1
PA32604	341799	OR6S1	chr14	21105855	21119850	13995	olfactory receptor, family 6, subfamily S, member 1
PA32605	219874	OR6T1	chr11	123810574	123824545	13971	olfactory receptor, family 6, subfamily T, member 1
PA32607	346517	OR6V1	chr7	142739438	142753379	13941	olfactory receptor, family 6, subfamily V, member 1
PA32609	390260	OR6X1	chr11	123621288	123635226	13938	olfactory receptor, family 6, subfamily X, member 1
PA32610	391112	OR6Y1	chr1	158513918	158527895	13977	olfactory receptor, family 6, subfamily Y, member 1
PA32611	390892	OR7A10	chr19	14948760	14962689	13929	olfactory receptor, family 7, subfamily A, member 10
PA32616	26333	OR7A17	chr19	14988238	15002167	13929	olfactory receptor, family 7, subfamily A, member 17
PA32622	26659	OR7A5	chr19	14934139	14949276	15137	olfactory receptor, family 7, subfamily A, member 5
PA32624	26664	OR7C1	chr19	14906943	14956188	49245	olfactory receptor, family 7, subfamily C, member 1
PA32625	26658	OR7C2	chr19	15042301	15056260	13959	olfactory receptor, family 7, subfamily C, member 2
PA32627	162998	OR7D2	chr19	9286270	9302493	16223	olfactory receptor, family 7, subfamily D, member 2
PA32628	125958	OR7D4	chr19	9321526	9335547	14021	olfactory receptor, family 7, subfamily D, member 4
PA32675	26648	OR7E24	chr19	9351720	9365739	14019	olfactory receptor, family 7, subfamily E, member 24
PA32737	125962	OR7G1	chr19	9222504	9236439	13935	olfactory receptor, family 7, subfamily G, member 1
PA32738	390882	OR7G2	chr19	9209945	9223982	14037	olfactory receptor, family 7, subfamily G, member 2
PA32739	390883	OR7G3	chr19	9233688	9247626	13938	olfactory receptor, family 7, subfamily G, member 3
PA32744	390275	OR8A1	chr11	124429965	124443945	13980	olfactory receptor, family 8, subfamily A, member 1
PA32748	219858	OR8B12	chr11	124409618	124423550	13932	olfactory receptor, family 8, subfamily B, member 12
PA32750	26595	OR8B2	chr11	124249298	124286648	37350	olfactory receptor, family 8, subfamily B, member 2
PA32751	390271	OR8B3	chr11	124263306	124277247	13941	olfactory receptor, family 8, subfamily B, member 3
PA32752	283162	OR8B4	chr11	124290838	124304767	13929	olfactory receptor, family 8, subfamily B, member 4
PA32756	26493	OR8B8	chr11	124307046	124320981	13935	olfactory receptor, family 8, subfamily B, member 8
PA32760	283159	OR8D1	chr11	124176736	124190662	13926	olfactory receptor, family 8, subfamily D, member 1
PA32761	283160	OR8D2	chr11	124186158	124200093	13935	olfactory receptor, family 8, subfamily D, member 2
PA32762	338662	OR8D4	chr11	123767139	123781083	13944	olfactory receptor, family 8, subfamily D, member 4
PA32764	26494	OR8G1	chr11	124110423	124124287	13864	olfactory receptor, family 8, subfamily G, member 1 (gene/pseudogene)
PA32767	219469	OR8H1	chr11	56054603	56068538	13935	olfactory receptor, family 8, subfamily H, member 1
PA32768	390151	OR8H2	chr11	55862519	55876457	13938	olfactory receptor, family 8, subfamily H, member 2
PA32769	390152	OR8H3	chr11	55879849	55893787	13938	olfactory receptor, family 8, subfamily H, member 3
PA32771	120586	OR8I2	chr11	55850784	55864716	13932	olfactory receptor, family 8, subfamily I, member 2
PA32772	219477	OR8J1	chr11	56117691	56131764	14073	olfactory receptor, family 8, subfamily J, member 1
PA32774	81168	OR8J3	chr11	55901247	55915194	13947	olfactory receptor, family 8, subfamily J, member 3
PA32775	390157	OR8K1	chr11	56103515	56117474	13959	olfactory receptor, family 8, subfamily K, member 1
PA32777	219473	OR8K3	chr11	56075783	56089721	13938	olfactory receptor, family 8, subfamily K, member 3
PA32779	219453	OR8K5	chr11	55923870	55937793	13923	olfactory receptor, family 8, subfamily K, member 5
PA134896911	341568	OR8S1	chr12	48909415	48924886	15471	olfactory receptor, family 8, subfamily S, member 1
PA134970669	219417	OR8U1	chr11	56133100	56147029	13929	olfactory receptor, family 8, subfamily U, member 1
PA142671222	504189	OR8U8	chr11	55889677	55903636	13959	olfactory receptor, family 8, subfamily U, member 8
PA142671223	504190	OR8U9	chr11	-1	-1	0	olfactory receptor, family 8, subfamily U, member 9
PA32785	135924	OR9A2	chr7	142720287	142734219	13932	olfactory receptor, family 9, subfamily A, member 2
PA32787	130075	OR9A4	chr7	141608676	141622620	13944	olfactory receptor, family 9, subfamily A, member 4
PA32788	390174	OR9G1	chr11	56457864	56471781	13917	olfactory receptor, family 9, subfamily G, member 1
PA32791	283189	OR9G4	chr11	56507304	56521287	13983	olfactory receptor, family 9, subfamily G, member 4
PA142671224	504191	OR9G9	chr11	56457865	56471782	13917	olfactory receptor, family 9, subfamily G, member 9
PA32794	219954	OR9I1	chr11	57882972	57896916	13944	olfactory receptor, family 9, subfamily I, member 1
PA32799	441639	OR9K2	chr12	55513553	55527560	14007	olfactory receptor, family 9, subfamily K, member 2
PA32805	219956	OR9Q1	chr11	57781353	57952059	170706	olfactory receptor, family 9, subfamily Q, member 1
PA32806	219957	OR9Q2	chr11	57947906	57961990	14084	olfactory receptor, family 9, subfamily Q, member 2
PA162398445	84876	ORAI1	chr12	122054455	122082946	28491	ORAI calcium release-activated calcium modulator 1
PA162398454	80228	ORAI2	chr7	102063977	102100268	36291	ORAI calcium release-activated calcium modulator 2
PA162398465	93129	ORAI3	chr16	30950405	30969259	18854	ORAI calcium release-activated calcium modulator 3
PA38242	220064	ORAOV1	chr11	69477331	69500165	22834	oral cancer overexpressed 1
PA32808	4998	ORC1	chr1	52835501	52880143	44642	origin recognition complex, subunit 1
PA32809	4999	ORC2	chr2	201771894	201838424	66530	origin recognition complex, subunit 2
PA32810	23595	ORC3	chr6	88289785	88380172	90387	origin recognition complex, subunit 3
PA32811	5000	ORC4	chr2	148684966	148789173	104207	origin recognition complex, subunit 4
PA32812	5001	ORC5	chr7	103763788	103858495	94707	origin recognition complex, subunit 5
PA32813	23594	ORC6	chr16	46713558	46735306	21748	origin recognition complex, subunit 6
PA260	5004	ORM1	chr9	117075303	117091759	16456	orosomucoid 1
PA32818	5005	ORM2	chr9	117082069	117098536	16467	orosomucoid 2
PA32819	94101	ORMDL1	chr2	190631993	190659097	27104	ORMDL sphingolipid biosynthesis regulator 1
PA32820	29095	ORMDL2	chr12	56201806	56217959	16153	ORMDL sphingolipid biosynthesis regulator 2
PA32821	94103	ORMDL3	chr17	38074294	38093884	19590	ORMDL sphingolipid biosynthesis regulator 3
PA164724245	10956	OS9	chr12	58077738	58118340	40602	osteosarcoma amplified 9, endoplasmic reticulum lectin
PA32822	5007	OSBP	chr11	59338871	59393617	54746	oxysterol binding protein
PA32823	23762	OSBP2	chr22	31079769	31306811	227042	oxysterol binding protein 2
PA32824	114884	OSBPL10	chr3	31699317	32033342	334025	oxysterol binding protein-like 10
PA32825	114885	OSBPL11	chr3	125244702	125324381	79679	oxysterol binding protein-like 11
PA32826	114876	OSBPL1A	chr18	21739009	21987846	248837	oxysterol binding protein-like 1A
PA32827	9885	OSBPL2	chr20	60803541	60874269	70728	oxysterol binding protein-like 2
PA32828	26031	OSBPL3	chr7	24833159	25029818	196659	oxysterol binding protein-like 3
PA32829	114879	OSBPL5	chr11	3105345	3196582	91237	oxysterol binding protein-like 5
PA32830	114880	OSBPL6	chr2	179049208	179267160	217952	oxysterol binding protein-like 6
PA32831	114881	OSBPL7	chr17	45881733	45909169	27436	oxysterol binding protein-like 7
PA32832	114882	OSBPL8	chr12	76742577	76963589	221012	oxysterol binding protein-like 8
PA32833	114883	OSBPL9	chr1	52072546	52257891	185345	oxysterol binding protein-like 9
PA162398474	126014	OSCAR	chr19	54594933	54614159	19226	osteoclast associated, immunoglobulin-like receptor
PA165752125	127700	OSCP1	chr1	36880507	36926086	45579	organic solute carrier partner 1
PA25651	51526	OSER1	chr20	42821579	42849702	28123	oxidative stress responsive serine-rich 1
PA32834	55644	OSGEP	chr14	20912207	20933267	21060	O-sialoglycoprotein endopeptidase
PA134959704	64172	OSGEPL1	chr2	190608386	190638020	29634	O-sialoglycoprotein endopeptidase-like 1
PA162398489	29948	OSGIN1	chr16	83972594	84002937	30343	oxidative stress induced growth inhibitor 1
PA162398506	734	OSGIN2	chr8	90904096	90943096	39000	oxidative stress induced growth inhibitor family member 2
PA32836	5008	OSM	chr22	30655817	30672829	17012	oncostatin M
PA32837	9180	OSMR	chr5	38835960	38938743	102783	oncostatin M receptor
PA164742217	130497	OSR1	chr2	19548246	19568372	20126	odd-skipped related transciption factor 1
PA134924513	116039	OSR2	chr8	99946631	99967338	20707	odd-skipped related transciption factor 2
PA165697090	100128731	OST4	chr2	27290340	27304567	14227	oligosaccharyltransferase 4 homolog (S. cerevisiae)
PA164724280	58505	OSTC	chr4	109561741	109591978	30237	oligosaccharyltransferase complex subunit (non-catalytic)
PA32839	26578	OSTF1	chr9	77693398	77765114	71716	osteoclast stimulating factor 1
PA134941162	28962	OSTM1	chr6	108359613	108405941	46328	osteopetrosis associated transmembrane protein 1
PA134912892	344901	OSTN	chr3	190907039	190986404	79365	osteocrin
PA32840	5009	OTC	chrX	38201736	38283703	81967	ornithine carbamoyltransferase
PA38403	146183	OTOA	chr16	21679835	21775050	95215	otoancorin
PA32841	9381	OTOF	chr2	26677071	26791566	114495	otoferlin
PA32842	340990	OTOG	chr11	17558920	17670491	111571	otogelin
PA162377849	283310	OTOGL	chr12	80573151	80775870	202719	otogelin-like
PA134883507	133060	OTOP1	chr4	4187530	4238621	51091	otopetrin 1
PA134930692	92736	OTOP2	chr17	72910370	72933006	22636	otopetrin 2
PA134888566	347741	OTOP3	chr17	72921897	72949087	27190	otopetrin 3
PA32843	56914	OTOR	chr20	16718998	16735809	16811	otoraplin
PA134906408	150677	OTOS	chr2	241075446	241090073	14627	otospiralin
PA32844	23440	OTP	chr5	76921537	76944522	22985	orthopedia homeobox
PA134988141	55611	OTUB1	chr11	63743325	63768892	25567	OTU deubiquitinase, ubiquitin aldehyde binding 1
PA134861658	78990	OTUB2	chr14	94479511	94518276	38765	OTU deubiquitinase, ubiquitin aldehyde binding 2
PA134932304	220213	OTUD1	chr10	23718198	23734310	16112	OTU deubiquitinase 1
PA142671215	23252	OTUD3	chr1	20198356	20242438	44082	OTU deubiquitinase 3
PA142671216	54726	OTUD4	chr4	146051802	146111768	59966	OTU deubiquitinase 4
PA142671217	55593	OTUD5	chrX	48776301	48825880	49579	OTU deubiquitinase 5
PA142671218	139562	OTUD6A	chrX	69272341	69287029	14688	OTU deubiquitinase 6A
PA142671219	51633	OTUD6B	chr8	92072424	92102323	29899	OTU domain containing 6B
PA134877572	161725	OTUD7A	chr15	31770884	32172875	401991	OTU deubiquitinase 7A
PA134873802	56957	OTUD7B	chr1	149909229	149992686	83457	OTU deubiquitinase 7B
PA142671789	90268	OTULIN	chr5	14654783	14702842	48059	OTU deubiquitinase with linear linkage specificity
PA32848	5013	OTX1	chr2	63267192	63287966	20774	orthodenticle homeobox 1
PA32849	5015	OTX2	chr14	57264425	57287194	22769	orthodenticle homeobox 2
PA165432281	124641	OVCA2	chr17	1935277	1949725	14448	ovarian tumor suppressor candidate 2
PA134910581	341350	OVCH1	chr12	29577489	29660619	83130	ovochymase 1
PA142671212	341277	OVCH2	chr11	7707669	7738001	30332	ovochymase 2 (gene/pseudogene)
PA32852	5016	OVGP1	chr1	111953937	111980399	26462	oviductal glycoprotein 1, 120kDa
PA32853	5017	OVOL1	chr11	65544505	65567690	23185	ovo-like zinc finger 1
PA38039	58495	OVOL2	chr20	18001796	18049834	48038	ovo-like zinc finger 2
PA32854	5018	OXA1L	chr14	23225731	23243998	18267	oxidase (cytochrome c) assembly 1-like
PA32855	5019	OXCT1	chr5	41727167	41880791	153624	3-oxoacid CoA transferase 1
PA38360	64064	OXCT2	chr1	40232197	40247020	14823	3-oxoacid CoA transferase 2
PA134983779	165140	OXER1	chr2	42986639	43001401	14762	oxoeicosanoid (OXE) receptor 1
PA28924	27199	OXGR1	chr13	97634973	97656984	22011	oxoglutarate (alpha-ketoglutarate) receptor 1
PA162378543	339229	OXLD1	chr17	79629066	79643618	14552	oxidoreductase-like domain containing 1
PA142671213	92106	OXNAD1	chr3	16296667	16382000	85333	oxidoreductase NAD-binding domain containing 1
PA32856	55074	OXR1	chr8	107272406	107767922	495516	oxidation resistance 1
PA142671214	54995	OXSM	chr3	25821563	25839025	17462	3-oxoacyl-ACP synthase, mitochondrial
PA134973207	9943	OXSR1	chr3	38197022	38299979	102957	oxidative stress responsive 1
PA32857	5020	OXT	chr20	3042266	3056163	13897	oxytocin/neurophysin I prepropeptide
PA32858	5021	OXTR	chr3	8789094	8821300	32206	oxytocin receptor
PA32861	5023	P2RX1	chr17	3796885	3829960	33075	purinergic receptor P2X, ligand-gated ion channel, 1
PA32862	22953	P2RX2	chr12	133185393	133201972	16579	purinergic receptor P2X, ligand-gated ion channel, 2
PA32863	5024	P2RX3	chr11	57095841	57140549	44708	purinergic receptor P2X, ligand-gated ion channel, 3
PA32864	5025	P2RX4	chr12	121637664	121674909	37245	purinergic receptor P2X, ligand-gated ion channel, 4
PA32865	5026	P2RX5	chr17	3572156	3609698	37542	purinergic receptor P2X, ligand-gated ion channel, 5
PA162398523	9127	P2RX6	chr22	21359442	21385302	25860	purinergic receptor P2X, ligand-gated ion channel, 6
PA32866	5027	P2RX7	chr12	121560622	121627439	66817	purinergic receptor P2X, ligand-gated ion channel, 7
PA32868	5028	P2RY1	chr3	152542736	152558845	16109	purinergic receptor P2Y, G-protein coupled, 1
PA134873055	27334	P2RY10	chrX	78190829	78222224	31395	purinergic receptor P2Y, G-protein coupled, 10
PA32869	5032	P2RY11	chr19	10212197	10229065	16868	purinergic receptor P2Y, G-protein coupled, 11
PA134971947	64805	P2RY12	chr3	151051631	151112600	60969	purinergic receptor P2Y, G-protein coupled, 12
PA28930	53829	P2RY13	chr3	151041096	151057337	16241	purinergic receptor P2Y, G-protein coupled, 13
PA28853	9934	P2RY14	chr3	150926905	151006996	80091	purinergic receptor P2Y, G-protein coupled, 14
PA32870	5029	P2RY2	chr11	72918735	72956472	37737	purinergic receptor P2Y, G-protein coupled, 2
PA32871	5030	P2RY4	chrX	69475016	69489654	14638	pyrimidinergic receptor P2Y, G-protein coupled, 4
PA32872	5031	P2RY6	chr11	72965550	73012670	47120	pyrimidinergic receptor P2Y, G-protein coupled, 6
PA32873	286530	P2RY8	chrY	1528465	1616037	87572	purinergic receptor P2Y, G-protein coupled, 8
PA32874	5033	P4HA1	chr10	74763975	74866732	102757	prolyl 4-hydroxylase, alpha polypeptide I
PA32875	8974	P4HA2	chr5	131525299	131573556	48257	prolyl 4-hydroxylase, alpha polypeptide II
PA134870931	283208	P4HA3	chr11	73955532	74032699	77167	prolyl 4-hydroxylase, alpha polypeptide III
PA32876	5034	P4HB	chr17	79798034	79828566	30532	prolyl 4-hydroxylase, beta polypeptide
PA164724295	54681	P4HTM	chr3	49017304	49047582	30278	prolyl 4-hydroxylase, transmembrane (endoplasmic reticulum)
PA32877	5036	PA2G4	chr12	56488103	56510694	22591	proliferation-associated 2G4, 38kDa
PA162398551	80227	PAAF1	chr11	73577744	73641781	64037	proteasomal ATPase-associated factor 1
PA32880	26986	PABPC1	chr8	101712144	101744969	32825	poly(A) binding protein, cytoplasmic 1
PA162398552	80336	PABPC1L	chr20	43528701	43590585	61884	poly(A) binding protein, cytoplasmic 1-like
PA162398587	340529	PABPC1L2A	chrX	72294177	72309351	15174	poly(A) binding protein, cytoplasmic 1-like 2A
PA162398594	645974	PABPC1L2B	chrX	72213352	72228551	15199	poly(A) binding protein, cytoplasmic 1-like 2B
PA32886	728773	PABPC1P2	chr2	147334625	147351558	16933	poly(A) binding protein, cytoplasmic 1 pseudogene 2
PA32882	5042	PABPC3	chr13	25660276	25675705	15429	poly(A) binding protein, cytoplasmic 3
PA32883	8761	PABPC4	chr1	40023485	40052522	29037	poly(A) binding protein, cytoplasmic 4 (inducible form)
PA32884	140886	PABPC5	chrX	90679597	90696583	16986	poly(A) binding protein, cytoplasmic 5
PA32891	8106	PABPN1	chr14	23779397	23798394	18997	poly(A) binding protein, nuclear 1
PA165450439	390748	PABPN1L	chr16	88926746	88943068	16322	poly(A) binding protein, nuclear 1-like (cytoplasmic)
PA134909011	135138	PACRG	chr6	163138164	163739524	601360	PARK2 co-regulated
PA164724318	133015	PACRGL	chr4	20692036	20732980	40944	PARK2 co-regulated-like
PA134989529	55690	PACS1	chr11	65827747	66015218	187471	phosphofurin acidic cluster sorting protein 1
PA134941470	23241	PACS2	chr14	105757170	105867484	110314	phosphofurin acidic cluster sorting protein 2
PA32896	29993	PACSIN1	chr6	34423838	34506000	82162	protein kinase C and casein kinase substrate in neurons 1
PA32897	11252	PACSIN2	chr22	43262772	43421184	158412	protein kinase C and casein kinase substrate in neurons 2
PA32898	29763	PACSIN3	chr11	47196073	47218010	21937	protein kinase C and casein kinase substrate in neurons 3
PA32899	29943	PADI1	chr1	17521621	17575501	53880	peptidyl arginine deiminase, type I
PA32900	11240	PADI2	chr1	17390256	17455948	65692	peptidyl arginine deiminase, type II
PA32901	51702	PADI3	chr1	17565593	17613728	48135	peptidyl arginine deiminase, type III
PA32903	23569	PADI4	chr1	17624690	17693495	68805	peptidyl arginine deiminase, type IV
PA32904	5047	PAEP	chr9	138443601	138461622	18021	progestagen-associated endometrial protein
PA142671206	54623	PAF1	chr19	39873269	39891835	18566	Paf1, RNA polymerase II associated factor, homolog (S. cerevisiae)
PA32905	5048	PAFAH1B1	chr17	2486923	2591909	104986	platelet-activating factor acetylhydrolase 1b, regulatory subunit 1 (45kDa)
PA32906	5049	PAFAH1B2	chr11	117005000	117051889	46889	platelet-activating factor acetylhydrolase 1b, catalytic subunit 2 (30kDa)
PA32907	5050	PAFAH1B3	chr19	42798185	42816952	18767	platelet-activating factor acetylhydrolase 1b, catalytic subunit 3 (29kDa)
PA32910	5051	PAFAH2	chr1	26283258	26336366	53108	platelet-activating factor acetylhydrolase 2, 40kDa
PA142671201	55824	PAG1	chr8	81877045	82034303	157258	phosphoprotein membrane anchor with glycosphingolipid microdomains 1
PA28522	8712	PAGE1	chrX	49449053	49470596	21543	P antigen family, member 1 (prostate associated)
PA142671202	203569	PAGE2	chrX	55105497	55122260	16763	P antigen family, member 2 (prostate associated)
PA142671203	389860	PAGE2B	chrX	55091489	55108336	16847	P antigen family, member 2B
PA28523	9506	PAGE4	chrX	49583863	49601572	17709	P antigen family, member 4 (prostate associated)
PA142671204	90737	PAGE5	chrX	55236791	55253541	16750	P antigen family, member 5 (prostate associated)
PA142672260	79447	PAGR1	chr16	29817528	29836816	19288	PAXIP1 associated glutamate-rich protein 1
PA32911	5053	PAH	chr12	103229104	103321381	92277	phenylalanine hydroxylase
PA32914	10606	PAICS	chr4	57266682	57330534	63852	phosphoribosylaminoimidazole carboxylase, phosphoribosylaminoimidazole succinocarboxamide synthetase
PA134941557	10605	PAIP1	chr5	43523369	43567521	44152	poly(A) binding protein interacting protein 1
PA134897284	51247	PAIP2	chr5	138667519	138708409	40890	poly(A) binding protein interacting protein 2
PA162398595	400961	PAIP2B	chr2	71406868	71464233	57365	poly(A) binding protein interacting protein 2B
PA32917	5058	PAK1	chr11	77030060	77195108	165048	p21 protein (Cdc42/Rac)-activated kinase 1
PA134928299	55003	PAK1IP1	chr6	10685180	10713015	27835	PAK1 interacting protein 1
PA32918	5062	PAK2	chr3	196456728	196562518	105790	p21 protein (Cdc42/Rac)-activated kinase 2
PA32919	5063	PAK3	chrX	110177513	110473590	296077	p21 protein (Cdc42/Rac)-activated kinase 3
PA32920	10298	PAK4	chr19	39606417	39673046	66629	p21 protein (Cdc42/Rac)-activated kinase 4
PA32921	56924	PAK6	chr15	40499629	40572688	73059	p21 protein (Cdc42/Rac)-activated kinase 6
PA32922	57144	PAK7	chr20	9515037	9829687	314650	p21 protein (Cdc42/Rac)-activated kinase 7
PA162398608	79728	PALB2	chr16	23611481	23662678	51197	partner and localizer of BRCA2
PA134986569	27143	PALD1	chr10	72228564	72331206	102642	phosphatase domain containing, paladin 1
PA142671205	23022	PALLD	chr4	169408215	169852608	444393	palladin, cytoskeletal associated protein
PA32923	5064	PALM	chr19	698953	751330	52377	paralemmin
PA32924	114299	PALM2	chr9	112393068	112716756	323688	paralemmin 2
PA162398639	445815	PALM2-AKAP2	chr9	112532577	112937792	405215	PALM2-AKAP2 readthrough
PA165393890	342979	PALM3	chr19	14161179	14182908	21729	paralemmin 3
PA32925	54873	PALMD	chr1	100101431	100163097	61666	palmdelphin
PA32926	5066	PAM	chr5	102191527	102369809	178282	peptidylglycine alpha-amidating monooxygenase
PA164724339	25891	PAMR1	chr11	35450374	35561848	111474	peptidase domain containing associated with muscle regeneration 1
PA162398664	9924	PAN2	chr12	56707007	56737837	30830	PAN2 poly(A) specific ribonuclease subunit
PA144596398	255967	PAN3	chr13	28700997	28872475	171478	PAN3 poly(A) specific ribonuclease subunit
PA32928	53354	PANK1	chr10	91336254	91415329	79075	pantothenate kinase 1
PA38048	80025	PANK2	chr20	3859486	3907538	48052	pantothenate kinase 2
PA134903180	79646	PANK3	chr5	167979628	168016614	36986	pantothenate kinase 3
PA134887214	55229	PANK4	chr1	2436975	2468061	31086	pantothenate kinase 4
PA32929	24145	PANX1	chr11	93852094	93921762	69668	pannexin 1
PA32930	56666	PANX2	chr22	50599160	50621724	22564	pannexin 2
PA134920643	116337	PANX3	chr11	124471453	124493252	21799	pannexin 3
PA134907695	196743	PAOX	chr10	135182741	135208198	25457	polyamine oxidase (exo-N4-amino)
PA134918975	167153	PAPD4	chr5	78898243	78985471	87228	PAP associated domain containing 4
PA134949693	64282	PAPD5	chr16	50176829	50272221	95392	PAP associated domain containing 5
PA33523	11044	PAPD7	chr5	6704076	6760161	56085	PAP associated domain containing 7
PA134914395	89932	PAPLN	chr14	73694205	73744348	50143	papilin, proteoglycan-like sulfated glycoprotein
PA32932	10914	PAPOLA	chr14	96958713	97036453	77740	poly(A) polymerase alpha
PA32933	56903	PAPOLB	chr7	4894369	4911625	17256	poly(A) polymerase beta (testis specific)
PA32934	64895	PAPOLG	chr2	60973365	61032221	58856	poly(A) polymerase gamma
PA32935	5069	PAPPA	chr9	118906071	119167600	261529	pregnancy-associated plasma protein A, pappalysin 1
PA33373	60676	PAPPA2	chr1	176422307	176817737	395430	pappalysin 2
PA384	9061	PAPSS1	chr4	108531822	108651419	119597	3'-phosphoadenosine 5'-phosphosulfate synthase 1
PA383	9060	PAPSS2	chr10	89409476	89510462	100986	3'-phosphoadenosine 5'-phosphosulfate synthase 2
PA134952039	152559	PAQR3	chr4	79833364	79870582	37218	progestin and adipoQ receptor family member III
PA134945614	124222	PAQR4	chr16	3009342	3026485	17143	progestin and adipoQ receptor family member IV
PA142671199	54852	PAQR5	chr15	69581294	69702976	121682	progestin and adipoQ receptor family member V
PA134931897	79957	PAQR6	chr1	156210112	156227908	17796	progestin and adipoQ receptor family member VI
PA142671200	164091	PAQR7	chr1	26184975	26212461	27486	progestin and adipoQ receptor family member VII
PA25934	85315	PAQR8	chr6	52216926	52275575	58649	progestin and adipoQ receptor family member VIII
PA134880790	344838	PAQR9	chr3	142677073	142692818	15745	progestin and adipoQ receptor family member IX
PA32936	56288	PARD3	chr10	34395488	35114253	718765	par-3 family cell polarity regulator
PA162398721	117583	PARD3B	chr2	205400516	206487886	1087370	par-3 family cell polarity regulator beta
PA32937	50855	PARD6A	chr16	67684851	67699681	14830	par-6 family cell polarity regulator alpha
PA32938	84612	PARD6B	chr20	49337923	49376333	38410	par-6 family cell polarity regulator beta
PA32939	84552	PARD6G	chr18	77912115	78015397	103282	par-6 family cell polarity regulator gamma
PA32940	8505	PARG	chr10	51023325	51381346	358021	poly (ADP-ribose) glycohydrolase
PA32942	5071	PARK2	chr6	161765590	163158834	1393244	parkin RBR E3 ubiquitin protein ligase
PA32946	11315	PARK7	chr1	8011714	8048342	36628	parkinson protein 7
PA134939789	55486	PARL	chr3	183540522	183612693	72171	presenilin associated, rhomboid-like
PA165664393	25849	PARM1	chr4	75848285	75978325	130040	prostate androgen-regulated mucin-like protein 1
PA32949	5073	PARN	chr16	14526557	14734128	207571	poly(A)-specific ribonuclease
PA32	142	PARP1	chr1	226545392	226605801	60409	poly (ADP-ribose) polymerase 1
PA134892853	84875	PARP10	chr8	145048320	145070635	22315	poly (ADP-ribose) polymerase family, member 10
PA25507	57097	PARP11	chr12	3904410	3992608	88198	poly (ADP-ribose) polymerase family, member 11
PA134953063	64761	PARP12	chr7	139720544	139774086	53542	poly (ADP-ribose) polymerase family, member 12
PA134861585	54625	PARP14	chr3	122389672	122452687	63015	poly (ADP-ribose) polymerase family, member 14
PA134905094	165631	PARP15	chr3	122286435	122360894	74459	poly (ADP-ribose) polymerase family, member 15
PA134984504	54956	PARP16	chr15	65547436	65589212	41776	poly (ADP-ribose) polymerase family, member 16
PA24592	10038	PARP2	chr14	20801773	20829063	27290	poly (ADP-ribose) polymerase 2
PA24593	10039	PARP3	chr3	51966297	51985883	19586	poly (ADP-ribose) polymerase family, member 3
PA24591	143	PARP4	chr13	24992069	25096948	104879	poly (ADP-ribose) polymerase family, member 4
PA134900863	56965	PARP6	chr15	72530522	72574885	44363	poly (ADP-ribose) polymerase family, member 6
PA134903201	79668	PARP8	chr5	49951733	50145356	193623	poly (ADP-ribose) polymerase family, member 8
PA134870403	83666	PARP9	chr3	122243757	122293523	49766	poly (ADP-ribose) polymerase family, member 9
PA143485378	55010	PARPBP	chr12	102503956	102594298	90342	PARP1 binding protein
PA142671198	25973	PARS2	chr1	55219571	55240226	20655	prolyl-tRNA synthetase 2, mitochondrial (putative)
PA32950	55742	PARVA	chr11	12387988	12559903	171915	parvin, alpha
PA32951	29780	PARVB	chr22	44385091	44568113	183022	parvin, beta
PA32952	64098	PARVG	chr22	44556271	44607349	51078	parvin, gamma
PA134909788	139135	PASD1	chrX	150722007	150848211	126204	PAS domain containing 1
PA32953	23178	PASK	chr2	242042514	242099394	56880	PAS domain containing serine/threonine kinase
PA164724368	160065	PATE1	chr11	125606180	125622743	16563	prostate and testis expressed 1
PA164724383	399967	PATE2	chr11	125643025	125658714	15689	prostate and testis expressed 2
PA164724396	100169851	PATE3	chr11	125648006	125664495	16489	prostate and testis expressed 3
PA164724397	399968	PATE4	chr11	125693211	125712967	19756	prostate and testis expressed 4
PA162398769	219988	PATL1	chr11	59401189	59446513	45324	protein associated with topoisomerase II homolog 1 (yeast)
PA164724408	197135	PATL2	chr15	44954930	44980894	25964	protein associated with topoisomerase II homolog 2 (yeast)
PA162398806	23598	PATZ1	chr22	31718790	31752249	33459	POZ (BTB) and AT hook containing zinc finger 1
PA32954	5074	PAWR	chr12	79982745	80094877	112132	PRKC, apoptosis, WT1, regulator
PA32955	5075	PAX1	chr20	21676297	21702124	25827	paired box 1
PA32956	5076	PAX2	chr10	102485316	102592698	107382	paired box 2
PA32957	5077	PAX3	chr2	223061606	223173715	112109	paired box 3
PA32958	5078	PAX4	chr7	127247346	127265982	18636	paired box 4
PA32959	5079	PAX5	chr9	36830272	37044476	214204	paired box 5
PA32960	5080	PAX6	chr11	31803340	31849509	46169	paired box 6
PA32961	5081	PAX7	chr1	18947500	19078360	130860	paired box 7
PA32962	7849	PAX8	chr2	113970574	114046527	75953	paired box 8
PA32963	5083	PAX9	chr14	37116773	37150012	33239	paired box 9
PA25861	94104	PAXBP1	chr21	34103210	34154169	50959	PAX3 and PAX7 binding protein 1
PA32964	22976	PAXIP1	chr7	154732400	154804682	72282	PAX interacting (with transcription-activation domain) protein 1
PA128394657	51260	PBDC1	chrX	75382771	75401033	18262	polysaccharide biosynthesis domain containing 1
PA134925802	55872	PBK	chr8	27664138	27705612	41474	PDZ binding kinase
PA162398821	64081	PBLD	chr10	70039417	70106115	66698	phenazine biosynthesis-like protein domain containing
PA134869958	59351	PBOV1	chr6	138534123	138549627	15504	prostate and breast cancer overexpressed 1
PA162398846	55193	PBRM1	chr3	52576368	52729866	153498	polybromo 1
PA32970	5087	PBX1	chr1	164518597	164824067	305470	pre-B-cell leukemia homeobox 1
PA32971	5089	PBX2	chr6	32149510	32167963	18453	pre-B-cell leukemia homeobox 2
PA32972	5090	PBX3	chr9	128499617	128732656	233039	pre-B-cell leukemia homeobox 3
PA32973	80714	PBX4	chr19	19669516	19739725	70209	pre-B-cell leukemia homeobox 4
PA134956095	57326	PBXIP1	chr1	154913553	154938624	25071	pre-B-cell leukemia homeobox interacting protein 1
PA32975	5091	PC	chr11	66612993	66735847	122854	pyruvate carboxylase
PA32985	5092	PCBD1	chr10	72639037	72658541	19504	pterin-4 alpha-carbinolamine dehydratase/dimerization cofactor of hepatocyte nuclear factor 1 alpha
PA142671197	84105	PCBD2	chr5	134230810	134301336	70526	pterin-4 alpha-carbinolamine dehydratase/dimerization cofactor of hepatocyte nuclear factor 1 alpha (TCF1) 2
PA32986	5093	PCBP1	chr2	70303972	70319335	15363	poly(rC) binding protein 1
PA32987	5094	PCBP2	chr12	53835886	53877946	42060	poly(rC) binding protein 2
PA32990	54039	PCBP3	chr21	47258023	47365368	107345	poly(rC) binding protein 3
PA32991	57060	PCBP4	chr3	51988470	52011482	23012	poly(rC) binding protein 4
PA32992	5095	PCCA	chr13	100731269	101185691	454422	propionyl CoA carboxylase, alpha polypeptide
PA32993	5096	PCCB	chr3	135959167	136059737	100570	propionyl CoA carboxylase, beta polypeptide
PA32994	5097	PCDH1	chr5	141229655	141268361	38706	protocadherin 1
PA32995	57575	PCDH10	chr4	134060470	134115732	55262	protocadherin 10
PA32996	27328	PCDH11X	chrX	91024260	91881229	856969	protocadherin 11 X-linked
PA32997	83259	PCDH11Y	chrY	4858267	5613269	755002	protocadherin 11 Y-linked
PA32998	51294	PCDH12	chr5	141320150	141348627	28477	protocadherin 12
PA32999	65217	PCDH15	chr10	55559531	56571051	1011520	protocadherin-related 15
PA33001	27253	PCDH17	chr13	58194238	58306445	112207	protocadherin 17
PA33002	54510	PCDH18	chr4	138437072	138463629	26557	protocadherin 18
PA33003	57526	PCDH19	chrX	99543642	99675271	131629	protocadherin 19
PA33004	64881	PCDH20	chr13	61980818	61999655	18837	protocadherin 20
PA33006	5099	PCDH7	chr4	30711951	31151423	439472	protocadherin 7
PA33007	5100	PCDH8	chr13	53415109	53432775	17666	protocadherin 8
PA33008	5101	PCDH9	chr13	66873966	67814468	940502	protocadherin 9
PA33009	56147	PCDHA1	chr5	140155876	140394929	239053	protocadherin alpha 1
PA33010	56139	PCDHA10	chr5	140225634	140394929	169295	protocadherin alpha 10
PA33011	56138	PCDHA11	chr5	140237831	140394929	157098	protocadherin alpha 11
PA33012	56137	PCDHA12	chr5	140244931	140394929	149998	protocadherin alpha 12
PA33013	56136	PCDHA13	chr5	140251854	140394929	143075	protocadherin alpha 13
PA33014	56146	PCDHA2	chr5	140164444	140394929	230485	protocadherin alpha 2
PA33015	56145	PCDHA3	chr5	140170783	140394929	224146	protocadherin alpha 3
PA33016	56144	PCDHA4	chr5	140176672	140394929	218257	protocadherin alpha 4
PA33017	56143	PCDHA5	chr5	140191361	140394929	203568	protocadherin alpha 5
PA33018	56142	PCDHA6	chr5	140197650	140394929	197279	protocadherin alpha 6
PA33019	56141	PCDHA7	chr5	140203969	140394929	190960	protocadherin alpha 7
PA33020	56140	PCDHA8	chr5	140210907	140394929	184022	protocadherin alpha 8
PA33021	9752	PCDHA9	chr5	140217357	140394929	177572	protocadherin alpha 9
PA33022	56135	PCDHAC1	chr5	140296302	140394929	98627	protocadherin alpha subfamily C, 1
PA33023	56134	PCDHAC2	chr5	140335747	140394929	59182	protocadherin alpha subfamily C, 2
PA33025	29930	PCDHB1	chr5	140420979	140436512	15533	protocadherin beta 1
PA33026	56126	PCDHB10	chr5	140561952	140578213	16261	protocadherin beta 10
PA33027	56125	PCDHB11	chr5	140569348	140585618	16270	protocadherin beta 11
PA33028	56124	PCDHB12	chr5	140578291	140594698	16407	protocadherin beta 12
PA33029	56123	PCDHB13	chr5	140583509	140599993	16484	protocadherin beta 13
PA33030	56122	PCDHB14	chr5	140593078	140608860	15782	protocadherin beta 14
PA33031	56121	PCDHB15	chr5	140615147	140630802	15655	protocadherin beta 15
PA33032	57717	PCDHB16	chr5	140550980	140568796	17816	protocadherin beta 16
PA33036	56133	PCDHB2	chr5	140464237	140479964	15727	protocadherin beta 2
PA33037	56132	PCDHB3	chr5	140470234	140486406	16172	protocadherin beta 3
PA33038	56131	PCDHB4	chr5	140491581	140508201	16620	protocadherin beta 4
PA33039	26167	PCDHB5	chr5	140504800	140520704	15904	protocadherin beta 5
PA33040	56130	PCDHB6	chr5	140519839	140535868	16029	protocadherin beta 6
PA33041	56129	PCDHB7	chr5	140542243	140558957	16714	protocadherin beta 7
PA33042	56128	PCDHB8	chr5	140547371	140563081	15710	protocadherin beta 8
PA33043	56127	PCDHB9	chr5	140556893	140574111	17218	protocadherin beta 9
PA33044	56114	PCDHGA1	chr5	140700252	140895546	195294	protocadherin gamma subfamily A, 1
PA33045	56106	PCDHGA10	chr5	140782743	140895546	112803	protocadherin gamma subfamily A, 10
PA33046	56105	PCDHGA11	chr5	140790537	140895546	105009	protocadherin gamma subfamily A, 11
PA33047	26025	PCDHGA12	chr5	140800158	140895546	95388	protocadherin gamma subfamily A, 12
PA33048	56113	PCDHGA2	chr5	140708354	140895546	187192	protocadherin gamma subfamily A, 2
PA33049	56112	PCDHGA3	chr5	140713601	140895546	181945	protocadherin gamma subfamily A, 3
PA33050	56111	PCDHGA4	chr5	140724768	140895546	170778	protocadherin gamma subfamily A, 4
PA33051	56110	PCDHGA5	chr5	140733898	140895546	161648	protocadherin gamma subfamily A, 5
PA33052	56109	PCDHGA6	chr5	140743651	140895546	151895	protocadherin gamma subfamily A, 6
PA33053	56108	PCDHGA7	chr5	140752467	140895546	143079	protocadherin gamma subfamily A, 7
PA33054	9708	PCDHGA8	chr5	140761483	140895546	134063	protocadherin gamma subfamily A, 8
PA33055	56107	PCDHGA9	chr5	140772520	140895546	123026	protocadherin gamma subfamily A, 9
PA33056	56104	PCDHGB1	chr5	140719828	140895546	175718	protocadherin gamma subfamily B, 1
PA33057	56103	PCDHGB2	chr5	140729703	140895546	165843	protocadherin gamma subfamily B, 2
PA33058	56102	PCDHGB3	chr5	140739962	140895546	155584	protocadherin gamma subfamily B, 3
PA33059	8641	PCDHGB4	chr5	140757452	140895546	138094	protocadherin gamma subfamily B, 4
PA33061	56100	PCDHGB6	chr5	140777770	140895546	117776	protocadherin gamma subfamily B, 6
PA33062	56099	PCDHGB7	chr5	140787214	140895548	108334	protocadherin gamma subfamily B, 7
PA33064	5098	PCDHGC3	chr5	140845569	140895546	49977	protocadherin gamma subfamily C, 3
PA33065	56098	PCDHGC4	chr5	140854741	140895546	40805	protocadherin gamma subfamily C, 4
PA33066	56097	PCDHGC5	chr5	140858808	140895546	36738	protocadherin gamma subfamily C, 5
PA25790	64773	PCED1A	chr20	2812960	2831889	18929	PC-esterase domain containing 1A
PA143485471	91523	PCED1B	chr12	47463386	47633446	170060	PC-esterase domain containing 1B
PA142671196	51585	PCF11	chr11	82858137	82899836	41699	PCF11 cleavage and polyadenylation factor subunit
PA134976631	84759	PCGF1	chr2	74729170	74745707	16537	polycomb group ring finger 1
PA37516	7703	PCGF2	chr17	36887150	36916070	28920	polycomb group ring finger 2
PA34433	10336	PCGF3	chr4	689537	767428	77891	polycomb group ring finger 3
PA134929149	84333	PCGF5	chr10	92912769	93047088	134319	polycomb group ring finger 5
PA134887110	84108	PCGF6	chr10	105059553	105120891	61338	polycomb group ring finger 6
PA144596397	55795	PCID2	chr13	113828853	113873335	44482	PCI domain containing 2
PA162398977	63935	PCIF1	chr20	44553313	44579732	26419	PDX1 C-terminal inhibiting factor 1
PA33069	5105	PCK1	chr20	56126137	56144515	18378	phosphoenolpyruvate carboxykinase 1 (soluble)
PA33070	5106	PCK2	chr14	24553347	24576339	22992	phosphoenolpyruvate carboxykinase 2 (mitochondrial)
PA33072	27445	PCLO	chr7	82380321	82802197	421876	piccolo presynaptic cytomatrix protein
PA33073	5108	PCM1	chr8	17770364	17890457	120093	pericentriolar material 1
PA262	5110	PCMT1	chr6	150060831	150135557	74726	protein-L-isoaspartate (D-aspartate) O-methyltransferase
PA142671194	115294	PCMTD1	chr8	52727140	52821735	94595	protein-L-isoaspartate (D-aspartate) O-methyltransferase domain containing 1
PA25750	55251	PCMTD2	chr20	62877048	62910583	33535	protein-L-isoaspartate (D-aspartate) O-methyltransferase domain containing 2
PA263	5111	PCNA	chr20	5092599	5117268	24669	proliferating cell nuclear antigen
PA143485572	57092	PCNP	chr3	101282997	101316281	33284	PEST proteolytic signal containing nuclear protein
PA33079	5116	PCNT	chr21	47733976	47868682	134706	pericentrin
PA134905848	22990	PCNX	chr14	71364122	71585099	220977	pecanex homolog (Drosophila)
PA33081	80003	PCNXL2	chr1	233116855	233441459	324604	pecanex-like 2 (Drosophila)
PA38680	399909	PCNXL3	chr11	65373686	65407910	34224	pecanex-like 3 (Drosophila)
PA134919147	64430	PCNXL4	chr14	60548545	60604532	55987	pecanex-like 4 (Drosophila)
PA33083	5118	PCOLCE	chr7	100189882	100208798	18916	procollagen C-endopeptidase enhancer
PA33084	26577	PCOLCE2	chr3	142533702	142618045	84343	procollagen C-endopeptidase enhancer 2
PA134864901	126006	PCP2	chr19	7693501	7711282	17781	Purkinje cell protein 2
PA33087	5121	PCP4	chr21	41229347	41304322	74975	Purkinje cell protein 4
PA143485573	654790	PCP4L1	chr1	161218517	161258240	39723	Purkinje cell protein 4 like 1
PA33089	5122	PCSK1	chr5	95723040	95778985	55945	proprotein convertase subtilisin/kexin type 1
PA33090	27344	PCSK1N	chrX	48686504	48704036	17532	proprotein convertase subtilisin/kexin type 1 inhibitor
PA33091	5126	PCSK2	chr20	17196752	17468223	271471	proprotein convertase subtilisin/kexin type 2
PA33092	54760	PCSK4	chr19	1478427	1500886	22459	proprotein convertase subtilisin/kexin type 4
PA33093	5125	PCSK5	chr9	78495560	78980255	484695	proprotein convertase subtilisin/kexin type 5
PA32895	5046	PCSK6	chr15	101841133	102040187	199054	proprotein convertase subtilisin/kexin type 6
PA33094	9159	PCSK7	chr11	117072788	117112811	40023	proprotein convertase subtilisin/kexin type 7
PA38617	255738	PCSK9	chr1	55495149	55533526	38377	proprotein convertase subtilisin/kexin type 9
PA33098	58488	PCTP	chr17	53818340	53923522	105182	phosphatidylcholine transfer protein
PA134959852	51449	PCYOX1	chr2	70475231	70511317	36086	prenylcysteine oxidase 1
PA147357517	78991	PCYOX1L	chr5	148727570	148752221	24651	prenylcysteine oxidase 1 like
PA33099	5130	PCYT1A	chr3	195958239	196024623	66384	phosphate cytidylyltransferase 1, choline, alpha
PA33100	9468	PCYT1B	chrX	24573204	24700979	127775	phosphate cytidylyltransferase 1, choline, beta
PA33101	5833	PCYT2	chr17	79857777	79879340	21563	phosphate cytidylyltransferase 2, ethanolamine
PA33102	11333	PDAP1	chr7	98989296	99016305	27009	PDGFA associated protein 1
PA33109	5132	PDC	chr1	186409698	186440240	30542	phosducin
PA33110	5133	PDCD1	chr2	242789033	242811058	22025	programmed cell death 1
PA33111	11235	PDCD10	chr3	167398692	167462693	64001	programmed cell death 10
PA134909758	22984	PDCD11	chr10	105146387	105209052	62665	programmed cell death 11
PA134891547	80380	PDCD1LG2	chr9	5500512	5574282	73770	programmed cell death 1 ligand 2
PA33112	5134	PDCD2	chr6	170881660	170903780	22120	programmed cell death 2
PA144596395	84306	PDCD2L	chr19	34885300	34920073	34773	programmed cell death 2-like
PA33113	27250	PDCD4	chr10	112621553	112662764	41211	programmed cell death 4 (neoplastic transformation inhibitor)
PA33114	9141	PDCD5	chr19	33062071	33081358	19287	programmed cell death 5
PA33115	10016	PDCD6	chr5	261736	318089	56353	programmed cell death 6
PA33116	10015	PDCD6IP	chr3	33830063	33914199	84136	programmed cell death 6 interacting protein
PA33117	10081	PDCD7	chr15	65406717	65436174	29457	programmed cell death 7
PA33119	5082	PDCL	chr9	125577376	125600935	23559	phosducin-like
PA134987062	132954	PDCL2	chr4	56419686	56468418	48732	phosducin-like 2
PA134979849	79031	PDCL3	chr2	101169418	101196201	26783	phosducin-like 3
PA142671193	347862	PDDC1	chr11	764222	787501	23279	Parkinson disease 7 domain containing 1
PA33120	10846	PDE10A	chr6	165737776	166085588	347812	phosphodiesterase 10A
PA33121	50940	PDE11A	chr2	178484977	178983066	498089	phosphodiesterase 11A
PA162399016	201626	PDE12	chr3	57531882	57643704	111822	phosphodiesterase 12
PA33122	5136	PDE1A	chr2	183001762	183397572	395810	phosphodiesterase 1A, calmodulin-dependent
PA33123	5153	PDE1B	chr12	54933177	54976023	42846	phosphodiesterase 1B, calmodulin-dependent
PA33124	5137	PDE1C	chr7	31788666	32349016	560350	phosphodiesterase 1C, calmodulin-dependent 70kDa
PA33125	5138	PDE2A	chr11	72284184	72395497	111313	phosphodiesterase 2A, cGMP-stimulated
PA33126	5139	PDE3A	chr12	20512179	20843575	331396	phosphodiesterase 3A, cGMP-inhibited
PA33127	5140	PDE3B	chr11	14655191	14896605	241414	phosphodiesterase 3B, cGMP-inhibited
PA33128	5141	PDE4A	chr19	10517449	10583307	65858	phosphodiesterase 4A, cAMP-specific
PA33129	5142	PDE4B	chr1	66248193	66843262	595069	phosphodiesterase 4B, cAMP-specific
PA264	5143	PDE4C	chr19	18315771	18369010	53239	phosphodiesterase 4C, cAMP-specific
PA33130	5144	PDE4D	chr5	58261865	59793925	1532060	phosphodiesterase 4D, cAMP-specific
PA33131	9659	PDE4DIP	chr1	144848424	145086186	237762	phosphodiesterase 4D interacting protein
PA33132	8654	PDE5A	chr4	120412550	120559981	147431	phosphodiesterase 5A, cGMP-specific
PA33133	5145	PDE6A	chr5	149234519	149334356	99837	phosphodiesterase 6A, cGMP-specific, rod, alpha
PA33134	5158	PDE6B	chr4	609363	667681	58318	phosphodiesterase 6B, cGMP-specific, rod, beta
PA33135	5146	PDE6C	chr10	95362345	95428430	66085	phosphodiesterase 6C, cGMP-specific, cone, alpha prime
PA33136	5147	PDE6D	chr2	232594147	232655974	61827	phosphodiesterase 6D, cGMP-specific, rod, delta
PA33137	5148	PDE6G	chr17	79614489	79633607	19118	phosphodiesterase 6G, cGMP-specific, rod, gamma
PA33138	5149	PDE6H	chr12	15115956	15137799	21843	phosphodiesterase 6H, cGMP-specific, cone, gamma
PA33139	5150	PDE7A	chr8	66623569	66763969	140400	phosphodiesterase 7A
PA33140	27115	PDE7B	chr6	136162834	136519709	356875	phosphodiesterase 7B
PA33141	5151	PDE8A	chr15	85513744	85685376	171632	phosphodiesterase 8A
PA33142	8622	PDE8B	chr5	76466082	76727081	260999	phosphodiesterase 8B
PA33143	5152	PDE9A	chr21	44063862	44198619	134757	phosphodiesterase 9A
PA144596394	64146	PDF	chr16	69359524	69374498	14974	peptide deformylase (mitochondrial)
PA33144	5154	PDGFA	chr7	533895	569481	35586	platelet-derived growth factor alpha polypeptide
PA33145	5155	PDGFB	chr22	39616685	39650957	34272	platelet-derived growth factor beta polypeptide
PA33146	56034	PDGFC	chr4	157679763	157902546	222783	platelet derived growth factor C
PA134892327	80310	PDGFD	chr11	103774914	104045027	270113	platelet derived growth factor D
PA33147	5156	PDGFRA	chr4	55085264	55167412	82148	platelet-derived growth factor receptor, alpha polypeptide
PA33148	5159	PDGFRB	chr5	149490402	149545447	55045	platelet-derived growth factor receptor, beta polypeptide
PA33149	5157	PDGFRL	chr8	17423942	17503642	79700	platelet-derived growth factor receptor-like
PA33150	5160	PDHA1	chrX	19352011	19382825	30814	pyruvate dehydrogenase (lipoamide) alpha 1
PA33151	5161	PDHA2	chr4	96751239	96765625	14386	pyruvate dehydrogenase (lipoamide) alpha 2
PA33152	5162	PDHB	chr3	58410357	58429579	19222	pyruvate dehydrogenase (lipoamide) beta
PA134976445	8050	PDHX	chr11	34927677	35020675	92998	pyruvate dehydrogenase complex, component X
PA33153	64714	PDIA2	chr16	323118	340215	17097	protein disulfide isomerase family A, member 2
PA29000	2923	PDIA3	chr15	44028326	44067804	39478	protein disulfide isomerase family A, member 3
PA142671190	9601	PDIA4	chr7	148697154	148735782	38628	protein disulfide isomerase family A, member 4
PA142671191	10954	PDIA5	chr3	122775856	122883953	108097	protein disulfide isomerase family A, member 5
PA134977905	10130	PDIA6	chr2	10905889	10988103	82214	protein disulfide isomerase family A, member 6
PA134959839	149420	PDIK1L	chr1	26427656	26455039	27383	PDLIM1 interacting kinase 1 like
PA164724442	204474	PDILT	chr16	20367492	20426064	58572	protein disulfide isomerase-like, testis expressed
PA33154	5163	PDK1	chr2	173410101	173493351	83250	pyruvate dehydrogenase kinase, isozyme 1
PA33155	5164	PDK2	chr17	48162101	48191733	29632	pyruvate dehydrogenase kinase, isozyme 2
PA33156	5165	PDK3	chrX	24473344	24571583	98239	pyruvate dehydrogenase kinase, isozyme 3
PA33157	5166	PDK4	chr7	95209809	95235925	26116	pyruvate dehydrogenase kinase, isozyme 4
PA33158	9124	PDLIM1	chr10	96994325	97060905	66580	PDZ and LIM domain 1
PA33159	64236	PDLIM2	chr8	22425805	22458538	32733	PDZ and LIM domain 2 (mystique)
PA134970631	27295	PDLIM3	chr4	186418814	186466712	47898	PDZ and LIM domain 3
PA134869796	8572	PDLIM4	chr5	131583351	131612147	28796	PDZ and LIM domain 4
PA134917248	10611	PDLIM5	chr4	95363008	95592378	229370	PDZ and LIM domain 5
PA128394546	9260	PDLIM7	chr5	176907395	176934606	27211	PDZ and LIM domain 7 (enigma)
PA33607	54704	PDP1	chr8	94919083	94941296	22213	pyruvate dehyrogenase phosphatase catalytic subunit 1
PA165450460	57546	PDP2	chr16	66904360	66928004	23644	pyruvate dehyrogenase phosphatase catalytic subunit 2
PA33160	5170	PDPK1	chr16	2577965	2656191	78226	3-phosphoinositide dependent protein kinase 1
PA142671187	10630	PDPN	chr1	13900252	13947452	47200	podoplanin
PA25667	81572	PDRG1	chr20	30529758	30566513	36755	p53 and DNA-damage regulated 1
PA162399027	23244	PDS5A	chr4	39821483	39989576	168093	PDS5 cohesin associated factor A
PA162399098	23047	PDS5B	chr13	33150564	33355158	204594	PDS5 cohesin associated factor B
PA134982512	23590	PDSS1	chr10	26976353	27038727	62374	prenyl (decaprenyl) diphosphate synthase, subunit 1
PA134957167	57107	PDSS2	chr6	107470761	107790779	320018	prenyl (decaprenyl) diphosphate synthase, subunit 2
PA162399173	3651	PDX1	chr13	28484168	28503451	19283	pancreatic and duodenal homeobox 1
PA162399182	23042	PDXDC1	chr16	15058448	15134552	76104	pyridoxal-dependent decarboxylase domain containing 1
PA33162	8566	PDXK	chr21	45128978	45185188	56210	pyridoxal (pyridoxine, vitamin B6) kinase
PA134882132	57026	PDXP	chr22	38044737	38065939	21202	pyridoxal (pyridoxine, vitamin B6) phosphatase
PA33163	5173	PDYN	chr20	1956402	1984931	28529	prodynorphin
PA134968632	51248	PDZD11	chrX	69503211	69519798	16587	PDZ domain containing 11
PA33164	23037	PDZD2	chr5	31629345	32114038	484693	PDZ domain containing 2
PA134911718	79849	PDZD3	chr11	119046127	119063932	17805	PDZ domain containing 3
PA134896313	57595	PDZD4	chrX	153064621	153106022	41401	PDZ domain containing 4
PA142671189	79955	PDZD7	chr10	102764440	102800914	36474	PDZ domain containing 7
PA134916380	118987	PDZD8	chr10	119026936	119144951	118015	PDZ domain containing 8
PA165450481	255762	PDZD9	chr16	21992186	22022431	30245	PDZ domain containing 9
PA33165	5174	PDZK1	chr1	145717662	145767207	49545	PDZ domain containing 1
PA142671188	10158	PDZK1IP1	chr1	47646261	47665771	19510	PDZK1 interacting protein 1
PA134931098	23024	PDZRN3	chr3	73428582	73684072	255490	PDZ domain containing ring finger 3
PA134974780	29951	PDZRN4	chr12	41572250	41971392	399142	PDZ domain containing ring finger 4
PA33166	8682	PEA15	chr1	160165125	160188162	23037	phosphoprotein enriched in astrocytes 15
PA162399233	375033	PEAR1	chr1	156853496	156889226	35730	platelet endothelial aggregation receptor 1
PA32968	5037	PEBP1	chr12	118563668	118586390	22722	phosphatidylethanolamine binding protein 1
PA165585814	157310	PEBP4	chr8	22567765	22795491	227726	phosphatidylethanolamine-binding protein 4
PA134967510	55825	PECR	chr2	216900111	216956539	56428	peroxisomal trans-2-enoyl-CoA reductase
PA142671184	553115	PEF1	chr1	32092463	32120838	28375	penta-EF-hand domain containing 1
PA33170	23089	PEG10	chr7	94275637	94302007	26370	paternally expressed 10
PA33171	5178	PEG3	chr19	57282730	57362121	79391	paternally expressed 3
PA33172	57162	PELI1	chr2	64316786	64381605	64819	pellino E3 ubiquitin protein ligase 1
PA33173	57161	PELI2	chr14	56575039	56771241	196202	pellino E3 ubiquitin protein ligase family member 2
PA142671185	246330	PELI3	chr11	66223798	66247808	24010	pellino E3 ubiquitin protein ligase family member 3
PA33174	53918	PELO	chr5	52073774	52101451	27677	pelota homolog (Drosophila)
PA142671186	27043	PELP1	chr17	4571679	4617712	46033	proline, glutamate and leucine rich protein 1
PA33175	10400	PEMT	chr17	17405877	17505434	99557	phosphatidylethanolamine N-methyltransferase
PA33176	5179	PENK	chr8	57350513	57369282	18769	proenkephalin
PA33181	5184	PEPD	chr19	33874855	34022799	147944	peptidase D
PA33184	5187	PER1	chr17	8040788	8069723	28935	period circadian clock 1
PA33185	8864	PER2	chr2	239149679	239208678	58999	period circadian clock 2
PA33186	8863	PER3	chr1	7834413	7908241	73828	period circadian clock 3
PA134944221	64065	PERP	chr6	138406642	138438660	32018	PERP, TP53 apoptosis effector
PA33190	23481	PES1	chr22	30969612	31013000	43388	pescadillo ribosomal biogenesis factor 1
PA33192	5189	PEX1	chr7	92113337	92167845	54508	peroxisomal biogenesis factor 1
PA33193	5192	PEX10	chr1	2333241	2354010	20769	peroxisomal biogenesis factor 10
PA33194	8800	PEX11A	chr15	90221762	90244015	22253	peroxisomal biogenesis factor 11 alpha
PA33195	8799	PEX11B	chr1	145506165	145526732	20567	peroxisomal biogenesis factor 11 beta
PA134987796	92960	PEX11G	chr19	7538756	7565884	27128	peroxisomal biogenesis factor 11 gamma
PA33196	5193	PEX12	chr17	33898814	33915656	16842	peroxisomal biogenesis factor 12
PA33197	5194	PEX13	chr2	61234812	61282125	47313	peroxisomal biogenesis factor 13
PA33198	5195	PEX14	chr1	10525003	10693815	168812	peroxisomal biogenesis factor 14
PA33199	9409	PEX16	chr11	45928220	45949674	21454	peroxisomal biogenesis factor 16
PA34058	5824	PEX19	chr1	160243599	160264941	21342	peroxisomal biogenesis factor 19
PA34060	5828	PEX2	chr8	77889494	77923280	33786	peroxisomal biogenesis factor 2
PA134983458	55670	PEX26	chr22	18550686	18576797	26111	peroxisomal biogenesis factor 26
PA33200	8504	PEX3	chr6	143761918	143814753	52835	peroxisomal biogenesis factor 3
PA34063	5830	PEX5	chr12	7331759	7374170	42411	peroxisomal biogenesis factor 5
PA134892044	51555	PEX5L	chr3	179509746	179764841	255095	peroxisomal biogenesis factor 5-like
PA33201	5190	PEX6	chr6	42928611	42956981	28370	peroxisomal biogenesis factor 6
PA33202	5191	PEX7	chr6	137133702	137238072	104370	peroxisomal biogenesis factor 7
PA33203	5196	PF4	chr4	74843542	74857841	14299	platelet factor 4
PA33204	5197	PF4V1	chr4	74709013	74723198	14185	platelet factor 4 variant 1
PA33205	5198	PFAS	chr17	8142596	8176809	34213	phosphoribosylformylglycinamidine synthase
PA33207	5201	PFDN1	chr5	139621635	139692689	71054	prefoldin subunit 1
PA33208	5202	PFDN2	chr1	161067346	161097866	30520	prefoldin subunit 2
PA33209	5203	PFDN4	chr20	52814502	52839492	24990	prefoldin subunit 4
PA33210	5204	PFDN5	chr12	53679235	53696234	16999	prefoldin subunit 5
PA29304	10471	PFDN6	chr6	33247374	33261711	14337	prefoldin subunit 6
PA33211	5207	PFKFB1	chrX	54956307	55035244	78937	6-phosphofructo-2-kinase/fructose-2,6-biphosphatase 1
PA33212	5208	PFKFB2	chr1	207197761	207257368	59607	6-phosphofructo-2-kinase/fructose-2,6-biphosphatase 2
PA33213	5209	PFKFB3	chr10	6176843	6280508	103665	6-phosphofructo-2-kinase/fructose-2,6-biphosphatase 3
PA33214	5210	PFKFB4	chr3	48552117	48608607	56490	6-phosphofructo-2-kinase/fructose-2,6-biphosphatase 4
PA33215	5211	PFKL	chr21	45709925	45750261	40336	phosphofructokinase, liver
PA33216	5213	PFKM	chr12	48489656	48543187	53531	phosphofructokinase, muscle
PA33217	5214	PFKP	chr10	3099667	3181997	82330	phosphofructokinase, platelet
PA33219	5216	PFN1	chr17	4845945	4862381	16436	profilin 1
PA33220	5217	PFN2	chr3	149679691	149698741	19050	profilin 2
PA142671182	345456	PFN3	chr5	176824108	176837637	13529	profilin 3
PA134919643	375189	PFN4	chr2	24334954	24356334	21380	profilin family, member 4
PA33222	643834	PGA3	chr11	60960984	60983350	22366	pepsinogen 3, group I (pepsinogen A)
PA33223	643847	PGA4	chr11	60979821	61002179	22358	pepsinogen 4, group I (pepsinogen A)
PA33224	5222	PGA5	chr11	60998644	61021929	23285	pepsinogen 5, group I (pepsinogen A)
PA33225	5223	PGAM1	chr10	99176027	99196198	20171	phosphoglycerate mutase 1 (brain)
PA33226	5224	PGAM2	chr7	44099326	44115186	15860	phosphoglycerate mutase 2 (muscle)
PA142671183	441531	PGAM4	chrX	77220458	77235135	14677	phosphoglycerate mutase family member 4
PA143485574	192111	PGAM5	chr12	133277393	133302323	24930	phosphoglycerate mutase family member 5
PA162399235	80055	PGAP1	chr2	197694728	197801454	106726	post-GPI attachment to proteins 1
PA165543520	27315	PGAP2	chr11	3808954	3850601	41647	post-GPI attachment to proteins 2
PA165432310	93210	PGAP3	chr17	37824375	37854310	29935	post-GPI attachment to proteins 3
PA134919893	84547	PGBD1	chr6	28239314	28273326	34012	piggyBac transposable element derived 1
PA134877743	267002	PGBD2	chr1	249190395	249218453	28058	piggyBac transposable element derived 2
PA134927747	267004	PGBD3	chr10	50720151	50742327	22176	piggyBac transposable element derived 3
PA134885912	161779	PGBD4	chr15	34384274	34399591	15317	piggyBac transposable element derived 4
PA134905621	79605	PGBD5	chr1	230454392	230571674	117282	piggyBac transposable element derived 5
PA33228	5225	PGC	chr6	41701449	41725139	23690	progastricsin (pepsinogen C)
PA33229	5226	PGD	chr1	10448884	10483565	34681	phosphogluconate dehydrogenase
PA33231	5228	PGF	chr14	75405533	75432467	26934	placental growth factor
PA33233	5229	PGGT1B	chr5	114543527	114609123	65596	protein geranylgeranyltransferase type I, beta subunit
PA33234	5230	PGK1	chrX	77349666	77385324	35658	phosphoglycerate kinase 1
PA33237	5232	PGK2	chr6	49750364	49765053	14689	phosphoglycerate kinase 2
PA33240	25796	PGLS	chr19	17612278	17635097	22819	6-phosphogluconolactonase
PA33241	8993	PGLYRP1	chr19	46519411	46536556	17145	peptidoglycan recognition protein 1
PA134929965	114770	PGLYRP2	chr19	15576456	15600315	23859	peptidoglycan recognition protein 2
PA134861692	114771	PGLYRP3	chr1	153267338	153293194	25856	peptidoglycan recognition protein 3
PA134902492	57115	PGLYRP4	chr1	153299596	153331039	31443	peptidoglycan recognition protein 4
PA33242	5236	PGM1	chr1	64048947	64128916	79969	phosphoglucomutase 1
PA33243	55276	PGM2	chr4	37818282	37867559	49277	phosphoglucomutase 2
PA134938366	283209	PGM2L1	chr11	74038361	74119502	81141	phosphoglucomutase 2-like 1
PA33244	5238	PGM3	chr6	83871592	83913655	42063	phosphoglucomutase 3
PA33245	5239	PGM5	chr9	70961815	71148977	187162	phosphoglucomutase 5
PA33246	283871	PGP	chr16	2258603	2274822	16219	phosphoglycolate phosphatase
PA33247	54858	PGPEP1	chr19	18441397	18483763	42366	pyroglutamyl-peptidase I
PA165479208	145814	PGPEP1L	chr15	99508459	99561024	52565	pyroglutamyl-peptidase I-like
PA266	5241	PGR	chr11	100897355	101010544	113189	progesterone receptor
PA33248	10857	PGRMC1	chrX	118360211	118381429	21218	progesterone receptor membrane component 1
PA33249	10424	PGRMC2	chr4	129187392	129219984	32592	progesterone receptor membrane component 2
PA142671180	9489	PGS1	chr17	76364705	76423740	59035	phosphatidylglycerophosphate synthase 1
PA134923900	221692	PHACTR1	chr6	12706888	13293476	586588	phosphatase and actin regulator 1
PA134944445	9749	PHACTR2	chr6	143919317	144155322	236005	phosphatase and actin regulator 2
PA128394750	116154	PHACTR3	chr20	58142564	58425766	283202	phosphatase and actin regulator 3
PA134959472	65979	PHACTR4	chr1	28686093	28829881	143788	phosphatase and actin regulator 4
PA164724444	51808	PHAX	chr5	125926607	125965944	39337	phosphorylated adaptor for RNA export
PA33251	5245	PHB	chr17	47478410	47502267	23857	prohibitin
PA142671181	11331	PHB2	chr12	7071515	7089981	18466	prohibitin 2
PA27619	1911	PHC1	chr12	9057292	9097063	39771	polyhomeotic homolog 1 (Drosophila)
PA27620	1912	PHC2	chr1	33786224	33851194	64970	polyhomeotic homolog 2 (Drosophila)
PA134886018	80012	PHC3	chr3	169802368	169909537	107169	polyhomeotic homolog 3 (Drosophila)
PA33258	5251	PHEX	chrX	22040921	22269478	228557	phosphate regulating endopeptidase homolog, X-linked
PA33259	5252	PHF1	chr6	33368773	33387230	18457	PHD finger protein 1
PA134972675	55274	PHF10	chr6	170101001	170134106	33105	PHD finger protein 10
PA134947696	51131	PHF11	chr13	50059746	50106123	46377	PHD finger protein 11
PA134954478	57649	PHF12	chr17	27229264	27288622	59358	PHD finger protein 12
PA134901883	148479	PHF13	chr1	6663756	6687093	23337	PHD finger protein 13
PA134867397	9678	PHF14	chr7	11003495	11212250	208755	PHD finger protein 14
PA134911501	26147	PHF19	chr9	123614929	123667168	52239	PHD finger protein 19
PA33260	5253	PHF2	chr9	96328909	96444869	115960	PHD finger protein 2
PA25644	51230	PHF20	chr20	34349923	34541292	191369	PHD finger protein 20
PA134874888	51105	PHF20L1	chr8	133777604	133864052	86448	PHD finger protein 20-like 1
PA134977844	51317	PHF21A	chr11	45947870	46152985	205115	PHD finger protein 21A
PA134872136	112885	PHF21B	chr22	45274042	45415809	141767	PHD finger protein 21B
PA142671175	79142	PHF23	chr17	7135347	7152825	17478	PHD finger protein 23
PA33261	23469	PHF3	chr6	64335707	64427407	91700	PHD finger protein 3
PA134876104	84844	PHF5A	chr22	41852721	41874708	21987	PHD finger protein 5A
PA33263	84295	PHF6	chrX	133497324	133565822	68498	PHD finger protein 6
PA38541	51533	PHF7	chr3	52434577	52460657	26080	PHD finger protein 7
PA134889361	23133	PHF8	chrX	53960113	54085368	125255	PHD finger protein 8
PA33264	26227	PHGDH	chr1	120244419	120289849	45430	phosphoglycerate dehydrogenase
PA165479224	644844	PHGR1	chr15	40633234	40651635	18401	proline/histidine/glycine-rich 1
PA33265	55023	PHIP	chr6	79641136	79798011	156875	pleckstrin homology domain interacting protein
PA33266	5255	PHKA1	chrX	71795664	71944029	148365	phosphorylase kinase, alpha 1 (muscle)
PA33267	5256	PHKA2	chrX	18907416	19012480	105064	phosphorylase kinase, alpha 2 (liver)
PA33268	5257	PHKB	chr16	47485047	47738434	253387	phosphorylase kinase, beta
PA33271	5260	PHKG1	chr7	56144616	56170780	26164	phosphorylase kinase, gamma 1 (muscle)
PA33272	5261	PHKG2	chr16	30749574	30775497	25923	phosphorylase kinase, gamma 2 (testis)
PA33274	22822	PHLDA1	chr12	76416227	76435556	19329	pleckstrin homology-like domain, family A, member 1
PA37053	7262	PHLDA2	chr11	2946503	2960650	14147	pleckstrin homology-like domain, family A, member 2
PA33275	23612	PHLDA3	chr1	201431607	201448299	16692	pleckstrin homology-like domain, family A, member 3
PA134917952	23187	PHLDB1	chr11	118467213	118531748	64535	pleckstrin homology-like domain, family B, member 1
PA134884060	90102	PHLDB2	chr3	111441327	111698364	257037	pleckstrin homology-like domain, family B, member 2
PA134934874	653583	PHLDB3	chr19	43976255	44019073	42818	pleckstrin homology-like domain, family B, member 3
PA165429055	23239	PHLPP1	chr18	60372672	60650676	278004	PH domain and leucine rich repeat protein phosphatase 1
PA165450496	23035	PHLPP2	chr16	71675827	71767798	91971	PH domain and leucine rich repeat protein phosphatase 2
PA33276	162466	PHOSPHO1	chr17	47297728	47319009	21281	phosphatase, orphan 1
PA134947617	493911	PHOSPHO2	chr2	170540946	170561218	20272	phosphatase, orphan 2
PA28093	401	PHOX2A	chr11	71947121	71965220	18099	paired-like homeobox 2a
PA33467	8929	PHOX2B	chr4	41743099	41760987	17888	paired-like homeobox 2b
PA134948141	29085	PHPT1	chr9	139733256	139748490	15234	phosphohistidine phosphatase 1
PA164724459	57661	PHRF1	chr11	566226	615222	48996	PHD and ring finger domains 1
PA33278	10745	PHTF1	chr1	114236824	114312165	75341	putative homeodomain transcription factor 1
PA33279	57157	PHTF2	chr7	77418109	77589821	171712	putative homeodomain transcription factor 2
PA33280	5264	PHYH	chr10	13316796	13352133	35337	phytanoyl-CoA 2-hydroxylase
PA134959674	254295	PHYHD1	chr9	131673174	131707322	34148	phytanoyl-CoA dioxygenase domain containing 1
PA33281	9796	PHYHIP	chr8	22074216	22099851	25635	phytanoyl-CoA 2-hydroxylase interacting protein
PA134906827	84457	PHYHIPL	chr10	60926348	61010815	84467	phytanoyl-CoA 2-hydroxylase interacting protein-like
PA162376015	85007	PHYKPL	chr5	177632475	177669823	37348	5-phosphohydroxy-L-lysine phospho-lyase
PA33282	51050	PI15	chr8	75726772	75770264	43492	peptidase inhibitor 15
PA134867616	221476	PI16	chr6	36906039	36935613	29574	peptidase inhibitor 16
PA33283	5266	PI3	chr20	43793540	43808185	14645	peptidase inhibitor 3, skin-derived
PA162399304	55361	PI4K2A	chr10	99390443	99439187	48744	phosphatidylinositol 4-kinase type 2 alpha
PA142671173	55300	PI4K2B	chr4	25225653	25283831	58178	phosphatidylinositol 4-kinase type 2 beta
PA162399305	5297	PI4KA	chr22	21058979	21223100	164121	phosphatidylinositol 4-kinase, catalytic, alpha
PA162399420	5298	PI4KB	chr1	151261273	151310191	48918	phosphatidylinositol 4-kinase, catalytic, beta
PA143485382	196500	PIANP	chr12	6799957	6820009	20052	PILR alpha associated neural protein
PA33285	8554	PIAS1	chr15	68336572	68486797	150225	protein inhibitor of activated STAT, 1
PA134933292	9063	PIAS2	chr18	44385900	44510130	124230	protein inhibitor of activated STAT, 2
PA134989011	10401	PIAS3	chr1	145565257	145589546	24289	protein inhibitor of activated STAT, 3
PA134945903	51588	PIAS4	chr19	3997749	4041067	43318	protein inhibitor of activated STAT, 4
PA162399421	10464	PIBF1	chr13	73346202	73593592	247390	progesterone immunomodulatory binding factor 1
PA33287	8301	PICALM	chr11	85665214	85790923	125709	phosphatidylinositol binding clathrin assembly protein
PA33760	9463	PICK1	chr22	38443262	38474708	31446	protein interacting with PRKCA 1
PA162399462	55022	PID1	chr2	229885689	230146057	260368	phosphotyrosine interaction domain containing 1
PA30445	55367	PIDD1	chr11	796179	815250	19071	p53-induced death domain protein 1
PA128394558	9780	PIEZO1	chr16	88778746	88861372	82626	piezo-type mechanosensitive ion channel component 1
PA162399475	80119	PIF1	chr15	65104831	65127867	23036	PIF1 5'-to-3' DNA helicase
PA142672472	128344	PIFO	chr1	111857285	111898639	41354	primary cilia formation
PA33288	5277	PIGA	chrX	15334573	15363676	29103	phosphatidylinositol glycan anchor biosynthesis, class A
PA33290	9488	PIGB	chr15	55601133	55650906	49773	phosphatidylinositol glycan anchor biosynthesis, class B
PA33291	5279	PIGC	chr1	172407597	172423230	15633	phosphatidylinositol glycan anchor biosynthesis, class C
PA33293	5281	PIGF	chr2	46805413	46854251	48838	phosphatidylinositol glycan anchor biosynthesis, class F
PA143485575	54872	PIGG	chr4	482989	536320	53331	phosphatidylinositol glycan anchor biosynthesis, class G
PA33295	5283	PIGH	chr14	68045225	68077017	31792	phosphatidylinositol glycan anchor biosynthesis, class H
PA33296	10026	PIGK	chr1	77551666	77695132	143466	phosphatidylinositol glycan anchor biosynthesis, class K
PA33297	9487	PIGL	chr17	16110509	16233098	122589	phosphatidylinositol glycan anchor biosynthesis, class L
PA38718	93183	PIGM	chr1	159994462	160011783	17321	phosphatidylinositol glycan anchor biosynthesis, class M
PA33298	23556	PIGN	chr18	59708457	59864289	155832	phosphatidylinositol glycan anchor biosynthesis, class N
PA134993507	84720	PIGO	chr9	35084028	35106598	22570	phosphatidylinositol glycan anchor biosynthesis, class O
PA27498	51227	PIGP	chr21	38434664	38455458	20794	phosphatidylinositol glycan anchor biosynthesis, class P
PA33299	9091	PIGQ	chr16	609968	637136	27168	phosphatidylinositol glycan anchor biosynthesis, class Q
PA33300	5284	PIGR	chr1	207098867	207129814	30947	polymeric immunoglobulin receptor
PA33301	94005	PIGS	chr17	26877405	26908887	31482	phosphatidylinositol glycan anchor biosynthesis, class S
PA33302	51604	PIGT	chr20	44034707	44057885	23178	phosphatidylinositol glycan anchor biosynthesis, class T
PA162399506	128869	PIGU	chr20	33145346	33275089	129743	phosphatidylinositol glycan anchor biosynthesis, class U
PA134952230	55650	PIGV	chr1	27103739	27127894	24155	phosphatidylinositol glycan anchor biosynthesis, class V
PA134894412	284098	PIGW	chr17	34880849	34898217	17368	phosphatidylinositol glycan anchor biosynthesis, class W
PA134928970	54965	PIGX	chr3	196429234	196465878	36644	phosphatidylinositol glycan anchor biosynthesis, class X
PA143485576	84992	PIGY	chr4	89439129	89454952	15823	phosphatidylinositol glycan anchor biosynthesis, class Y
PA142671171	80235	PIGZ	chr3	196670214	196705742	35528	phosphatidylinositol glycan anchor biosynthesis, class Z
PA162399535	55011	PIH1D1	chr19	49946550	49965266	18716	PIH1 domain containing 1
PA162399536	120379	PIH1D2	chr11	111931734	111954895	23161	PIH1 domain containing 2
PA134882142	139212	PIH1D3	chrX	106439862	106490473	50611	PIH1 domain containing 3
PA134979629	118788	PIK3AP1	chr10	98350069	98490279	140210	phosphoinositide-3-kinase adaptor protein 1
PA33304	5286	PIK3C2A	chr11	17105108	17239543	134435	phosphatidylinositol-4-phosphate 3-kinase, catalytic subunit type 2 alpha
PA33305	5287	PIK3C2B	chr1	204388756	204473943	85187	phosphatidylinositol-4-phosphate 3-kinase, catalytic subunit type 2 beta
PA33306	5288	PIK3C2G	chr12	18385912	18804352	418440	phosphatidylinositol-4-phosphate 3-kinase, catalytic subunit type 2 gamma
PA33307	5289	PIK3C3	chr18	39525165	39665272	140107	phosphatidylinositol 3-kinase, catalytic subunit type 3
PA33308	5290	PIK3CA	chr3	178856311	178955500	99189	phosphatidylinositol-4,5-bisphosphate 3-kinase, catalytic subunit alpha
PA33309	5291	PIK3CB	chr3	138368540	138563780	195240	phosphatidylinositol-4,5-bisphosphate 3-kinase, catalytic subunit beta
PA33310	5293	PIK3CD	chr1	9701789	9792172	90383	phosphatidylinositol-4,5-bisphosphate 3-kinase, catalytic subunit delta
PA33311	5294	PIK3CG	chr7	106495723	106550592	54869	phosphatidylinositol-4,5-bisphosphate 3-kinase, catalytic subunit gamma
PA162399553	113791	PIK3IP1	chr22	31674579	31698833	24254	phosphoinositide-3-kinase interacting protein 1
PA33312	5295	PIK3R1	chr5	67501584	67600649	99065	phosphoinositide-3-kinase, regulatory subunit 1 (alpha)
PA33313	5296	PIK3R2	chr19	18253988	18284343	30355	phosphoinositide-3-kinase, regulatory subunit 2 (beta)
PA33314	8503	PIK3R3	chr1	46502812	46652167	149355	phosphoinositide-3-kinase, regulatory subunit 3 (gamma)
PA33315	30849	PIK3R4	chr3	130394778	130475696	80918	phosphoinositide-3-kinase, regulatory subunit 4
PA134890823	23533	PIK3R5	chr17	8779233	8879029	99796	phosphoinositide-3-kinase, regulatory subunit 5
PA165697116	200576	PIKFYVE	chr2	209120990	209226475	105485	phosphoinositide kinase, FYVE finger containing
PA134873007	29992	PILRA	chr7	99961068	100000722	39654	paired immunoglobin-like type 2 receptor alpha
PA134906700	29990	PILRB	chr7	99945626	99968454	22828	paired immunoglobin-like type 2 receptor beta
PA33318	5292	PIM1	chr6	37127922	37146204	18282	Pim-1 proto-oncogene, serine/threonine kinase
PA33319	11040	PIM2	chrX	48767459	48786413	18954	Pim-2 proto-oncogene, serine/threonine kinase
PA134980758	415116	PIM3	chr22	50344143	50360720	16577	Pim-3 proto-oncogene, serine/threonine kinase
PA33320	5300	PIN1	chr19	9935883	9963365	27482	peptidylprolyl cis/trans isomerase, NIMA-interacting 1
PA33324	5303	PIN4	chrX	71391526	71486814	95288	protein (peptidylprolyl cis/trans isomerase) NIMA-interacting, 4 (parvulin)
PA33325	65018	PINK1	chr1	20949948	20981004	31056	PTEN induced putative kinase 1
PA165585852	54984	PINX1	chr8	10619473	10707394	87921	PIN2/TERF1 interacting, telomerase inhibitor 1
PA33326	5304	PIP	chr7	142819174	142839834	20660	prolactin-induced protein
PA162399615	5305	PIP4K2A	chr10	22820766	23013503	192737	phosphatidylinositol-5-phosphate 4-kinase, type II, alpha
PA162399640	8396	PIP4K2B	chr17	36918944	36966218	47274	phosphatidylinositol-5-phosphate 4-kinase, type II, beta
PA162399665	79837	PIP4K2C	chr12	57974942	58000211	25269	phosphatidylinositol-5-phosphate 4-kinase, type II, gamma
PA33327	8394	PIP5K1A	chr1	151161021	151225007	63986	phosphatidylinositol-4-phosphate 5-kinase, type I, alpha
PA33328	8395	PIP5K1B	chr9	71310188	71627092	316904	phosphatidylinositol-4-phosphate 5-kinase, type I, beta
PA33329	23396	PIP5K1C	chr19	3627179	3710484	83305	phosphatidylinositol-4-phosphate 5-kinase, type I, gamma
PA134926015	138429	PIP5KL1	chr9	130680808	130703076	22268	phosphatidylinositol-4-phosphate 5-kinase-like 1
PA33332	51268	PIPOX	chr17	27359918	27387245	27327	pipecolic acid oxidase
PA134870022	8544	PIR	chrX	15399921	15521711	121790	pirin (iron-binding nuclear protein)
PA165432447	644139	PIRT	chr17	10722792	10751418	28626	phosphoinositide-interacting regulator of transient receptor potential channels
PA33333	23761	PISD	chr22	32011477	32068550	57073	phosphatidylserine decarboxylase
PA142672446	57095	PITHD1	chr1	24094876	24117722	22846	PITH (C-terminal proteasome-interacting domain of thioredoxin-like) domain containing 1
PA33335	5306	PITPNA	chr17	1418283	1476110	57827	phosphatidylinositol transfer protein, alpha
PA33336	23760	PITPNB	chr22	28244657	28325255	80598	phosphatidylinositol transfer protein, beta
PA128394642	26207	PITPNC1	chr17	65363397	65696379	332982	phosphatidylinositol transfer protein, cytoplasmic 1
PA33337	9600	PITPNM1	chr11	67256231	67282843	26612	phosphatidylinositol transfer protein, membrane-associated 1
PA134963002	57605	PITPNM2	chr12	123465027	123645376	180349	phosphatidylinositol transfer protein, membrane-associated 2
PA134971883	83394	PITPNM3	chr17	6351583	6469877	118294	PITPNM family member 3
PA134902269	10531	PITRM1	chr10	3176919	3225033	48114	pitrilysin metallopeptidase 1
PA33338	5307	PITX1	chr5	134360424	134379964	19540	paired-like homeodomain 1
PA33339	5308	PITX2	chr4	111535579	111573279	37700	paired-like homeodomain 2
PA33340	5309	PITX3	chr10	103986946	104011231	24285	paired-like homeodomain 3
PA33341	9271	PIWIL1	chr12	130812433	130859877	47444	piwi-like RNA-mediated gene silencing 1
PA38461	55124	PIWIL2	chr8	22122810	22218560	95750	piwi-like RNA-mediated gene silencing 2
PA38332	440822	PIWIL3	chr22	25112001	25180687	68686	piwi-like RNA-mediated gene silencing 3
PA38333	143689	PIWIL4	chr11	94269876	94357587	87711	piwi-like RNA-mediated gene silencing 4
PA33342	64219	PJA1	chrX	68377581	68395365	17784	praja ring finger 1, E3 ubiquitin protein ligase
PA134873520	9867	PJA2	chr5	108667410	108755675	88265	praja ring finger 2, E3 ubiquitin protein ligase
PA35521	5310	PKD1	chr16	2135709	2195899	60190	polycystic kidney disease 1 (autosomal dominant)
PA38282	168507	PKD1L1	chr7	47811250	47998071	186821	polycystic kidney disease 1 like 1
PA134874396	114780	PKD1L2	chr16	81131484	81263975	132491	polycystic kidney disease 1-like 2
PA134907578	342372	PKD1L3	chr16	71960441	72043877	83436	polycystic kidney disease 1-like 3
PA33343	5311	PKD2	chr4	88918799	89001931	83132	polycystic kidney disease 2 (autosomal dominant)
PA33344	9033	PKD2L1	chr10	102044903	102100243	55340	polycystic kidney disease 2-like 1
PA33345	27039	PKD2L2	chr5	137215125	137279156	64031	polycystic kidney disease 2-like 2
PA165697259	91461	PKDCC	chr2	42265161	42288668	23507	protein kinase domain containing, cytoplasmic
PA33347	10343	PKDREJ	chr22	46648560	46669277	20717	polycystin (PKD) family receptor for egg jelly
PA33348	5314	PKHD1	chr6	51477145	51962423	485278	polycystic kidney and hepatic disease 1 (autosomal recessive)
PA134950222	93035	PKHD1L1	chr8	110364706	110546500	181794	polycystic kidney and hepatic disease 1 (autosomal recessive)-like 1
PA33349	5569	PKIA	chr8	79418336	79520502	102166	protein kinase (cAMP-dependent, catalytic) inhibitor alpha
PA33350	5570	PKIB	chr6	122783062	123050518	267456	protein kinase (cAMP-dependent, catalytic) inhibitor beta
PA33351	11142	PKIG	chr20	43150422	43250678	100256	protein kinase (cAMP-dependent, catalytic) inhibitor gamma
PA33352	5313	PKLR	chr1	155256084	155288531	32447	pyruvate kinase, liver and RBC
PA33353	5315	PKM	chr15	72488370	72533901	45531	pyruvate kinase, muscle
PA385	9088	PKMYT1	chr16	3015101	3040540	25439	protein kinase, membrane associated tyrosine/threonine 1
PA33769	5585	PKN1	chr19	14534166	14585679	51513	protein kinase N1
PA33770	5586	PKN2	chr1	89139876	89304938	165062	protein kinase N2
PA134919098	29941	PKN3	chr9	131454802	131486199	31397	protein kinase N3
PA33354	5316	PKNOX1	chr21	44384643	44456688	72045	PBX/knotted 1 homeobox 1
PA33355	63876	PKNOX2	chr11	125024559	125306285	281726	PBX/knotted 1 homeobox 2
PA33356	5317	PKP1	chr1	201242580	201305121	62541	plakophilin 1
PA33357	5318	PKP2	chr12	32940680	33059780	119100	plakophilin 2
PA33358	11187	PKP3	chr11	382614	407908	25294	plakophilin 3
PA33359	8502	PKP4	chr2	159303476	159540941	237465	plakophilin 4
PA134955851	51365	PLA1A	chr3	119306695	119351658	44963	phospholipase A1 member A
PA33360	8399	PLA2G10	chr16	14763405	14798526	35121	phospholipase A2, group X
PA38347	81579	PLA2G12A	chr4	110628145	110661242	33097	phospholipase A2, group XIIA
PA38573	84647	PLA2G12B	chr10	74691519	74724590	33071	phospholipase A2, group XIIB
PA164724567	23659	PLA2G15	chr16	68269240	68297965	28725	phospholipase A2, group XV
PA164724584	11145	PLA2G16	chr11	63338934	63391941	53007	phospholipase A2, group XVI
PA33361	5319	PLA2G1B	chr12	120756914	120775592	18678	phospholipase A2, group IB (pancreas)
PA270	5320	PLA2G2A	chr1	20298924	20316932	18008	phospholipase A2, group IIA (platelets, synovial fluid)
PA33362	391013	PLA2G2C	chr1	20487484	20511687	24203	phospholipase A2, group IIC
PA33363	26279	PLA2G2D	chr1	20436143	20456059	19916	phospholipase A2, group IID
PA134889019	30814	PLA2G2E	chr1	20243800	20260110	16310	phospholipase A2, group IIE
PA134931043	64600	PLA2G2F	chr1	20455823	20479879	24056	phospholipase A2, group IIF
PA38267	50487	PLA2G3	chr22	31527793	31546469	18676	phospholipase A2, group III
PA271	5321	PLA2G4A	chr1	186788032	186961113	173081	phospholipase A2, group IVA (cytosolic, calcium-dependent)
PA33364	100137049	PLA2G4B	chr15	42121011	42143346	22335	phospholipase A2, group IVB (cytosolic)
PA33365	8605	PLA2G4C	chr19	48548100	48624109	76009	phospholipase A2, group IVC (cytosolic, calcium-independent)
PA134974074	283748	PLA2G4D	chr15	42356881	42396752	39871	phospholipase A2, group IVD (cytosolic)
PA142671169	123745	PLA2G4E	chr15	42270780	42352901	82121	phospholipase A2, group IVE
PA142671170	255189	PLA2G4F	chr15	42430332	42458839	28507	phospholipase A2, group IVF
PA33366	5322	PLA2G5	chr1	20376157	20421394	45237	phospholipase A2, group V
PA33367	8398	PLA2G6	chr22	38504502	38587857	83355	phospholipase A2, group VI (cytosolic, calcium-independent)
PA33368	7941	PLA2G7	chr6	46669053	46713430	44377	phospholipase A2, group VII (platelet-activating factor acetylhydrolase, plasma)
PA33369	22925	PLA2R1	chr2	160785523	160929126	143603	phospholipase A2 receptor 1, 180kDa
PA33370	9373	PLAA	chr9	26900368	26957468	57100	phospholipase A2-activating protein
PA33371	10761	PLAC1	chrX	133696873	133802513	105640	placenta-specific 1
PA134950814	51316	PLAC8	chr4	84008201	84045911	37710	placenta-specific 8
PA134890176	153770	PLAC8L1	chr5	145460876	145493946	33070	PLAC8-like 1
PA134941839	219348	PLAC9	chr10	81882258	81907784	25526	placenta-specific 9
PA33378	5324	PLAG1	chr8	57070463	57133859	63396	pleiomorphic adenoma gene 1
PA33379	5325	PLAGL1	chr6	144258437	144395736	137299	pleiomorphic adenoma gene-like 1
PA33380	5326	PLAGL2	chr20	30777307	30805546	28239	pleiomorphic adenoma gene-like 2
PA33381	5327	PLAT	chr8	42029236	42075242	46006	plasminogen activator, tissue
PA33382	5328	PLAU	chr10	75660862	75680259	19397	plasminogen activator, urokinase
PA33383	5329	PLAUR	chr19	44147247	44184498	37251	plasminogen activator, urokinase receptor
PA134891309	151056	PLB1	chr2	28708938	28869654	160716	phospholipase B1
PA164724597	79887	PLBD1	chr12	14653597	14730791	77194	phospholipase B domain containing 1
PA164724624	196463	PLBD2	chr12	113786371	113830458	44087	phospholipase B domain containing 2
PA33384	23236	PLCB1	chr20	8102912	8868547	765635	phospholipase C, beta 1 (phosphoinositide-specific)
PA33385	5330	PLCB2	chr15	40573461	40610174	36713	phospholipase C, beta 2
PA33386	5331	PLCB3	chr11	64008995	64039924	30929	phospholipase C, beta 3 (phosphatidylinositol-specific)
PA33387	5332	PLCB4	chr20	9039357	9464463	425106	phospholipase C, beta 4
PA33388	5333	PLCD1	chr3	38045987	38081154	35167	phospholipase C, delta 1
PA33389	113026	PLCD3	chr17	43186008	43219891	33883	phospholipase C, delta 3
PA33390	84812	PLCD4	chr2	219462488	219504909	42421	phospholipase C, delta 4
PA33391	51196	PLCE1	chr10	95743746	96091149	347403	phospholipase C, epsilon 1
PA33392	5335	PLCG1	chr20	39756159	39807359	51200	phospholipase C, gamma 1
PA33393	5336	PLCG2	chr16	81802899	81999290	196391	phospholipase C, gamma 2 (phosphatidylinositol-specific)
PA128394595	23007	PLCH1	chr3	155194670	155472878	278208	phospholipase C, eta 1
PA134914471	9651	PLCH2	chr1	2397754	2439964	42210	phospholipase C, eta 2
PA33394	5334	PLCL1	chr2	198659426	199017608	358182	phospholipase C-like 1
PA33395	23228	PLCL2	chr3	16964582	17135098	170516	phospholipase C-like 2
PA134878642	55344	PLCXD1	chrY	132991	173023	40032	phosphatidylinositol-specific phospholipase C, X domain containing 1
PA134928848	257068	PLCXD2	chr3	111383523	111568294	184771	phosphatidylinositol-specific phospholipase C, X domain containing 2
PA134886053	345557	PLCXD3	chr5	41304048	41520730	216682	phosphatidylinositol-specific phospholipase C, X domain containing 3
PA134875646	89869	PLCZ1	chr12	18833110	18901020	67910	phospholipase C, zeta 1
PA164742228	5337	PLD1	chr3	171315195	171538284	223089	phospholipase D1, phosphatidylcholine-specific
PA33397	5338	PLD2	chr17	4700396	4729727	29331	phospholipase D2
PA134887482	23646	PLD3	chr19	40844302	40887392	43090	phospholipase D family, member 3
PA134861676	122618	PLD4	chr14	105381153	105402573	21420	phospholipase D family, member 4
PA142671168	200150	PLD5	chr1	242248689	242697998	449309	phospholipase D family, member 5
PA164724625	201164	PLD6	chr17	17101309	17119646	18337	phospholipase D family, member 6
PA33399	5339	PLEC	chr8	144986321	145060913	74592	plectin
PA33400	5341	PLEK	chr2	68582322	68627585	45263	pleckstrin
PA134963543	26499	PLEK2	chr14	67850700	67888828	38128	pleckstrin 2
PA33401	59338	PLEKHA1	chr10	124124094	124194871	70777	pleckstrin homology domain containing, family A (phosphoinositide binding specific) member 1
PA33402	59339	PLEKHA2	chr8	38748753	38834431	85678	pleckstrin homology domain containing, family A (phosphoinositide binding specific) member 2
PA33403	65977	PLEKHA3	chr2	179335199	179372783	37584	pleckstrin homology domain containing, family A (phosphoinositide binding specific) member 3
PA33404	57664	PLEKHA4	chr19	49337349	49381884	44535	pleckstrin homology domain containing, family A (phosphoinositide binding specific) member 4
PA134949896	54477	PLEKHA5	chr12	19272626	19532334	259708	pleckstrin homology domain containing, family A member 5
PA134955964	22874	PLEKHA6	chr1	204184979	204339057	154078	pleckstrin homology domain containing, family A member 6
PA134894945	144100	PLEKHA7	chr11	16806207	17045963	239756	pleckstrin homology domain containing, family A member 7
PA134926954	84725	PLEKHA8	chr7	30057977	30160961	102984	pleckstrin homology domain containing, family A (phosphoinositide binding specific) member 8
PA134868961	51054	PLEKHA8P1	chr12	45563817	45619789	55972	pleckstrin homology domain containing, family A member 8 pseudogene 1
PA38787	58473	PLEKHB1	chr11	73347223	73376864	29641	pleckstrin homology domain containing, family B (evectins) member 1
PA134885873	55041	PLEKHB2	chr2	131852420	131910425	58005	pleckstrin homology domain containing, family B (evectins) member 2
PA134948413	400224	PLEKHD1	chr14	69941471	69998215	56744	pleckstrin homology domain containing, family D (with coiled-coil domains) member 1
PA134928547	79156	PLEKHF1	chr19	30146327	30169384	23057	pleckstrin homology domain containing, family F (with FYVE domain) member 1
PA128394715	79666	PLEKHF2	chr8	96135949	96171913	35964	pleckstrin homology domain containing, family F (with FYVE domain) member 2
PA134922441	57480	PLEKHG1	chr6	150910999	151167801	256802	pleckstrin homology domain containing, family G (with RhoGef domain) member 1
PA134893492	64857	PLEKHG2	chr19	39893222	39922055	28833	pleckstrin homology domain containing, family G (with RhoGef domain) member 2
PA134925358	26030	PLEKHG3	chr14	65161132	65216623	55491	pleckstrin homology domain containing, family G (with RhoGef domain) member 3
PA142671163	25894	PLEKHG4	chr16	67301413	67326403	24990	pleckstrin homology domain containing, family G (with RhoGef domain) member 4
PA162399667	153478	PLEKHG4B	chr5	130373	193087	62714	pleckstrin homology domain containing, family G (with RhoGef domain) member 4B
PA142671164	57449	PLEKHG5	chr1	6523152	6590121	66969	pleckstrin homology domain containing, family G (with RhoGef domain) member 5
PA142671165	55200	PLEKHG6	chr12	6409602	6440672	31070	pleckstrin homology domain containing, family G (with RhoGef domain) member 6
PA162399708	440107	PLEKHG7	chr12	93105122	93169231	64109	pleckstrin homology domain containing, family G (with RhoGef domain) member 7
PA134879998	57475	PLEKHH1	chr14	67989916	68059255	69339	pleckstrin homology domain containing, family H (with MyTH4 domain) member 1
PA134912826	130271	PLEKHH2	chr2	43854439	43998126	143687	pleckstrin homology domain containing, family H (with MyTH4 domain) member 2
PA143485577	79990	PLEKHH3	chr17	40816932	40839048	22116	pleckstrin homology domain containing, family H (with MyTH4 domain) member 3
PA134936152	55111	PLEKHJ1	chr19	2230149	2247703	17554	pleckstrin homology domain containing, family J member 1
PA134906881	9842	PLEKHM1	chr17	43510266	43578146	67880	pleckstrin homology domain containing, family M (with RUN domain) member 1
PA134888781	23207	PLEKHM2	chr1	16000632	16064264	63632	pleckstrin homology domain containing, family M (with RUN domain) member 2
PA162399738	389072	PLEKHM3	chr2	208683012	208900284	217272	pleckstrin homology domain containing, family M, member 3
PA142671166	84069	PLEKHN1	chr1	891872	913488	21616	pleckstrin homology domain containing, family N member 1
PA142671167	51177	PLEKHO1	chr1	150112170	150134825	22655	pleckstrin homology domain containing, family O member 1
PA162399756	80301	PLEKHO2	chr15	65124082	65163201	39119	pleckstrin homology domain containing, family O member 2
PA134915529	349633	PLET1	chr11	112115876	112141583	25707	placenta expressed transcript 1
PA33405	5340	PLG	chr6	161113225	161178086	64861	plasminogen
PA33408	285189	PLGLA	chr2	106988570	107010851	22281	plasminogen-like A (pseudogene)
PA33406	5343	PLGLB1	chr2	87234587	87258969	24382	plasminogen-like B1
PA33407	5342	PLGLB2	chr2	88037606	88061995	24389	plasminogen-like B2
PA134964114	55848	PLGRKT	chr9	5354966	5448381	93415	plasminogen receptor, C-terminal lysine transmembrane protein
PA33409	5346	PLIN1	chr15	90204598	90232648	28050	perilipin 1
PA24569	123	PLIN2	chr9	19112759	19137604	24845	perilipin 2
PA165394001	10226	PLIN3	chr19	4835346	4877780	42434	perilipin 3
PA165394042	729359	PLIN4	chr19	4499192	4528529	29337	perilipin 4
PA165394043	440503	PLIN5	chr19	4519543	4545208	25665	perilipin 5
PA33410	5347	PLK1	chr16	23680201	23704688	24487	polo-like kinase 1
PA134940798	10769	PLK2	chr5	57746809	57765966	19157	polo-like kinase 2
PA26664	1263	PLK3	chr1	45255638	45274667	19029	polo-like kinase 3
PA36205	10733	PLK4	chr4	128792016	128823379	31363	polo-like kinase 4
PA38572	51090	PLLP	chr16	57287009	57328584	41575	plasmolipin
PA272	5350	PLN	chr6	118859442	118884587	25145	phospholamban
PA33411	5351	PLOD1	chr1	11984724	12038599	53875	procollagen-lysine, 2-oxoglutarate 5-dioxygenase 1
PA33412	5352	PLOD2	chr3	145784225	145889282	105057	procollagen-lysine, 2-oxoglutarate 5-dioxygenase 2
PA33413	8985	PLOD3	chr7	100846258	100871011	24753	procollagen-lysine, 2-oxoglutarate 5-dioxygenase 3
PA33414	5354	PLP1	chrX	103021439	103050548	29109	proteolipid protein 1
PA33415	5355	PLP2	chrX	49018184	49034469	16285	proteolipid protein 2 (colonic epithelium-enriched)
PA33416	5356	PLRG1	chr4	155453149	155481585	28436	pleiotropic regulator 1
PA33417	5357	PLS1	chr3	142305229	142435506	130277	plastin 1
PA33418	5358	PLS3	chrX	114785177	114888181	103004	plastin 3
PA33419	5359	PLSCR1	chr3	146229967	146272628	42661	phospholipid scramblase 1
PA33420	57047	PLSCR2	chr3	146106150	146223778	117628	phospholipid scramblase 2
PA33421	57048	PLSCR3	chr17	7290046	7308162	18116	phospholipid scramblase 3
PA33422	57088	PLSCR4	chr3	145907122	145978966	71844	phospholipid scramblase 4
PA134902268	389158	PLSCR5	chr3	146291342	146334003	42661	phospholipid scramblase family, member 5
PA273	5360	PLTP	chr20	44524259	44551003	26744	phospholipid transfer protein
PA33424	83483	PLVAP	chr19	17459264	17498137	38873	plasmalemma vesicle associated protein
PA134990658	57125	PLXDC1	chr17	37216556	37318946	102390	plexin domain containing 1
PA134932187	84898	PLXDC2	chr10	20095118	20578199	483081	plexin domain containing 2
PA33425	5361	PLXNA1	chr3	126697437	126759235	61798	plexin A1
PA33426	5362	PLXNA2	chr1	208192587	208427665	235078	plexin A2
PA33427	55558	PLXNA3	chrX	153676623	153704985	28362	plexin A3
PA162399757	91584	PLXNA4	chr7	131805091	132343447	538356	plexin A4
PA33429	5364	PLXNB1	chr3	48442261	48481460	39199	plexin B1
PA33430	23654	PLXNB2	chr22	50710408	50756062	45654	plexin B2
PA33431	5365	PLXNB3	chrX	153019651	153047801	28150	plexin B3
PA33432	10154	PLXNC1	chr12	94532499	94704451	171952	plexin C1
PA128394602	23129	PLXND1	chr3	129271056	129335582	64526	plexin D1
PA162399772	148811	PM20D1	chr1	205794150	205829276	35126	peptidase M20 domain containing 1
PA162399803	135293	PM20D2	chr6	89840047	89878288	38241	peptidase M20 domain containing 2
PA33434	5366	PMAIP1	chr18	57557153	57574538	17385	phorbol-12-myristate-13-acetate-induced protein 1
PA33435	5367	PMCH	chr12	102587237	102601614	14377	pro-melanin-concentrating hormone
PA35781	6490	PMEL	chr12	56344889	56370523	25634	premelanosome protein
PA162399822	56937	PMEPA1	chr20	56220448	56296592	76144	prostate transmembrane protein, androgen induced 1
PA33438	11243	PMF1	chr1	156172779	156212868	40089	polyamine-modulated factor 1
PA38464	83449	PMFBP1	chr16	72149996	72216349	66353	polyamine modulated factor 1 binding protein 1
PA33439	5371	PML	chr15	74277014	74343160	66146	promyelocytic leukemia
PA33440	5372	PMM1	chr22	41969890	41995871	25981	phosphomannomutase 1
PA33441	5373	PMM2	chr16	8881670	8946194	64524	phosphomannomutase 2
PA33443	5375	PMP2	chr8	82349561	82369719	20158	peripheral myelin protein 2
PA33444	5376	PMP22	chr17	15130094	15178674	48580	peripheral myelin protein 22
PA38629	23203	PMPCA	chr9	139295110	139321213	26103	peptidase (mitochondrial processing) alpha
PA33445	9512	PMPCB	chr7	102927873	102973349	45476	peptidase (mitochondrial processing) beta
PA33447	5378	PMS1	chr2	190638710	190745355	106645	PMS1 postmeiotic segregation increased 1 (S. cerevisiae)
PA33448	5395	PMS2	chr7	6009870	6058737	48867	PMS2 postmeiotic segregation increased 2 (S. cerevisiae)
PA33465	10654	PMVK	chr1	154894208	154919484	25276	phosphomevalonate kinase
PA134988711	139728	PNCK	chrX	152932188	152949816	17628	pregnancy up-regulated nonubiquitous CaM kinase
PA162402984	25957	PNISR	chr6	99843534	99883263	39729	PNN-interacting serine/arginine-rich protein
PA33476	25953	PNKD	chr2	219125115	219214516	89401	paroxysmal nonkinesigenic dyskinesia
PA33477	11284	PNKP	chr19	50361460	50380840	19380	polynucleotide kinase 3'-phosphatase
PA134892245	154197	PNLDC1	chr6	160211281	160244736	33455	poly(A)-specific ribonuclease (PARN)-like domain containing 1
PA33478	5406	PNLIP	chr10	118295428	118330367	34939	pancreatic lipase
PA33479	5407	PNLIPRP1	chr10	118340478	118371687	31209	pancreatic lipase-related protein 1
PA33480	5408	PNLIPRP2	chr10	118370465	118407654	37189	pancreatic lipase-related protein 2
PA134954941	119548	PNLIPRP3	chr10	118177424	118240469	63045	pancreatic lipase-related protein 3
PA33481	9240	PNMA1	chr14	74175486	74191128	15642	paraneoplastic Ma antigen 1
PA33482	10687	PNMA2	chr8	26359196	26381608	22412	paraneoplastic Ma antigen 2
PA38667	29944	PNMA3	chrX	152214766	152231827	17061	paraneoplastic Ma antigen 3
PA38668	114824	PNMA5	chrX	152154368	152172671	18303	paraneoplastic Ma antigen family member 5
PA134880085	84968	PNMA6A	chrX	152328301	152343107	14806	paraneoplastic Ma antigen family member 6A
PA162399835	55228	PNMAL1	chr19	46966748	46984820	18072	paraneoplastic Ma antigen family-like 1
PA162399847	57469	PNMAL2	chr19	46991448	47009169	17721	paraneoplastic Ma antigen family-like 2
PA274	5409	PNMT	chr17	37814234	37829728	15494	phenylethanolamine N-methyltransferase
PA33484	5411	PNN	chr14	39634387	39655422	21035	pinin, desmosome associated protein
PA162399854	56902	PNO1	chr2	68375005	68406091	31086	partner of NOB1 homolog (S. cerevisiae)
PA33485	5368	PNOC	chr8	28164562	28203872	39310	prepronociceptin
PA31694	4860	PNP	chr14	20927538	20949165	21627	purine nucleoside phosphorylase
PA134887192	285848	PNPLA1	chr6	36200945	36279372	78427	patatin-like phospholipase domain containing 1
PA134903083	57104	PNPLA2	chr11	808901	828573	19672	patatin-like phospholipase domain containing 2
PA38592	80339	PNPLA3	chr22	44309619	44346451	36832	patatin-like phospholipase domain containing 3
PA134910531	8228	PNPLA4	chrX	7863804	7905780	41976	patatin-like phospholipase domain containing 4
PA134869344	150379	PNPLA5	chr22	44272558	44297893	25335	patatin-like phospholipase domain containing 5
PA145148268	10908	PNPLA6	chr19	7589033	7629653	40620	patatin-like phospholipase domain containing 6
PA134935962	375775	PNPLA7	chr9	140351404	140455021	103617	patatin-like phospholipase domain containing 7
PA145148236	50640	PNPLA8	chr7	108107866	108178605	70739	patatin-like phospholipase domain containing 8
PA134915565	55163	PNPO	chr17	46008889	46029674	20785	pyridoxamine 5'-phosphate oxidase
PA134915354	87178	PNPT1	chr2	55858198	55931045	72847	polyribonucleotide nucleotidyltransferase 1
PA33804	10957	PNRC1	chr6	89780429	89797879	17450	proline-rich nuclear receptor coactivator 1
PA134931421	55629	PNRC2	chr1	24276301	24292952	16651	proline-rich nuclear receptor coactivator 2
PA165698089	25886	POC1A	chr3	52106249	52198720	92471	POC1 centriolar protein A
PA165513299	282809	POC1B	chr12	89810495	89930039	119544	POC1 centriolar protein B
PA165660427	134359	POC5	chr5	74967023	75023313	56290	POC5 centriolar protein
PA134980106	127435	PODN	chr1	53517724	53554174	36450	podocan
PA162399855	79883	PODNL1	chr19	14039000	14074204	35204	podocan-like 1
PA33493	5420	PODXL	chr7	131182021	131251376	69355	podocalyxin-like
PA134860950	50512	PODXL2	chr3	127338002	127394653	56651	podocalyxin-like 2
PA134937695	79983	POF1B	chrX	84529395	84644748	115353	premature ovarian failure, 1B
PA33495	23509	POFUT1	chr20	30785625	30829467	43842	protein O-fucosyltransferase 1
PA25867	23275	POFUT2	chr21	46680843	46717811	36968	protein O-fucosyltransferase 2
PA38684	57645	POGK	chr1	166798681	166826709	28028	pogo transposable element with KRAB domain
PA162393771	56983	POGLUT1	chr3	119177785	119216555	38770	protein O-glucosyltransferase 1
PA38685	23126	POGZ	chr1	151372200	151455753	83553	pogo transposable element with ZNF domain
PA162399856	5422	POLA1	chrX	24702038	25018103	316065	polymerase (DNA directed), alpha 1, catalytic subunit
PA411	23649	POLA2	chr11	65019432	65068088	48656	polymerase (DNA directed), alpha 2, accessory subunit
PA276	5423	POLB	chr8	42185973	42232331	46358	polymerase (DNA directed), beta
PA33496	5424	POLD1	chr19	50877531	50924275	46744	polymerase (DNA directed), delta 1, catalytic subunit
PA33497	5425	POLD2	chr7	44151279	44173267	21988	polymerase (DNA directed), delta 2, accessory subunit
PA134868595	10714	POLD3	chr11	74293575	74383386	89811	polymerase (DNA-directed), delta 3, accessory subunit
PA33498	57804	POLD4	chr11	67115236	67131067	15831	polymerase (DNA-directed), delta 4, accessory subunit
PA134899124	84271	POLDIP3	chr22	42976727	43020968	44241	polymerase (DNA-directed), delta interacting protein 3
PA277	5426	POLE	chr12	133197344	133274050	76706	polymerase (DNA directed), epsilon, catalytic subunit
PA278	5427	POLE2	chr14	50107270	50165098	57828	polymerase (DNA directed), epsilon 2, accessory subunit
PA33499	54107	POLE3	chr9	116166515	116183029	16514	polymerase (DNA directed), epsilon 3, accessory subunit
PA38677	56655	POLE4	chr2	75175775	75199859	24084	polymerase (DNA-directed), epsilon 4, accessory subunit
PA33500	5428	POLG	chr15	89856536	89888026	31490	polymerase (DNA directed), gamma
PA33501	11232	POLG2	chr17	62470902	62503184	32282	polymerase (DNA directed), gamma 2, accessory subunit
PA279	5429	POLH	chr6	43533878	43591260	57382	polymerase (DNA directed), eta
PA33502	11201	POLI	chr18	51785849	51840583	54734	polymerase (DNA directed) iota
PA33503	51426	POLK	chr5	74797657	74898646	100989	polymerase (DNA directed) kappa
PA33504	27343	POLL	chr10	103335639	103358027	22388	polymerase (DNA directed), lambda
PA33505	27434	POLM	chr7	44108846	44132129	23283	polymerase (DNA directed), mu
PA134979866	353497	POLN	chr4	2070645	2253848	183203	polymerase (DNA directed) nu
PA33506	10721	POLQ	chr3	121147273	121274853	127580	polymerase (DNA directed), theta
PA134891380	25885	POLR1A	chr2	86250451	86343278	92827	polymerase (RNA) I polypeptide A, 194kDa
PA130601182	84172	POLR1B	chr2	113288676	113337727	49051	polymerase (RNA) I polypeptide B, 128kDa
PA134882004	9533	POLR1C	chr6	43474777	43500114	25337	polymerase (RNA) I polypeptide C, 30kDa
PA134914527	51082	POLR1D	chr13	28184880	28244559	59679	polymerase (RNA) I polypeptide D, 16kDa
PA142671136	64425	POLR1E	chr9	37475945	37506694	30749	polymerase (RNA) I polypeptide E, 53kDa
PA33507	5430	POLR2A	chr17	7377698	7420935	43237	polymerase (RNA) II (DNA directed) polypeptide A, 220kDa
PA33508	5431	POLR2B	chr4	57834944	57900334	65390	polymerase (RNA) II (DNA directed) polypeptide B, 140kDa
PA33509	5432	POLR2C	chr16	57486551	57508921	22370	polymerase (RNA) II (DNA directed) polypeptide C, 33kDa
PA33511	5433	POLR2D	chr2	128600840	128625729	24889	polymerase (RNA) II (DNA directed) polypeptide D
PA33512	5434	POLR2E	chr19	1083578	1105391	21813	polymerase (RNA) II (DNA directed) polypeptide E, 25kDa
PA33513	5435	POLR2F	chr22	38339674	38371463	31789	polymerase (RNA) II (DNA directed) polypeptide F
PA33514	5436	POLR2G	chr11	62519011	62537187	18176	polymerase (RNA) II (DNA directed) polypeptide G
PA33515	5437	POLR2H	chr3	184069502	184089383	19881	polymerase (RNA) II (DNA directed) polypeptide H
PA33516	5438	POLR2I	chr19	36601611	36616206	14595	polymerase (RNA) II (DNA directed) polypeptide I, 14.5kDa
PA33517	5439	POLR2J	chr7	102110547	102129446	18899	polymerase (RNA) II (DNA directed) polypeptide J, 13.3kDa
PA164724655	246721	POLR2J2	chr7	102274195	102322176	47981	polymerase (RNA) II (DNA directed) polypeptide J2
PA164724678	548644	POLR2J3	chr7	102175365	102223107	47742	polymerase (RNA) II (DNA directed) polypeptide J3
PA33518	5440	POLR2K	chr8	101152839	101169230	16391	polymerase (RNA) II (DNA directed) polypeptide K, 7.0kDa
PA33519	5441	POLR2L	chr11	836721	852529	15808	polymerase (RNA) II (DNA directed) polypeptide L, 7.6kDa
PA28986	81488	POLR2M	chr15	57988901	58012753	23852	polymerase (RNA) II (DNA directed) polypeptide M
PA134900426	11128	POLR3A	chr10	79731907	79799298	67391	polymerase (RNA) III (DNA directed) polypeptide A, 155kDa
PA134867680	55703	POLR3B	chr12	106741436	106906976	165540	polymerase (RNA) III (DNA directed) polypeptide B
PA134870963	10623	POLR3C	chr1	145589605	145620972	31367	polymerase (RNA) III (DNA directed) polypeptide C (62kD)
PA25390	661	POLR3D	chr8	22092619	22111680	19061	polymerase (RNA) III (DNA directed) polypeptide D, 44kDa
PA134964025	55718	POLR3E	chr16	22298696	22349424	50728	polymerase (RNA) III (DNA directed) polypeptide E (80kD)
PA33520	10621	POLR3F	chr20	18438033	18468287	30254	polymerase (RNA) III (DNA directed) polypeptide F, 39 kDa
PA134986024	10622	POLR3G	chr5	89759876	89813474	53598	polymerase (RNA) III (DNA directed) polypeptide G (32kD)
PA134921690	84265	POLR3GL	chr1	145453236	145486081	32845	polymerase (RNA) III (DNA directed) polypeptide G (32kD)-like
PA134994174	171568	POLR3H	chr22	41918803	41950479	31676	polymerase (RNA) III (DNA directed) polypeptide H (22.9kD)
PA33521	51728	POLR3K	chr16	93979	113632	19653	polymerase (RNA) III (DNA directed) polypeptide K, 12.3 kDa
PA33522	5442	POLRMT	chr19	614223	643665	29442	polymerase (RNA) mitochondrial (DNA directed)
PA134987951	9883	POM121	chr7	72339906	72424979	85073	POM121 transmembrane nucleoporin
PA162399935	100101267	POM121C	chr7	75043060	75125565	82505	POM121 transmembrane nucleoporin C
PA165618224	285877	POM121L12	chr7	53093349	53107618	14269	POM121 transmembrane nucleoporin-like 12
PA33524	94026	POM121L2	chr6	27273842	27290011	16169	POM121 transmembrane nucleoporin-like 2
PA33526	5443	POMC	chr2	25380722	25401559	20837	proopiomelanocortin
PA142671161	55624	POMGNT1	chr1	46651353	46695977	44624	protein O-linked mannose N-acetylglucosaminyltransferase 1 (beta 1,2-)
PA142672374	84892	POMGNT2	chr3	43117729	43157565	39836	protein O-linked mannose N-acetylglucosaminyltransferase 2 (beta 1,4-)
PA134898606	51371	POMP	chr13	29223141	29256094	32953	proteasome maturation protein
PA33527	10585	POMT1	chr9	134368282	134402193	33911	protein-O-mannosyltransferase 1
PA134980627	29954	POMT2	chr14	77738299	77797225	58926	protein-O-mannosyltransferase 2
PA33528	22932	POMZP3	chr7	76236303	76266620	30317	POM121 and ZP3 fusion
PA33529	5444	PON1	chr7	94924669	94963884	39215	paraoxonase 1
PA33530	5445	PON2	chr7	95031174	95074636	43462	paraoxonase 2
PA33531	5446	PON3	chr7	94986181	95035702	49521	paraoxonase 3
PA134907403	10940	POP1	chr8	99119521	99175069	55548	processing of precursor 1, ribonuclease P/MRP subunit (S. cerevisiae)
PA134987921	10775	POP4	chr19	30087170	30111162	23992	processing of precursor 4, ribonuclease P/MRP subunit (S. cerevisiae)
PA128394660	51367	POP5	chr12	121013848	121029201	15353	processing of precursor 5, ribonuclease P/MRP subunit (S. cerevisiae)
PA134887425	10248	POP7	chr7	100293676	100308123	14447	processing of precursor 7, ribonuclease P/MRP subunit (S. cerevisiae)
PA134982197	64091	POPDC2	chr3	119357899	119389437	31538	popeye domain containing 2
PA134935151	64208	POPDC3	chr6	105602775	105637858	35083	popeye domain containing 3
PA33532	5447	POR	chr7	75534420	75619173	84753	P450 (cytochrome) oxidoreductase
PA134906089	64840	PORCN	chrX	48357347	48382202	24855	porcupine homolog (Drosophila)
PA134900304	10631	POSTN	chr13	38133719	38182981	49262	periostin, osteoblast specific factor
PA134934904	25913	POT1	chr7	124459440	124580037	120597	protection of telomeres 1
PA164724701	340441	POTEA	chr8	43137585	43221328	83743	POTE ankyrin domain family, member A
PA164724702	100996331	POTEB	chr15	22048853	22093137	44284	POTE ankyrin domain family, member B
PA164724729	388468	POTEC	chr18	14508737	14553599	44862	POTE ankyrin domain family, member C
PA164724756	317754	POTED	chr21	14972498	15016937	44439	POTE ankyrin domain family, member D
PA164724783	445582	POTEE	chr2	131965924	132025944	60020	POTE ankyrin domain family, member E
PA164724818	728378	POTEF	chr2	130828108	130896795	68687	POTE ankyrin domain family, member F
PA164724853	404785	POTEG	chr14	19543365	19587942	44577	POTE ankyrin domain family, member G
PA24458	23784	POTEH	chr22	16253332	16297937	44605	POTE ankyrin domain family, member H
PA165697301	653269	POTEI	chr2	131217234	131276808	59574	POTE ankyrin domain family, member I
PA165697368	653781	POTEJ	chr2	131359106	131418610	59504	POTE ankyrin domain family, member J
PA142672652	440915	POTEKP	chr2	132339666	132369974	30308	POTE ankyrin domain family, member K, pseudogene
PA165479276	641455	POTEM	chr14	19980954	20030272	49318	POTE ankyrin domain family, member M
PA33534	5449	POU1F1	chr3	87305783	87335737	29954	POU class 1 homeobox 1
PA33535	5450	POU2AF1	chr11	111219976	111260348	40372	POU class 2 associating factor 1
PA33536	5451	POU2F1	chr1	167180066	167399582	219516	POU class 2 homeobox 1
PA33537	5452	POU2F2	chr19	42587262	42646625	59363	POU class 2 homeobox 2
PA134963258	25833	POU2F3	chr11	120097349	120193653	96304	POU class 2 homeobox 3
PA33538	5453	POU3F1	chr1	38506523	38522450	15927	POU class 3 homeobox 1
PA33539	5454	POU3F2	chr6	99272580	99289666	17086	POU class 3 homeobox 2
PA33540	5455	POU3F3	chr2	105461969	105476471	14502	POU class 3 homeobox 3
PA33541	5456	POU3F4	chrX	82753269	82767775	14506	POU class 3 homeobox 4
PA33542	5457	POU4F1	chr13	79170227	79187695	17468	POU class 4 homeobox 1
PA33543	5458	POU4F2	chr4	147550045	147566623	16578	POU class 4 homeobox 2
PA33544	5459	POU4F3	chr5	145708587	145723083	14496	POU class 4 homeobox 3
PA33545	5460	POU5F1	chr6	31129114	31148451	19337	POU class 5 homeobox 1
PA33547	5462	POU5F1B	chr8	128417131	128432455	15324	POU class 5 homeobox 1B
PA33548	5463	POU6F1	chr12	51577719	51621477	43758	POU class 6 homeobox 1
PA134969420	11281	POU6F2	chr7	39007609	39507390	499781	POU class 6 homeobox 2
PA33550	5464	PPA1	chr10	71959586	72003667	44081	pyrophosphatase (inorganic) 1
PA142671159	27068	PPA2	chr4	106287234	106405227	117993	pyrophosphatase (inorganic) 2
PA33551	56342	PPAN	chr19	10206899	10224975	18076	peter pan homolog (Drosophila)
PA162399971	692312	PPAN-P2RY11	chr19	10206899	10229065	22166	PPAN-P2RY11 readthrough
PA33552	8611	PPAP2A	chr5	54717670	54840906	123236	phosphatidic acid phosphatase type 2A
PA33553	8613	PPAP2B	chr1	56957419	57055257	97838	phosphatidic acid phosphatase type 2B
PA33554	8612	PPAP2C	chr19	278040	301435	23395	phosphatidic acid phosphatase type 2C
PA134907381	196051	PPAPDC1A	chr10	122206466	122352367	145901	phosphatidic acid phosphatase type 2 domain containing 1A
PA142671154	84513	PPAPDC1B	chr8	38116035	38136841	20806	phosphatidic acid phosphatase type 2 domain containing 1B
PA142671155	403313	PPAPDC2	chr9	4652294	4668274	15980	phosphatidic acid phosphatase type 2 domain containing 2
PA134931886	84814	PPAPDC3	chr9	134155069	134187649	32580	phosphatidic acid phosphatase type 2 domain containing 3
PA280	5465	PPARA	chr22	46536458	46642653	106195	peroxisome proliferator-activated receptor alpha
PA33557	5467	PPARD	chr6	35300335	35398968	98633	peroxisome proliferator-activated receptor delta
PA281	5468	PPARG	chr3	12319349	12478855	159506	peroxisome proliferator-activated receptor gamma
PA33558	10891	PPARGC1A	chr4	23790644	24484394	693750	peroxisome proliferator-activated receptor gamma, coactivator 1 alpha
PA134953410	133522	PPARGC1B	chr5	149099815	149237585	137770	peroxisome proliferator-activated receptor gamma, coactivator 1 beta
PA33559	5471	PPAT	chr4	57256528	57311802	55274	phosphoribosyl pyrophosphate amidotransferase
PA33561	5473	PPBP	chr4	74849156	74863907	14751	pro-platelet basic protein (chemokine (C-X-C motif) ligand 7)
PA142671157	60490	PPCDC	chr15	75305927	75346067	40140	phosphopantothenoylcysteine decarboxylase
PA142671158	79717	PPCS	chr1	42911968	42942088	30120	phosphopantothenoylcysteine synthetase
PA25691	79144	PPDPF	chr20	62141426	62156524	15098	pancreatic progenitor cell differentiation and proliferation factor
PA33564	5475	PPEF1	chrX	18694257	18849039	154782	protein phosphatase, EF-hand calcium binding domain 1
PA33565	5470	PPEF2	chr4	76778025	76833681	55656	protein phosphatase, EF-hand calcium binding domain 2
PA33566	8500	PPFIA1	chr11	70106806	70233607	126801	protein tyrosine phosphatase, receptor type, f polypeptide (PTPRF), interacting protein (liprin), alpha 1
PA33567	8499	PPFIA2	chr12	81649045	82163109	514064	protein tyrosine phosphatase, receptor type, f polypeptide (PTPRF), interacting protein (liprin), alpha 2
PA33568	8541	PPFIA3	chr19	49612646	49657287	44641	protein tyrosine phosphatase, receptor type, f polypeptide (PTPRF), interacting protein (liprin), alpha 3
PA33569	8497	PPFIA4	chr1	202985649	203050864	65215	protein tyrosine phosphatase, receptor type, f polypeptide (PTPRF), interacting protein (liprin), alpha 4
PA33570	8496	PPFIBP1	chr12	27667045	27851497	184452	PTPRF interacting protein, binding protein 1 (liprin beta 1)
PA33571	8495	PPFIBP2	chr11	7524996	7681537	156541	PTPRF interacting protein, binding protein 2 (liprin beta 2)
PA134881011	51535	PPHLN1	chr12	42709947	42845422	135475	periphilin 1
PA33574	5478	PPIA	chr7	44826241	44845716	19475	peptidylprolyl isomerase A (cyclophilin A)
PA164724909	164022	PPIAL4A	chr1	147951760	147965419	13659	peptidylprolyl isomerase A (cyclophilin A)-like 4A
PA164724910	653505	PPIAL4B	chr1	144360462	144374246	13784	peptidylprolyl isomerase A (cyclophilin A)-like 4B
PA164724917	653598	PPIAL4C	chr1	149543003	149556787	13784	peptidylprolyl isomerase A (cyclophilin A)-like 4C
PA165752246	645142	PPIAL4D	chr1	148198752	148212536	13784	peptidylprolyl isomerase A (cyclophilin A)-like 4D
PA164724924	730262	PPIAL4E	chr1	148634011	148647795	13784	peptidylprolyl isomerase A (cyclophilin A)-like 4E
PA165752267	728945	PPIAL4F	chr1	148796015	148809799	13784	peptidylprolyl isomerase A (cyclophilin A)-like 4F
PA164724931	644591	PPIAL4G	chr1	143764144	143777881	13737	peptidylprolyl isomerase A (cyclophilin A)-like 4G
PA33580	5479	PPIB	chr15	64445014	64465354	20340	peptidylprolyl isomerase B (cyclophilin B)
PA33581	5480	PPIC	chr5	122356078	122382425	26347	peptidylprolyl isomerase C (cyclophilin C)
PA33582	5481	PPID	chr4	159627279	159654552	27273	peptidylprolyl isomerase D
PA33583	10450	PPIE	chr1	40194517	40232586	38069	peptidylprolyl isomerase E (cyclophilin E)
PA33584	10105	PPIF	chr10	81097220	81118090	20870	peptidylprolyl isomerase F
PA33585	9360	PPIG	chr2	170430850	170500916	70066	peptidylprolyl isomerase G (cyclophilin G)
PA33586	10465	PPIH	chr1	43113706	43145429	31723	peptidylprolyl isomerase H (cyclophilin H)
PA33587	51645	PPIL1	chr6	36819605	36852800	33195	peptidylprolyl isomerase (cyclophilin)-like 1
PA33588	23759	PPIL2	chr22	22010273	22055202	44929	peptidylprolyl isomerase (cyclophilin)-like 2
PA33589	53938	PPIL3	chr2	201732630	201764048	31418	peptidylprolyl isomerase (cyclophilin)-like 3
PA33590	85313	PPIL4	chr6	149822631	149877238	54607	peptidylprolyl isomerase (cyclophilin)-like 4
PA134939571	285755	PPIL6	chr6	109708418	109772374	63956	peptidylprolyl isomerase (cyclophilin)-like 6
PA165479401	9677	PPIP5K1	chr15	43822660	43892451	69791	diphosphoinositol pentakisphosphate kinase 1
PA165660454	23262	PPIP5K2	chr5	102445958	102542224	96266	diphosphoinositol pentakisphosphate kinase 2
PA33602	5493	PPL	chr16	4929508	4997136	67628	periplakin
PA33603	5494	PPM1A	chr14	60702470	60768805	66335	protein phosphatase, Mg2+/Mn2+ dependent, 1A
PA33604	5495	PPM1B	chr2	44385984	44474570	88586	protein phosphatase, Mg2+/Mn2+ dependent, 1B
PA33605	8493	PPM1D	chr17	58667544	58746641	79097	protein phosphatase, Mg2+/Mn2+ dependent, 1D
PA134943567	22843	PPM1E	chr17	56823230	57065540	242310	protein phosphatase, Mg2+/Mn2+ dependent, 1E
PA134935566	9647	PPM1F	chr22	22270792	22317250	46458	protein phosphatase, Mg2+/Mn2+ dependent, 1F
PA33606	5496	PPM1G	chr2	27601066	27642550	41484	protein phosphatase, Mg2+/Mn2+ dependent, 1G
PA38354	57460	PPM1H	chr12	63034762	63338665	303903	protein phosphatase, Mg2+/Mn2+ dependent, 1H
PA142671150	333926	PPM1J	chr1	113249616	113267950	18334	protein phosphatase, Mg2+/Mn2+ dependent, 1J
PA134912083	152926	PPM1K	chr4	89175761	89215983	40222	protein phosphatase, Mg2+/Mn2+ dependent, 1K
PA134871016	151742	PPM1L	chr3	160463996	160791817	327821	protein phosphatase, Mg2+/Mn2+ dependent, 1L
PA142671151	132160	PPM1M	chr3	52269782	52287615	17833	protein phosphatase, Mg2+/Mn2+ dependent, 1M
PA165394107	147699	PPM1N	chr19	45991731	46008768	17037	protein phosphatase, Mg2+/Mn2+ dependent, 1N (putative)
PA142671152	51400	PPME1	chr11	73871936	73968748	96812	protein phosphatase methylesterase 1
PA33608	5498	PPOX	chr1	161125832	161151136	25304	protoporphyrinogen oxidase
PA33609	5499	PPP1CA	chr11	67162652	67179376	16724	protein phosphatase 1, catalytic subunit, alpha isozyme
PA33610	5500	PPP1CB	chr2	28964614	29028806	64192	protein phosphatase 1, catalytic subunit, beta isozyme
PA33611	5501	PPP1CC	chr12	111154613	111190783	36170	protein phosphatase 1, catalytic subunit, gamma isozyme
PA33612	5514	PPP1R10	chr6	30565177	30595084	29907	protein phosphatase 1, regulatory subunit 10
PA33614	6992	PPP1R11	chr6	30024932	30041110	16178	protein phosphatase 1, regulatory (inhibitor) subunit 11
PA33617	4659	PPP1R12A	chr12	80164343	80339235	174892	protein phosphatase 1, regulatory subunit 12A
PA33618	4660	PPP1R12B	chr1	202307830	202560697	252867	protein phosphatase 1, regulatory subunit 12B
PA33619	54776	PPP1R12C	chr19	55599281	55638968	39687	protein phosphatase 1, regulatory subunit 12C
PA33622	23368	PPP1R13B	chr14	104197088	104325116	128028	protein phosphatase 1, regulatory subunit 13B
PA34195	10848	PPP1R13L	chr19	45879892	45919787	39895	protein phosphatase 1, regulatory subunit 13 like
PA33623	94274	PPP1R14A	chr19	38738877	38757231	18354	protein phosphatase 1, regulatory (inhibitor) subunit 14A
PA33624	26472	PPP1R14B	chr11	64008951	64024413	15462	protein phosphatase 1, regulatory (inhibitor) subunit 14B
PA33630	81706	PPP1R14C	chr6	150454188	150574528	120340	protein phosphatase 1, regulatory (inhibitor) subunit 14C
PA33631	54866	PPP1R14D	chr15	41104643	41131283	26640	protein phosphatase 1, regulatory (inhibitor) subunit 14D
PA33632	23645	PPP1R15A	chr19	49365649	49382319	16670	protein phosphatase 1, regulatory subunit 15A
PA33633	84919	PPP1R15B	chr1	204366781	204390945	24164	protein phosphatase 1, regulatory subunit 15B
PA33634	84988	PPP1R16A	chr8	145693365	145730504	37139	protein phosphatase 1, regulatory subunit 16A
PA33635	26051	PPP1R16B	chr20	37424348	37554667	130319	protein phosphatase 1, regulatory subunit 16B
PA134908901	10842	PPP1R17	chr7	31716631	31751069	34438	protein phosphatase 1, regulatory subunit 17
PA134918172	170954	PPP1R18	chr6	30641166	30665672	24506	protein phosphatase 1, regulatory subunit 18
PA33636	5502	PPP1R1A	chr12	54966176	54992451	26275	protein phosphatase 1, regulatory (inhibitor) subunit 1A
PA33639	84152	PPP1R1B	chr17	37773177	37795878	22701	protein phosphatase 1, regulatory (inhibitor) subunit 1B
PA33640	151242	PPP1R1C	chr2	182808968	182999109	190141	protein phosphatase 1, regulatory (inhibitor) subunit 1C
PA33641	5504	PPP1R2	chr3	195238221	195280224	42003	protein phosphatase 1, regulatory (inhibitor) subunit 2
PA164722001	129285	PPP1R21	chr2	48657908	48745531	87623	protein phosphatase 1, regulatory subunit 21
PA134869847	9858	PPP1R26	chr9	138361545	138383739	22194	protein phosphatase 1, regulatory subunit 26
PA27555	116729	PPP1R27	chr17	79788368	79802926	14558	protein phosphatase 1, regulatory subunit 27
PA144596485	220004	PPP1R32	chr11	61238585	61261400	22815	protein phosphatase 1, regulatory subunit 32
PA162380520	221908	PPP1R35	chr7	100029900	100044468	14568	protein phosphatase 1, regulatory subunit 35
PA134955014	145376	PPP1R36	chr14	65006620	65059099	52479	protein phosphatase 1, regulatory subunit 36
PA162394589	284352	PPP1R37	chr19	45586431	45653543	67112	protein phosphatase 1, regulatory subunit 37
PA33651	5506	PPP1R3A	chr7	113513882	113569082	55200	protein phosphatase 1, regulatory subunit 3A
PA33652	79660	PPP1R3B	chr8	8990764	9019152	28388	protein phosphatase 1, regulatory subunit 3B
PA33653	5507	PPP1R3C	chr10	93385197	93402858	17661	protein phosphatase 1, regulatory subunit 3C
PA33654	5509	PPP1R3D	chr20	58508887	58525352	16465	protein phosphatase 1, regulatory subunit 3D
PA33656	89801	PPP1R3F	chrX	49116305	49147557	31252	protein phosphatase 1, regulatory subunit 3F
PA33657	648791	PPP1R3G	chr6	5075720	5090455	14735	protein phosphatase 1, regulatory subunit 3G
PA33658	5510	PPP1R7	chr2	242079012	242125439	46427	protein phosphatase 1, regulatory subunit 7
PA33659	5511	PPP1R8	chr1	28147252	28181183	33931	protein phosphatase 1, regulatory subunit 8
PA33661	55607	PPP1R9A	chr7	94526949	94928727	401778	protein phosphatase 1, regulatory subunit 9A
PA33663	5515	PPP2CA	chr5	133529148	133571950	42802	protein phosphatase 2, catalytic subunit, alpha isozyme
PA33664	5516	PPP2CB	chr8	30640126	30680352	40226	protein phosphatase 2, catalytic subunit, beta isozyme
PA33666	5518	PPP2R1A	chr19	52683055	52732678	49623	protein phosphatase 2, regulatory subunit A, alpha
PA33667	5519	PPP2R1B	chr11	111594632	111647169	52537	protein phosphatase 2, regulatory subunit A, beta
PA33668	5520	PPP2R2A	chr8	26139007	26233196	94189	protein phosphatase 2, regulatory subunit B, alpha
PA33669	5521	PPP2R2B	chr5	145966067	146471083	505016	protein phosphatase 2, regulatory subunit B, beta
PA33670	5522	PPP2R2C	chr4	6319305	6575327	256022	protein phosphatase 2, regulatory subunit B, gamma
PA134899040	55844	PPP2R2D	chr10	133737957	133773054	35097	protein phosphatase 2, regulatory subunit B, delta
PA35523	5523	PPP2R3A	chr3	135674515	135869752	195237	protein phosphatase 2, regulatory subunit B'', alpha
PA134878872	28227	PPP2R3B	chrY	241668	307690	66022	protein phosphatase 2, regulatory subunit B'', beta
PA162400008	55012	PPP2R3C	chr14	35551678	35601868	50190	protein phosphatase 2, regulatory subunit B'', gamma
PA33671	5524	PPP2R4	chr9	131863183	131914225	51042	protein phosphatase 2A activator, regulatory subunit 4
PA33672	5525	PPP2R5A	chr1	212448879	212538205	89326	protein phosphatase 2, regulatory subunit B', alpha
PA33673	5526	PPP2R5B	chr11	64682143	64704950	22807	protein phosphatase 2, regulatory subunit B', beta
PA33674	5527	PPP2R5C	chr14	102216910	102397329	180419	protein phosphatase 2, regulatory subunit B', gamma
PA33676	5528	PPP2R5D	chr6	42942218	42983083	40865	protein phosphatase 2, regulatory subunit B', delta
PA33677	5529	PPP2R5E	chr14	63836838	64020095	183257	protein phosphatase 2, regulatory subunit B', epsilon isoform
PA33678	5530	PPP3CA	chr4	101941587	102278655	337068	protein phosphatase 3, catalytic subunit, alpha isozyme
PA33679	5532	PPP3CB	chr10	75193563	75265782	72219	protein phosphatase 3, catalytic subunit, beta isozyme
PA33680	5533	PPP3CC	chr8	22288483	22401657	113174	protein phosphatase 3, catalytic subunit, gamma isozyme
PA33681	5534	PPP3R1	chr2	68402979	68493392	90413	protein phosphatase 3, regulatory subunit B, alpha
PA33682	5535	PPP3R2	chr9	104350897	104367283	16386	protein phosphatase 3, regulatory subunit B, beta
PA33683	5531	PPP4C	chr16	30077297	30099698	22401	protein phosphatase 4, catalytic subunit
PA33684	9989	PPP4R1	chr18	9543789	9624605	80816	protein phosphatase 4, regulatory subunit 1
PA38520	151987	PPP4R2	chr3	73035985	73121349	85364	protein phosphatase 4, regulatory subunit 2
PA164724938	57718	PPP4R4	chr14	94630649	94749092	118443	protein phosphatase 4, regulatory subunit 4
PA33686	5536	PPP5C	chr19	46840251	46899238	58987	protein phosphatase 5, catalytic subunit
PA33687	5537	PPP6C	chr9	127905852	127962218	56366	protein phosphatase 6, catalytic subunit
PA165394108	22870	PPP6R1	chr19	55738147	55780038	41891	protein phosphatase 6, regulatory subunit 1
PA165378360	9701	PPP6R2	chr22	50771746	50886519	114773	protein phosphatase 6, regulatory subunit 2
PA25487	55291	PPP6R3	chr11	68218186	68385802	167616	protein phosphatase 6, regulatory subunit 3
PA134886297	23082	PPRC1	chr10	103882787	103913090	30303	peroxisome proliferator-activated receptor gamma, coactivator-related 1
PA33688	5538	PPT1	chr1	40535382	40573142	37760	palmitoyl-protein thioesterase 1
PA33689	9374	PPT2	chr6	32111229	32134458	23229	palmitoyl-protein thioesterase 2
PA143485580	160760	PPTC7	chr12	110969237	111031064	61827	PTC7 protein phosphatase homolog (S. cerevisiae)
PA142671149	23398	PPWD1	chr5	64849063	64886376	37313	peptidylprolyl isomerase domain and WD repeat containing 1
PA33690	5539	PPY	chr17	42015172	42029833	14661	pancreatic polypeptide
PA33693	10084	PQBP1	chrX	48745160	48763422	18262	polyglutamine binding protein 1
PA134958806	80148	PQLC1	chr18	77659420	77721664	62244	PQ loop repeat containing 1
PA134879718	54896	PQLC2	chr1	19628740	19661925	33185	PQ loop repeat containing 2
PA143485331	152078	PQLC2L	chr3	157251159	157322022	70863	PQ loop repeat containing 2-like
PA134941925	130814	PQLC3	chr2	11285498	11322000	36502	PQ loop repeat containing 3
PA164725009	84366	PRAC1	chr17	46796081	46809882	13801	prostate cancer susceptibility candidate 1
PA25895	84279	PRADC1	chr2	73452134	73470356	18222	protease-associated domain containing 1
PA134955002	11230	PRAF2	chrX	48925818	48941662	15844	PRA1 domain family, member 2
PA142671137	84106	PRAM1	chr19	8551940	8577538	25598	PML-RARA regulated adaptor molecule 1
PA33698	23532	PRAME	chr22	22887123	22911696	24573	preferentially expressed antigen in melanoma
PA142671138	65121	PRAMEF1	chr1	12841546	12859777	18231	PRAME family member 1
PA142671147	343071	PRAMEF10	chr1	12949727	12968094	18367	PRAME family member 10
PA142671148	440560	PRAMEF11	chr1	12881468	12901264	19796	PRAME family member 11
PA145148158	390999	PRAMEF12	chr1	12824984	12841049	16065	PRAME family member 12
PA145148169	400736	PRAMEF13	chr1	13444414	13462656	18242	PRAME family member 13
PA145148171	729528	PRAMEF14	chr1	13665269	13683511	18242	PRAME family member 14
PA145148173	653619	PRAMEF15	chr1	13631973	13651987	20014	PRAME family member 15
PA145148186	654348	PRAMEF16	chr1	13485254	13501260	16006	PRAME family member 16
PA145148194	391004	PRAMEF17	chr1	13706088	13722064	15976	PRAME family member 17
PA145148195	391003	PRAMEF18	chr1	13471053	13487569	16516	PRAME family member 18
PA145148196	645414	PRAMEF19	chr1	13691889	13708405	16516	PRAME family member 19
PA142671139	65122	PRAMEF2	chr1	12906941	12924764	17823	PRAME family member 2
PA145148198	645425	PRAMEF20	chr1	13726907	13750803	23896	PRAME family member 20
PA145148208	391001	PRAMEF21	chr1	13511963	13529943	17980	PRAME family member 21
PA162400009	653606	PRAMEF22	chr1	13025543	13041381	15838	PRAME family member 22
PA162400010	729368	PRAMEF23	chr1	13105838	13132577	26739	PRAME family member 23
PA142671140	401940	PRAMEF3	chr1	13325196	13341692	16496	PRAME family member 3
PA142671141	400735	PRAMEF4	chr1	12936033	12956025	19992	PRAME family member 4
PA142671142	343068	PRAMEF5	chr1	13349819	13372057	22238	PRAME family member 5
PA142671143	440561	PRAMEF6	chr1	12995302	13017406	22104	PRAME family member 6
PA142671144	441871	PRAMEF7	chr1	12966467	12983300	16833	PRAME family member 7
PA142671145	391002	PRAMEF8	chr1	13383646	13400765	17119	PRAME family member 8
PA142671146	343070	PRAMEF9	chr1	13411176	13431191	20015	PRAME family member 9
PA134981678	118471	PRAP1	chr10	135138362	135169187	30825	proline-rich acidic protein 1
PA33699	5542	PRB1	chr12	11501757	11518524	16767	proline-rich protein BstNI subfamily 1
PA33700	653247	PRB2	chr12	11541474	11558498	17024	proline-rich protein BstNI subfamily 2
PA33701	5544	PRB3	chr12	11415847	11432656	16809	proline-rich protein BstNI subfamily 3
PA33702	5545	PRB4	chr12	11457015	11473369	16354	proline-rich protein BstNI subfamily 4
PA33703	9055	PRC1	chr15	91506268	91547881	41613	protein regulator of cytokinesis 1
PA33704	5546	PRCC	chr1	156727274	156773609	46335	papillary renal cell carcinoma (translocation-associated)
PA162400025	768206	PRCD	chr17	74513668	74544458	30790	progressive rod-cone degeneration
PA33705	5547	PRCP	chr11	82532409	82622733	90324	prolylcarboxypeptidase (angiotensinase C)
PA33707	639	PRDM1	chr6	106524195	106560814	36619	PR domain containing 1, with ZNF domain
PA33708	56980	PRDM10	chr11	129766601	129882730	116129	PR domain containing 10
PA33709	56981	PRDM11	chr11	45105564	45259675	154111	PR domain containing 11
PA33710	59335	PRDM12	chr9	133529981	133561384	31403	PR domain containing 12
PA33711	59336	PRDM13	chr6	100044650	100066454	21804	PR domain containing 13
PA33712	63978	PRDM14	chr8	70960886	70993562	32676	PR domain containing 14
PA33713	63977	PRDM15	chr21	43215385	43309591	94206	PR domain containing 15
PA33714	63976	PRDM16	chr1	2975565	3358185	382620	PR domain containing 16
PA33715	7799	PRDM2	chr1	14016714	14154574	137860	PR domain containing 2, with ZNF domain
PA33716	11108	PRDM4	chr12	108123643	108165049	41406	PR domain containing 4
PA33717	11107	PRDM5	chr4	121610070	121854013	243943	PR domain containing 5
PA33718	93166	PRDM6	chr5	122414841	122532960	118119	PR domain containing 6
PA33719	11105	PRDM7	chr16	90119974	90153708	33734	PR domain containing 7
PA33720	56978	PRDM8	chr4	81095033	81128483	33450	PR domain containing 8
PA33721	56979	PRDM9	chr5	23497724	23531706	33982	PR domain containing 9
PA33722	5052	PRDX1	chr1	45973707	45998562	24855	peroxiredoxin 1
PA33723	7001	PRDX2	chr19	12904634	12922724	18090	peroxiredoxin 2
PA33724	10935	PRDX3	chr10	120924215	120948377	24162	peroxiredoxin 3
PA33725	10549	PRDX4	chrX	23672377	23707516	35139	peroxiredoxin 4
PA33726	25824	PRDX5	chr11	64075347	64092295	16948	peroxiredoxin 5
PA134992760	9588	PRDX6	chr1	173436486	173460946	24460	peroxiredoxin 6
PA33727	10113	PREB	chr2	27350624	27367542	16918	prolactin regulatory element binding
PA162400040	27166	PRELID1	chr5	176720763	176736960	16197	PRELI domain containing 1
PA162400041	153768	PRELID2	chr5	145135582	145224899	89317	PRELI domain containing 2
PA33729	5549	PRELP	chr1	203434883	203463480	28597	proline/arginine-rich end leucine-rich repeat protein
PA33730	5550	PREP	chr6	105722442	105860999	138557	prolyl endopeptidase
PA142671134	9581	PREPL	chr2	44541746	44599001	57255	prolyl endopeptidase-like
PA164725018	57580	PREX1	chr20	47237787	47454420	216633	phosphatidylinositol-3,4,5-trisphosphate-dependent Rac exchange factor 1
PA164725103	80243	PREX2	chr8	68854244	69146897	292653	phosphatidylinositol-3,4,5-trisphosphate-dependent Rac exchange factor 2
PA33732	5551	PRF1	chr10	72354104	72372531	18427	perforin 1 (pore forming protein)
PA33734	5553	PRG2	chr11	57151834	57181420	29586	proteoglycan 2, bone marrow (natural killer cell activator, eosinophil granule major basic protein)
PA33735	10394	PRG3	chr11	57141242	57158623	17381	proteoglycan 3
PA33736	10216	PRG4	chr1	186255405	186286688	31283	proteoglycan 4
PA33737	5554	PRH1	chr12	11030560	11046874	16314	proline-rich protein HaeIII subfamily 1
PA33738	5555	PRH2	chr12	11071834	11090444	18610	proline-rich protein HaeIII subfamily 2
PA134906946	144165	PRICKLE1	chr12	42849140	42993572	144432	prickle homolog 1 (Drosophila)
PA134883144	166336	PRICKLE2	chr3	64076526	64263859	187333	prickle homolog 2 (Drosophila)
PA162400060	4007	PRICKLE3	chrX	49028546	49052981	24435	prickle homolog 3 (Drosophila)
PA162400083	29964	PRICKLE4	chr6	41738500	41758110	19610	prickle homolog 4 (Drosophila)
PA33739	5557	PRIM1	chr12	57122364	57156146	33782	primase, DNA, polypeptide 1 (49kDa)
PA162400108	5558	PRIM2	chr6	57172415	57515702	343287	primase, DNA, polypeptide 2 (58kDa)
PA38315	145270	PRIMA1	chr14	94181644	94264766	83122	proline rich membrane anchor 1
PA145008751	201973	PRIMPOL	chr4	185560767	185619112	58345	primase and polymerase (DNA-directed)
PA33744	5562	PRKAA1	chr5	40756481	40808297	51816	protein kinase, AMP-activated, alpha 1 catalytic subunit
PA33745	5563	PRKAA2	chr1	57100990	57184008	83018	protein kinase, AMP-activated, alpha 2 catalytic subunit
PA33746	5564	PRKAB1	chr12	120095669	120122429	26760	protein kinase, AMP-activated, beta 1 non-catalytic subunit
PA33747	5565	PRKAB2	chr1	146623685	146654168	30483	protein kinase, AMP-activated, beta 2 non-catalytic subunit
PA33748	5566	PRKACA	chr19	14199500	14238559	39059	protein kinase, cAMP-dependent, catalytic, alpha
PA33749	5567	PRKACB	chr1	84533745	84707181	173436	protein kinase, cAMP-dependent, catalytic, beta
PA33750	5568	PRKACG	chr9	71624426	71645600	21174	protein kinase, cAMP-dependent, catalytic, gamma
PA33751	5571	PRKAG1	chr12	49393055	49423012	29957	protein kinase, AMP-activated, gamma 1 non-catalytic subunit
PA33752	51422	PRKAG2	chr7	151250200	151584316	334116	protein kinase, AMP-activated, gamma 2 non-catalytic subunit
PA33753	53632	PRKAG3	chr2	219684083	219706526	22443	protein kinase, AMP-activated, gamma 3 non-catalytic subunit
PA33754	5573	PRKAR1A	chr17	66497921	66550457	52536	protein kinase, cAMP-dependent, regulatory, type I, alpha
PA33756	5575	PRKAR1B	chr7	585834	777313	191479	protein kinase, cAMP-dependent, regulatory, type I, beta
PA33757	5576	PRKAR2A	chr3	48781017	48895270	114253	protein kinase, cAMP-dependent, regulatory, type II, alpha
PA33758	5577	PRKAR2B	chr7	106675178	106805256	130078	protein kinase, cAMP-dependent, regulatory, type II, beta
PA33759	5578	PRKCA	chr17	64288760	64809862	521102	protein kinase C, alpha
PA33761	5579	PRKCB	chr16	23837300	24234932	397632	protein kinase C, beta
PA33763	5580	PRKCD	chr3	53185223	53229733	44510	protein kinase C, delta
PA33764	112464	PRKCDBP	chr11	6337176	6351740	14564	protein kinase C, delta binding protein
PA33765	5581	PRKCE	chr2	45868454	46418129	549675	protein kinase C, epsilon
PA33766	5582	PRKCG	chr19	54375467	54413906	38439	protein kinase C, gamma
PA33767	5583	PRKCH	chr14	61778515	62020698	242183	protein kinase C, eta
PA33768	5584	PRKCI	chr3	169930220	170026770	96550	protein kinase C, iota
PA33773	5588	PRKCQ	chr10	6432558	6632254	199696	protein kinase C, theta
PA33774	5589	PRKCSH	chr19	11536111	11564783	28672	protein kinase C substrate 80K-H
PA33775	5590	PRKCZ	chr1	1971909	2119834	147925	protein kinase C, zeta
PA33771	5587	PRKD1	chr14	30042685	30406899	364214	protein kinase D1
PA134903505	25865	PRKD2	chr19	47174573	47230384	55811	protein kinase D2
PA33772	23683	PRKD3	chr2	37474645	37561915	87270	protein kinase D3
PA33776	5591	PRKDC	chr8	48682669	48882743	200074	protein kinase, DNA-activated, catalytic polypeptide
PA33777	5592	PRKG1	chr10	52740911	54061110	1320199	protein kinase, cGMP-dependent, type I
PA33778	5593	PRKG2	chr4	82005643	82146271	140628	protein kinase, cGMP-dependent, type II
PA33780	8575	PRKRA	chr2	179293141	179325958	32817	protein kinase, interferon-inducible double stranded RNA dependent activator
PA134952162	79706	PRKRIP1	chr7	102026804	102070129	43325	PRKR interacting protein 1 (IL11 inducible)
PA33781	5612	PRKRIR	chr11	76058004	76101880	43876	protein-kinase, interferon-inducible double stranded RNA dependent inhibitor, repressor of (P58 repressor)
PA33786	5613	PRKX	chrX	3519384	3641675	122291	protein kinase, X-linked
PA33790	5617	PRL	chr6	22284473	22313082	28609	prolactin
PA134927756	51052	PRLH	chr2	238465217	238478818	13601	prolactin releasing hormone
PA28847	2834	PRLHR	chr10	120349916	120365160	15244	prolactin releasing hormone receptor
PA33791	5618	PRLR	chr5	35045861	35240823	194962	prolactin receptor
PA33792	5619	PRM1	chr16	11371693	11385192	13499	protamine 1
PA33793	5620	PRM2	chr16	11366493	11380337	13844	protamine 2
PA33794	58531	PRM3	chr16	11364141	11377452	13311	protamine 3
PA29461	3276	PRMT1	chr19	50170409	50194707	24298	protein arginine methyltransferase 1
PA29460	3275	PRMT2	chr21	48045507	48088155	42648	protein arginine methyltransferase 2
PA29462	10196	PRMT3	chr11	20399076	20533879	134803	protein arginine methyltransferase 3
PA35794	10419	PRMT5	chr14	23386733	23408789	22056	protein arginine methyltransferase 5
PA134992775	55170	PRMT6	chr1	107589267	107604916	15649	protein arginine methyltransferase 6
PA143485581	54496	PRMT7	chr16	68334877	68394169	59292	protein arginine methyltransferase 7
PA134903406	56341	PRMT8	chr12	3480515	3706139	225624	protein arginine methyltransferase 8
PA165664476	90826	PRMT9	chr4	148556533	148615280	58747	protein arginine methyltransferase 9
PA33795	23627	PRND	chr20	4692556	4712106	19550	prion protein 2 (dublet)
PA33796	5621	PRNP	chr20	4656797	4685235	28438	prion protein
PA33799	5624	PROC	chr2	128165996	128189822	23826	protein C (inactivator of coagulation factors Va and VIIIa)
PA165432492	147011	PROCA1	chr17	27027214	27049127	21913	protein interacting with cyclin A1
PA33800	10544	PROCR	chr20	33749740	33806771	57031	protein C receptor, endothelial
PA33801	5625	PRODH	chr22	18897206	18934066	36860	proline dehydrogenase (oxidase) 1
PA33802	58510	PRODH2	chr19	36287892	36314201	26309	proline dehydrogenase (oxidase) 2
PA38539	84432	PROK1	chr1	110983788	111002976	19188	prokineticin 1
PA38540	60675	PROK2	chr3	71817806	71844357	26551	prokineticin 2
PA28916	10887	PROKR1	chr2	68860712	68886244	25532	prokineticin receptor 1
PA30014	128674	PROKR2	chr20	5278711	5307378	28667	prokineticin receptor 2
PA33803	58503	PROL1	chr4	71253599	71278914	25315	proline rich, lacrimal 1
PA33807	8842	PROM1	chr4	15966849	16095723	128874	prominin 1
PA134861956	150696	PROM2	chr2	95929674	95969067	39393	prominin 2
PA33808	5626	PROP1	chr5	177416236	177433243	17007	PROP paired-like homeobox 1
PA33809	5627	PROS1	chr3	93588881	93702934	114053	protein S (alpha)
PA33810	11212	PROSC	chr8	37609680	37640286	30606	proline synthetase co-transcribed homolog (bacterial)
PA134912550	80209	PROSER1	chr13	39581002	39622213	41211	proline and serine rich 1
PA134910296	254427	PROSER2	chr10	11855295	11917276	61981	proline and serine rich 2
PA162378639	148137	PROSER3	chr19	36239044	36263077	24033	proline and serine rich 3
PA33812	5629	PROX1	chr1	214151278	214217853	66575	prospero homeobox 1
PA162400142	283571	PROX2	chr14	75316736	75340562	23826	prospero homeobox 2
PA33813	8858	PROZ	chr13	113802968	113829698	26730	protein Z, vitamin K-dependent plasma glycoprotein
PA38449	8559	PRPF18	chr10	13618939	13675868	56929	pre-mRNA processing factor 18
PA134941355	27339	PRPF19	chr11	60655019	60684061	29042	pre-mRNA processing factor 19
PA134892509	9129	PRPF3	chr1	150283928	150328704	44776	pre-mRNA processing factor 3
PA33814	26121	PRPF31	chr19	54608790	54638150	29360	pre-mRNA processing factor 31
PA142671125	84950	PRPF38A	chr1	52860219	52886992	26773	pre-mRNA processing factor 38A
PA142671126	55119	PRPF38B	chr1	109224932	109247425	22493	pre-mRNA processing factor 38B
PA142671127	55015	PRPF39	chr14	45543302	45587804	44502	pre-mRNA processing factor 39
PA38448	9128	PRPF4	chr9	116027914	116059079	31165	pre-mRNA processing factor 4
PA28195	55660	PRPF40A	chr2	153505107	153584628	79521	PRP40 pre-mRNA processing factor 40 homolog A (S. cerevisiae)
PA143485582	25766	PRPF40B	chr12	50007197	50041452	34255	PRP40 pre-mRNA processing factor 40 homolog B (S. cerevisiae)
PA38447	8899	PRPF4B	chr6	4011563	4068217	56654	pre-mRNA processing factor 4B
PA25682	24148	PRPF6	chr20	62602417	62667453	65036	pre-mRNA processing factor 6
PA33815	10594	PRPF8	chr17	1550923	1598176	47253	pre-mRNA processing factor 8
PA33816	5630	PRPH	chr12	49678796	49695481	16685	peripherin
PA34310	5961	PRPH2	chr6	42661333	42700692	39359	peripherin 2 (retinal degeneration, slow)
PA33817	5631	PRPS1	chrX	106861654	106897256	35602	phosphoribosyl pyrophosphate synthetase 1
PA33818	221823	PRPS1L1	chr7	18063397	18077486	14089	phosphoribosyl pyrophosphate synthetase 1-like 1
PA33820	5634	PRPS2	chrX	12799474	12845346	45872	phosphoribosyl pyrophosphate synthetase 2
PA33821	5635	PRPSAP1	chr17	74303868	74389970	86102	phosphoribosyl pyrophosphate synthetase-associated protein 1
PA33822	5636	PRPSAP2	chr17	18749612	18837600	87988	phosphoribosyl pyrophosphate synthetase-associated protein 2
PA142671131	55771	PRR11	chr17	57222860	57287070	64210	proline rich 11
PA134903328	57479	PRR12	chr19	50084912	50132696	47784	proline rich 12
PA143485583	54458	PRR13	chr12	53825433	53843427	17994	proline rich 13
PA144596393	78994	PRR14	chr16	30652038	30670734	18696	proline rich 14
PA145149425	253143	PRR14L	chr22	32074333	32156120	81787	proline rich 14-like
PA162400154	222171	PRR15	chr7	29593039	29609911	16872	proline rich 15
PA165432527	79170	PRR15L	chr17	46026333	46045252	18919	proline rich 15-like
PA162400155	51334	PRR16	chr5	119789973	120026009	236036	proline rich 16
PA162400157	285800	PRR18	chr6	166715788	166732011	16223	proline rich 18
PA162400164	284338	PRR19	chr19	42796284	42817973	21689	proline rich 19
PA165505341	122183	PRR20A	chr13	57705052	57721073	16021	proline rich 20A
PA165505352	729233	PRR20B	chr13	57711622	57727643	16021	proline rich 20B
PA165505363	729240	PRR20C	chr13	57718195	57734216	16021	proline rich 20C
PA165505462	729246	PRR20D	chr13	57724766	57740787	16021	proline rich 20D
PA165505473	729250	PRR20E	chr13	57731331	57747352	16021	proline rich 20E
PA165697417	643905	PRR21	chr2	240978230	240992399	14169	proline rich 21
PA165394215	163154	PRR22	chr19	5779971	5794776	14805	proline rich 22
PA165698130	729627	PRR23A	chr3	138719804	138735110	15306	proline rich 23A
PA165698144	389151	PRR23B	chr3	138734873	138749768	14895	proline rich 23B
PA165698175	389152	PRR23C	chr3	138757944	138773734	15790	proline rich 23C
PA165450599	388199	PRR25	chr16	845443	866861	21418	proline rich 25
PA162379834	401137	PRR27	chr4	71009904	71035326	25422	proline rich 27
PA142672220	92340	PRR29	chr17	62065711	62084645	18934	proline rich 29
PA134950097	80742	PRR3	chr6	30514486	30535473	20987	proline rich 3
PA162379215	339779	PRR30	chr2	27356715	27372332	15617	proline rich 30
PA162383082	100130613	PRR32	chrX	125943747	125958769	15022	proline rich 32
PA145149369	55267	PRR34	chr22	46443339	46460024	16685	proline rich 34
PA25524	146325	PRR35	chr16	600422	618529	18107	proline rich 35
PA33806	11272	PRR4	chr12	10995448	11012075	16627	proline rich 4 (lacrimal)
PA144596392	55615	PRR5	chr22	45054427	45136561	82134	proline rich 5 (renal)
PA165378362	553158	PRR5-ARHGAP8	chr22	45088382	45261664	173282	PRR5-ARHGAP8 readthrough
PA165543593	79899	PRR5L	chr11	36307725	36489754	182029	proline rich 5 like
PA134939770	80758	PRR7	chr5	176863796	176886287	22491	proline rich 7 (synaptic)
PA142671129	574414	PRR9	chr1	153180060	153194793	14733	proline rich 9
PA162400175	133619	PRRC1	chr5	126843301	126893781	50480	proline-rich coiled-coil 1
PA25263	7916	PRRC2A	chr6	31578450	31608554	30104	proline-rich coiled-coil 2A
PA165585468	84726	PRRC2B	chr9	134295477	134378584	83107	proline-rich coiled-coil 2B
PA165750415	23215	PRRC2C	chr1	171444652	171565650	120998	proline-rich coiled-coil 2C
PA33824	5638	PRRG1	chrX	37198528	37319548	121020	proline rich Gla (G-carboxyglutamic acid) 1
PA33825	5639	PRRG2	chr19	50074574	50097272	22698	proline rich Gla (G-carboxyglutamic acid) 2
PA134963933	79057	PRRG3	chrX	150853730	150873063	19333	proline rich Gla (G-carboxyglutamic acid) 3 (transmembrane)
PA134974592	79056	PRRG4	chr11	32841309	32882669	41360	proline rich Gla (G-carboxyglutamic acid) 4 (transmembrane)
PA25932	80863	PRRT1	chr6	32113140	32129720	16580	proline-rich transmembrane protein 1
PA142671132	112476	PRRT2	chr16	29813409	29830202	16793	proline-rich transmembrane protein 2
PA142671133	285368	PRRT3	chr3	9984226	10004078	19852	proline-rich transmembrane protein 3
PA165618245	401399	PRRT4	chr7	127987379	128011739	24360	proline-rich transmembrane protein 4
PA33466	5396	PRRX1	chr1	170623313	170711541	88228	paired related homeobox 1
PA134871679	51450	PRRX2	chr9	132417920	132487953	70033	paired related homeobox 2
PA33828	5644	PRSS1	chr7	142447319	142463927	16608	protease, serine, 1 (trypsin 1)
PA33830	8492	PRSS12	chr4	119198193	119284053	85860	protease, serine, 12 (neurotrypsin, motopsin)
PA33832	10279	PRSS16	chr6	27205480	27227399	21919	protease, serine, 16 (thymus)
PA33833	5645	PRSS2	chr7	964021	980604	16583	protease, serine, 2 (trypsin 2)
PA33834	10942	PRSS21	chr16	2857164	2874723	17559	protease, serine, 21 (testisin)
PA33835	64063	PRSS22	chr16	2899728	2918625	18897	protease, serine, 22
PA134952846	11098	PRSS23	chr11	86501288	86525275	23987	protease, serine, 23
PA33837	83886	PRSS27	chr16	2759423	2780552	21129	protease, serine 27
PA33838	5646	PRSS3	chr9	33740464	33802229	61765	protease, serine, 3
PA134987813	260429	PRSS33	chr16	2830954	2847943	16989	protease, serine, 33
PA134974089	167681	PRSS35	chr6	84212194	84238423	26229	protease, serine, 35
PA142671123	146547	PRSS36	chr16	31147244	31171415	24171	protease, serine, 36
PA165618277	136242	PRSS37	chr7	141533078	141551332	18254	protease, serine, 37
PA165752268	339501	PRSS38	chr1	227993418	228037171	43753	protease, serine, 38
PA165698214	339906	PRSS42	chr3	46868894	46885585	16691	protease, serine, 42
PA165698329	377047	PRSS45	chr3	46780581	46800143	19562	protease, serine, 45
PA165698375	100287362	PRSS46	chr3	46758073	46787921	29848	protease, serine, 46
PA165664477	345062	PRSS48	chr4	152188152	152215719	27567	protease, serine, 48
PA165698443	29122	PRSS50	chr3	46750606	46769373	18767	protease, serine, 50
PA165450635	339105	PRSS53	chr16	31091745	31110289	18544	protease, serine, 53
PA165450675	221191	PRSS54	chr16	58310901	58338951	28050	protease, serine, 54
PA165585933	203074	PRSS55	chr8	10373030	10414676	41646	protease, serine, 55
PA33840	5652	PRSS8	chr16	31139754	31157151	17397	protease, serine, 8
PA134888009	56952	PRTFDC1	chr10	25134536	25252680	118144	phosphoribosyl transferase domain containing 1
PA142671124	283659	PRTG	chr15	55900738	56045847	145109	protogenin
PA33842	5657	PRTN3	chr19	830985	851175	20190	proteinase 3
PA134939749	58497	PRUNE	chr1	150970867	151011189	40322	prune exopolyphosphatase
PA162400198	158471	PRUNE2	chr9	79223292	79531136	307844	prune homolog 2 (Drosophila)
PA33843	57716	PRX	chr19	40896671	40929279	32608	periaxin
PA33844	9081	PRY	chrY	24626544	24663784	37240	PTPN13-like, Y-linked
PA134964356	442862	PRY2	chrY	24214903	24252154	37251	PTPN13-like, Y-linked 2
PA33845	5660	PSAP	chr10	73573055	73621082	48027	prosaposin
PA162400215	768239	PSAPL1	chr4	7429021	7446700	17679	prosaposin-like 1 (gene/pseudogene)
PA128395782	29968	PSAT1	chr9	80901991	80948009	46018	phosphoserine aminotransferase 1
PA33847	8000	PSCA	chr8	143741726	143767145	25419	prostate stem cell antigen
PA33854	5662	PSD	chr10	104159374	104189691	30317	pleckstrin and Sec7 domain containing
PA134885177	84249	PSD2	chr5	139165406	139227051	61645	pleckstrin and Sec7 domain containing 2
PA128394629	23362	PSD3	chr8	18381813	18881196	499383	pleckstrin and Sec7 domain containing 3
PA134875981	23550	PSD4	chr2	113904976	113963677	58701	pleckstrin and Sec7 domain containing 4
PA33855	5663	PSEN1	chr14	73593143	73693399	100256	presenilin 1
PA33856	5664	PSEN2	chr1	227047885	227086804	38919	presenilin 2
PA142671122	55851	PSENEN	chr19	36226478	36241056	14578	presenilin enhancer gamma secretase subunit
PA33861	5669	PSG1	chr19	43367613	43393921	26308	pregnancy specific beta-1-glycoprotein 1
PA164742300	5680	PSG11	chr19	43508809	43540658	31849	pregnancy specific beta-1-glycoprotein 11
PA33864	5670	PSG2	chr19	43565362	43596893	31531	pregnancy specific beta-1-glycoprotein 2
PA33865	5671	PSG3	chr19	43222794	43254668	31874	pregnancy specific beta-1-glycoprotein 3
PA33866	5672	PSG4	chr19	43693854	43719926	26072	pregnancy specific beta-1-glycoprotein 4
PA33867	5673	PSG5	chr19	43668895	43700688	31793	pregnancy specific beta-1-glycoprotein 5
PA33868	5675	PSG6	chr19	43403234	43432076	28842	pregnancy specific beta-1-glycoprotein 6
PA33869	5676	PSG7	chr19	43425284	43451330	26046	pregnancy specific beta-1-glycoprotein 7 (gene/pseudogene)
PA33870	440533	PSG8	chr19	43253839	43279831	25992	pregnancy specific beta-1-glycoprotein 8
PA33871	5678	PSG9	chr19	43754434	43783709	29275	pregnancy specific beta-1-glycoprotein 9
PA33872	11168	PSIP1	chr9	15461064	15521003	59939	PC4 and SFRS1 interacting protein 1
PA33874	5681	PSKH1	chr16	67917175	67966581	49406	protein serine kinase H1
PA134961168	85481	PSKH2	chr8	87057691	87091851	34160	protein serine kinase H2
PA33875	5682	PSMA1	chr11	14523422	14675180	151758	proteasome (prosome, macropain) subunit, alpha type, 1
PA33876	5683	PSMA2	chr7	42953460	42981805	28345	proteasome (prosome, macropain) subunit, alpha type, 2
PA33877	5684	PSMA3	chr14	58701523	58741727	40204	proteasome (prosome, macropain) subunit, alpha type, 3
PA33878	5685	PSMA4	chr15	78822747	78844562	21815	proteasome (prosome, macropain) subunit, alpha type, 4
PA33879	5686	PSMA5	chr1	109938653	109979108	40455	proteasome (prosome, macropain) subunit, alpha type, 5
PA33880	5687	PSMA6	chr14	35737811	35789680	51869	proteasome (prosome, macropain) subunit, alpha type, 6
PA33881	5688	PSMA7	chr20	60708783	60728514	19731	proteasome (prosome, macropain) subunit, alpha type, 7
PA134969470	143471	PSMA8	chr18	23703816	23776319	72503	proteasome (prosome, macropain) subunit, alpha type, 8
PA33882	5689	PSMB1	chr6	170841204	170872417	31213	proteasome (prosome, macropain) subunit, beta type, 1
PA33883	5699	PSMB10	chr16	67965407	67980780	15373	proteasome (prosome, macropain) subunit, beta type, 10
PA162400222	122706	PSMB11	chr14	23501376	23516269	14893	proteasome (prosome, macropain) subunit, beta type, 11
PA33884	5690	PSMB2	chr1	36037259	36117445	80186	proteasome (prosome, macropain) subunit, beta type, 2
PA33885	5691	PSMB3	chr17	36898978	36923484	24506	proteasome (prosome, macropain) subunit, beta type, 3
PA33886	5692	PSMB4	chr1	151362041	151377412	15371	proteasome (prosome, macropain) subunit, beta type, 4
PA33887	5693	PSMB5	chr14	23482752	23514429	31677	proteasome (prosome, macropain) subunit, beta type, 5
PA33888	5694	PSMB6	chr17	4689439	4704798	15359	proteasome (prosome, macropain) subunit, beta type, 6
PA33889	5695	PSMB7	chr9	127112744	127187752	75008	proteasome (prosome, macropain) subunit, beta type, 7
PA33890	5696	PSMB8	chr6	32805494	32822712	17218	proteasome (prosome, macropain) subunit, beta type, 8
PA33891	5698	PSMB9	chr6	32811927	32830628	18701	proteasome (prosome, macropain) subunit, beta type, 9
PA33892	5700	PSMC1	chr14	90712894	90741969	29075	proteasome (prosome, macropain) 26S subunit, ATPase, 1
PA33893	5701	PSMC2	chr7	102974852	103012842	37990	proteasome (prosome, macropain) 26S subunit, ATPase, 2
PA33894	5702	PSMC3	chr11	47437320	47458024	20704	proteasome (prosome, macropain) 26S subunit, ATPase, 3
PA143485584	29893	PSMC3IP	chr17	40721328	40739849	18521	PSMC3 interacting protein
PA33896	5704	PSMC4	chr19	40466912	40490671	23759	proteasome (prosome, macropain) 26S subunit, ATPase, 4
PA33897	5705	PSMC5	chr17	61894770	61912387	17617	proteasome (prosome, macropain) 26S subunit, ATPase, 5
PA33898	5706	PSMC6	chr14	53163894	53197716	33822	proteasome (prosome, macropain) 26S subunit, ATPase, 6
PA33899	5707	PSMD1	chr2	231911578	232040541	128963	proteasome (prosome, macropain) 26S subunit, non-ATPase, 1
PA33900	5716	PSMD10	chrX	107324435	107344874	20439	proteasome (prosome, macropain) 26S subunit, non-ATPase, 10
PA33902	5717	PSMD11	chr17	30761481	30813337	51856	proteasome (prosome, macropain) 26S subunit, non-ATPase, 11
PA33903	5718	PSMD12	chr17	65333619	65372721	39102	proteasome (prosome, macropain) 26S subunit, non-ATPase, 12
PA33904	5719	PSMD13	chr11	226808	255984	29176	proteasome (prosome, macropain) 26S subunit, non-ATPase, 13
PA134957776	10213	PSMD14	chr2	162154786	162271228	116442	proteasome (prosome, macropain) 26S subunit, non-ATPase, 14
PA33905	5708	PSMD2	chr3	184006886	184029842	22956	proteasome (prosome, macropain) 26S subunit, non-ATPase, 2
PA38123	5709	PSMD3	chr17	38127021	38157213	30192	proteasome (prosome, macropain) 26S subunit, non-ATPase, 3
PA33907	5710	PSMD4	chr1	151217176	151242955	25779	proteasome (prosome, macropain) 26S subunit, non-ATPase, 4
PA33909	5711	PSMD5	chr9	123575331	123615299	39968	proteasome (prosome, macropain) 26S subunit, non-ATPase, 5
PA33910	9861	PSMD6	chr3	63993225	64019686	26461	proteasome (prosome, macropain) 26S subunit, non-ATPase, 6
PA33911	5713	PSMD7	chr16	74320673	74343186	22513	proteasome (prosome, macropain) 26S subunit, non-ATPase, 7
PA33912	5714	PSMD8	chr19	38855190	38877464	22274	proteasome (prosome, macropain) 26S subunit, non-ATPase, 8
PA33913	5715	PSMD9	chr12	122316637	122358771	42134	proteasome (prosome, macropain) 26S subunit, non-ATPase, 9
PA33914	5720	PSME1	chr14	24595295	24611176	15881	proteasome (prosome, macropain) activator subunit 1 (PA28 alpha)
PA33915	5721	PSME2	chr14	24609574	24625855	16281	proteasome (prosome, macropain) activator subunit 2 (PA28 beta)
PA33916	10197	PSME3	chr17	40975159	40998777	23618	proteasome (prosome, macropain) activator subunit 3 (PA28 gamma; Ki)
PA134872587	23198	PSME4	chr2	54088204	54207977	119773	proteasome (prosome, macropain) activator subunit 4
PA33917	9491	PSMF1	chr20	1083872	1152017	68145	proteasome (prosome, macropain) inhibitor subunit 1 (PI31)
PA162400229	8624	PSMG1	chr21	40446076	40565440	119364	proteasome (prosome, macropain) assembly chaperone 1
PA162400246	56984	PSMG2	chr18	12648738	12728739	80001	proteasome (prosome, macropain) assembly chaperone 2
PA162400247	84262	PSMG3	chr7	1603968	1619668	15700	proteasome (prosome, macropain) assembly chaperone 3
PA162400256	389362	PSMG4	chr6	3249162	3271300	22138	proteasome (prosome, macropain) assembly chaperone 4
PA33919	170679	PSORS1C1	chr6	31072608	31110869	38261	psoriasis susceptibility 1 candidate 1
PA33920	170680	PSORS1C2	chr6	31102311	31117127	14816	psoriasis susceptibility 1 candidate 2
PA134968603	55269	PSPC1	chr13	20245892	20367159	121267	paraspeckle component 1
PA33928	5723	PSPH	chr7	56075056	56129297	54241	phosphoserine phosphatase
PA33930	5623	PSPN	chr19	6372305	6385860	13555	persephin
PA142671120	84722	PSRC1	chr1	109819176	109835790	16614	proline/serine-rich coiled-coil 1
PA162400268	118672	PSTK	chr10	124729556	124752906	23350	phosphoseryl-tRNA kinase
PA33931	9051	PSTPIP1	chr15	77277021	77332673	55652	proline-serine-threonine phosphatase interacting protein 1
PA33932	9050	PSTPIP2	chr18	43560502	43662250	101748	proline-serine-threonine phosphatase interacting protein 2
PA33933	5724	PTAFR	chr1	28470677	28530447	59770	platelet-activating factor receptor
PA134897041	375743	PTAR1	chr9	72321438	72384916	63478	protein prenyltransferase alpha subunit repeat containing 1
PA33934	5725	PTBP1	chr19	787392	815327	27935	polypyrimidine tract binding protein 1
PA33935	58155	PTBP2	chr1	97177161	97283605	106444	polypyrimidine tract binding protein 2
PA34625	9991	PTBP3	chr9	114976995	115105944	128949	polypyrimidine tract binding protein 3
PA134877986	26024	PTCD1	chr7	99011362	99055811	44449	pentatricopeptide repeat domain 1
PA134909110	79810	PTCD2	chr5	71606200	71659544	53344	pentatricopeptide repeat domain 2
PA147357465	55037	PTCD3	chr2	86323305	86372280	48975	pentatricopeptide repeat domain 3
PA33937	5727	PTCH1	chr9	98202264	98289247	86983	patched 1
PA33938	8643	PTCH2	chr1	45282516	45319226	36710	patched 2
PA134942420	139411	PTCHD1	chrX	23342985	23417918	74933	patched domain containing 1
PA142671116	57540	PTCHD2	chr1	11529295	11600640	71345	patched domain containing 2
PA142671117	374308	PTCHD3	chr10	27684117	27713297	29180	patched domain containing 3
PA134982541	442213	PTCHD4	chr6	47842157	48046425	204268	patched domain containing 4
PA134993184	171558	PTCRA	chr6	42873545	42896583	23038	pre T-cell antigen receptor alpha
PA33939	9791	PTDSS1	chr8	97264167	97349774	85607	phosphatidylserine synthase 1
PA33940	81490	PTDSS2	chr11	440280	494399	54119	phosphatidylserine synthase 2
PA33942	5728	PTEN	chr10	89613195	89731532	118337	phosphatase and tensin homolog
PA33944	9317	PTER	chr10	16468942	16558744	89802	phosphotriesterase related
PA134864129	256297	PTF1A	chr10	23471460	23486181	14721	pancreas specific transcription factor, 1a
PA285	5729	PTGDR	chr14	52724310	52746808	22498	prostaglandin D2 receptor (DP)
PA28891	11251	PTGDR2	chr11	60615398	60633444	18046	prostaglandin D2 receptor 2
PA33945	5730	PTGDS	chr9	139861898	139879194	17296	prostaglandin D2 synthase 21kDa (brain)
PA286	5731	PTGER1	chr19	14580278	14596174	15896	prostaglandin E receptor 1 (subtype EP1), 42kDa
PA287	5732	PTGER2	chr14	52771016	52798324	27308	prostaglandin E receptor 2 (subtype EP2), 53kDa
PA288	5733	PTGER3	chr1	71315036	71523497	208461	prostaglandin E receptor 3 (subtype EP3)
PA289	5734	PTGER4	chr5	40670032	40699962	29930	prostaglandin E receptor 4 (subtype EP4)
PA33948	9536	PTGES	chr9	132497615	132525344	27729	prostaglandin E synthase
PA33949	80142	PTGES2	chr9	130879972	130900741	20769	prostaglandin E synthase 2
PA142671118	10728	PTGES3	chr12	57054125	57092138	38013	prostaglandin E synthase 3 (cytosolic)
PA290	5737	PTGFR	chr1	78946728	79009386	62658	prostaglandin F receptor (FP)
PA33950	5738	PTGFRN	chr1	117442689	117535972	93283	prostaglandin F2 receptor inhibitor
PA291	5739	PTGIR	chr19	47111585	47138375	26790	prostaglandin I2 (prostacyclin) receptor (IP)
PA292	5740	PTGIS	chr20	48117411	48194707	77296	prostaglandin I2 (prostacyclin) synthase
PA162400322	22949	PTGR1	chr9	114309002	114372135	63133	prostaglandin reductase 1
PA162400323	145482	PTGR2	chr14	74308534	74355168	46634	prostaglandin reductase 2
PA24346	5742	PTGS1	chr9	125122809	125160982	38173	prostaglandin-endoperoxide synthase 1 (prostaglandin G/H synthase and cyclooxygenase)
PA293	5743	PTGS2	chr1	186637944	186659559	21615	prostaglandin-endoperoxide synthase 2 (prostaglandin G/H synthase and cyclooxygenase)
PA33951	5741	PTH	chr11	13510601	13527567	16966	parathyroid hormone
PA33953	5745	PTH1R	chr3	46909236	46948289	39053	parathyroid hormone 1 receptor
PA162400324	113091	PTH2	chr19	49922671	49936698	14027	parathyroid hormone 2
PA162400333	5746	PTH2R	chr2	209214569	209362231	147662	parathyroid hormone 2 receptor
PA33952	5744	PTHLH	chr12	28108017	28135664	27647	parathyroid hormone-like hormone
PA33955	5747	PTK2	chr8	141665481	142021412	355931	protein tyrosine kinase 2
PA33956	2185	PTK2B	chr8	27158999	27319908	160909	protein tyrosine kinase 2 beta
PA33960	5753	PTK6	chr20	62156766	62178723	21957	protein tyrosine kinase 6
PA33961	5754	PTK7	chr6	43034006	43132458	98452	protein tyrosine kinase 7
PA33966	5757	PTMA	chr2	232563235	232581251	18016	prothymosin, alpha
PA33973	5763	PTMS	chr12	6865255	6883118	17863	parathymosin
PA33974	5764	PTN	chr7	136909088	137038606	129518	pleiotrophin
PA33976	53635	PTOV1	chr19	50343667	50366999	23332	prostate tumor overexpressed 1
PA33977	7803	PTP4A1	chr6	64271917	64296493	24576	protein tyrosine phosphatase type IVA, member 1
PA33978	8073	PTP4A2	chr1	32369022	32413988	44966	protein tyrosine phosphatase type IVA, member 2
PA33979	11156	PTP4A3	chr8	142392093	142445554	53461	protein tyrosine phosphatase type IVA, member 3
PA134940207	138639	PTPDC1	chr9	96783076	96875138	92062	protein tyrosine phosphatase domain containing 1
PA33982	9200	PTPLA	chr10	17628031	17669383	41352	protein tyrosine phosphatase-like (proline instead of catalytic arginine), member A
PA142671113	51495	PTPLAD1	chr15	65812804	65873693	60889	protein tyrosine phosphatase-like A domain containing 1
PA142671114	401494	PTPLAD2	chr9	21000620	21041635	41015	protein tyrosine phosphatase-like A domain containing 2
PA33983	201562	PTPLB	chr3	123210363	123313924	103561	protein tyrosine phosphatase-like (proline instead of catalytic arginine), member b
PA142671115	114971	PTPMT1	chr11	47576888	47598013	21125	protein tyrosine phosphatase, mitochondrial 1
PA33985	5770	PTPN1	chr20	49116858	49204299	87441	protein tyrosine phosphatase, non-receptor type 1
PA33986	5781	PTPN11	chr12	112846536	112950717	104181	protein tyrosine phosphatase, non-receptor type 11
PA33987	5782	PTPN12	chr7	77156773	77272388	115615	protein tyrosine phosphatase, non-receptor type 12
PA33988	5783	PTPN13	chr4	87505468	87739332	233864	protein tyrosine phosphatase, non-receptor type 13 (APO-1/CD95 (Fas)-associated phosphatase)
PA33989	5784	PTPN14	chr1	214518640	214735024	216384	protein tyrosine phosphatase, non-receptor type 14
PA33991	26469	PTPN18	chr2	131103580	131135982	32402	protein tyrosine phosphatase, non-receptor type 18 (brain-derived)
PA33993	5771	PTPN2	chr18	12782477	12894337	111860	protein tyrosine phosphatase, non-receptor type 2
PA134904835	653129	PTPN20A	chr10	46547123	46651021	103898	protein tyrosine phosphatase, non-receptor type 20A
PA134863260	26095	PTPN20B	chr10	48734042	48837942	103900	protein tyrosine phosphatase, non-receptor type 20B
PA33994	11099	PTPN21	chr14	88929122	89031123	102001	protein tyrosine phosphatase, non-receptor type 21
PA33995	26191	PTPN22	chr1	114353433	114424375	70942	protein tyrosine phosphatase, non-receptor type 22 (lymphoid)
PA33996	25930	PTPN23	chr3	47412383	47457931	45548	protein tyrosine phosphatase, non-receptor type 23
PA33999	5774	PTPN3	chr9	112134974	112270593	135619	protein tyrosine phosphatase, non-receptor type 3
PA34000	5775	PTPN4	chr2	120507207	120745496	238289	protein tyrosine phosphatase, non-receptor type 4 (megakaryocyte)
PA34001	84867	PTPN5	chr11	18746475	18824268	77793	protein tyrosine phosphatase, non-receptor type 5 (striatum-enriched)
PA34002	5777	PTPN6	chr12	7045740	7073479	27739	protein tyrosine phosphatase, non-receptor type 6
PA34003	5778	PTPN7	chr1	202113141	202140716	27575	protein tyrosine phosphatase, non-receptor type 7
PA34005	5780	PTPN9	chr15	75756462	75881625	125163	protein tyrosine phosphatase, non-receptor type 9
PA34009	5786	PTPRA	chr20	2834841	3022316	187475	protein tyrosine phosphatase, receptor type, A
PA34010	5787	PTPRB	chr12	70907630	71041220	133590	protein tyrosine phosphatase, receptor type, B
PA34011	5788	PTPRC	chr1	198598098	198729605	131507	protein tyrosine phosphatase, receptor type, C
PA34012	5790	PTPRCAP	chr11	67199981	67215153	15172	protein tyrosine phosphatase, receptor type, C-associated protein
PA34013	5789	PTPRD	chr9	8311246	10622723	2311477	protein tyrosine phosphatase, receptor type, D
PA34014	5791	PTPRE	chr10	129695325	129887180	191855	protein tyrosine phosphatase, receptor type, E
PA34015	5792	PTPRF	chr1	43981708	44092343	110635	protein tyrosine phosphatase, receptor type, F
PA34016	5793	PTPRG	chr3	61537243	62283573	746330	protein tyrosine phosphatase, receptor type, G
PA34017	5794	PTPRH	chr19	55689615	55730874	41259	protein tyrosine phosphatase, receptor type, H
PA34018	5795	PTPRJ	chr11	47992101	48195394	203293	protein tyrosine phosphatase, receptor type, J
PA34019	5796	PTPRK	chr6	128286924	128851870	564946	protein tyrosine phosphatase, receptor type, K
PA34020	5797	PTPRM	chr18	7557314	8409859	852545	protein tyrosine phosphatase, receptor type, M
PA34021	5798	PTPRN	chr2	220151345	220184295	32950	protein tyrosine phosphatase, receptor type, N
PA34022	5799	PTPRN2	chr7	157328750	158390482	1061732	protein tyrosine phosphatase, receptor type, N polypeptide 2
PA34023	5800	PTPRO	chr12	15465191	15754265	289074	protein tyrosine phosphatase, receptor type, O
PA164742315	374462	PTPRQ	chr12	80828126	81076968	248842	protein tyrosine phosphatase, receptor type, Q
PA34025	5801	PTPRR	chr12	71028853	71324584	295731	protein tyrosine phosphatase, receptor type, R
PA34026	5802	PTPRS	chr19	5202514	5350814	148300	protein tyrosine phosphatase, receptor type, S
PA34027	11122	PTPRT	chr20	40698392	41828557	1130165	protein tyrosine phosphatase, receptor type, T
PA34028	10076	PTPRU	chr1	29553028	29656325	103297	protein tyrosine phosphatase, receptor type, U
PA34029	5803	PTPRZ1	chr7	121503159	121705090	201931	protein tyrosine phosphatase, receptor-type, Z polypeptide 1
PA34031	284119	PTRF	chr17	40551467	40585506	34039	polymerase I and transcript release factor
PA134917129	138428	PTRH1	chr9	130473227	130497152	23925	peptidyl-tRNA hydrolase 1 homolog (S. cerevisiae)
PA143485586	51651	PTRH2	chr17	57771667	57794856	23189	peptidyl-tRNA hydrolase 2
PA162379611	391356	PTRHD1	chr2	25010136	25026251	16115	peptidyl-tRNA hydrolase domain containing 1
PA34032	5805	PTS	chr11	112087088	112107696	20608	6-pyruvoyltetrahydropterin synthase
PA34033	9232	PTTG1	chr5	159838865	159858747	19882	pituitary tumor-transforming 1
PA34034	754	PTTG1IP	chr21	46266500	46304487	37987	pituitary tumor-transforming 1 interacting protein
PA34035	10744	PTTG2	chr4	37952056	37965631	13575	pituitary tumor-transforming 2
PA134988136	26255	PTTG3P	chr8	67676632	67690240	13608	pituitary tumor-transforming 3, pseudogene
PA34036	5806	PTX3	chr3	157144580	157164417	19837	pentraxin 3, long
PA25553	390667	PTX4	chr16	1532940	1548468	15528	pentraxin 4, long
PA162400364	22827	PUF60	chr8	144895514	144921556	26042	poly-U binding splicing factor 60KDa
PA34042	9698	PUM1	chr1	31401353	31548838	147485	pumilio RNA-binding family member 1
PA34043	23369	PUM2	chr2	20445453	20560585	115132	pumilio RNA-binding family member 2
PA34045	5813	PURA	chr5	139483708	139502001	18293	purine-rich element binding protein A
PA34046	5814	PURB	chr7	44912892	44934960	22068	purine-rich element binding protein B
PA134879671	29942	PURG	chr8	30850320	30901231	50911	purine-rich element binding protein G
PA34047	80324	PUS1	chr12	132403745	132431406	27661	pseudouridylate synthase 1
PA162400393	150962	PUS10	chr2	61164548	61255365	90817	pseudouridylate synthase 10
PA134874048	83480	PUS3	chr11	125760380	125783145	22765	pseudouridylate synthase 3
PA143485587	54517	PUS7	chr7	105093948	105172689	78741	pseudouridylate synthase 7 (putative)
PA143485588	83448	PUS7L	chr12	44118828	44162620	43792	pseudouridylate synthase 7 homolog (S. cerevisiae)-like
PA134947837	126789	PUSL1	chr1	1233962	1250057	16095	pseudouridylate synthase-like 1
PA34049	5816	PVALB	chr22	37193745	37225517	31772	parvalbumin
PA34050	5817	PVR	chr19	45137098	45172429	35331	poliovirus receptor
PA162400434	79037	PVRIG	chr7	99806147	99822113	15966	poliovirus receptor related immunoglobulin domain containing
PA34051	5818	PVRL1	chr11	119505808	119609435	103627	poliovirus receptor-related 1 (herpesvirus entry mediator C)
PA34052	5819	PVRL2	chr19	45339393	45395485	56092	poliovirus receptor-related 2 (herpesvirus entry mediator B)
PA134969621	25945	PVRL3	chr3	110780606	110916017	135411	poliovirus receptor-related 3
PA134991624	81607	PVRL4	chr1	161037781	161069385	31604	poliovirus receptor-related 4
PA142671112	11137	PWP1	chr12	108069590	108109257	39667	PWP1 homolog (S. cerevisiae)
PA162400451	5822	PWP2	chr21	45517208	45554063	36855	PWP2 periodic tryptophan protein homolog (yeast)
PA162400500	114825	PWWP2A	chr5	159499889	159556452	56563	PWWP domain containing 2A
PA162400513	170394	PWWP2B	chr10	134200702	134234363	33661	PWWP domain containing 2B
PA134944183	221749	PXDC1	chr6	3719836	3762246	42410	PX domain containing 1
PA128394535	7837	PXDN	chr2	1632659	1758291	125632	peroxidasin homolog (Drosophila)
PA142671110	137902	PXDNL	chr8	52229137	52732005	502868	peroxidasin homolog (Drosophila)-like
PA134899496	54899	PXK	chr3	58308617	58414815	106198	PX domain containing serine/threonine kinase
PA34059	5827	PXMP2	chr12	133254192	133284577	30385	peroxisomal membrane protein 2, 22kDa
PA34061	11264	PXMP4	chr20	32287550	32318136	30586	peroxisomal membrane protein 4, 24kDa
PA34062	5829	PXN	chr12	120645242	120713574	68332	paxillin
PA134958920	222659	PXT1	chr6	36355328	36420666	65338	peroxisomal, testis specific 1
PA134964387	92370	PXYLP1	chr3	140940682	141016486	75804	2-phosphoxylose phosphatase 1
PA134950175	29108	PYCARD	chr16	31209807	31224097	14290	PYD and CARD domain containing
PA34064	5831	PYCR1	chr17	79887260	79905203	17943	pyrroline-5-carboxylate reductase 1
PA134881955	29920	PYCR2	chr1	226104577	226122040	17463	pyrroline-5-carboxylate reductase family, member 2
PA134889043	65263	PYCRL	chr8	144683083	144701784	18701	pyrroline-5-carboxylate reductase-like
PA142671111	260434	PYDC1	chr16	31224283	31238398	14115	PYD (pyrin domain) containing 1
PA162400524	152138	PYDC2	chr3	191168952	191182245	13293	pyrin domain containing 2
PA34066	5834	PYGB	chr20	25218706	25281648	62942	phosphorylase, glycogen; brain
PA34068	5836	PYGL	chr14	51368935	51421248	52313	phosphorylase, glycogen, liver
PA34069	5837	PYGM	chr11	64510861	64538187	27326	phosphorylase, glycogen, muscle
PA134875127	26108	PYGO1	chr15	55833805	55891050	57245	pygopus family PHD finger 1
PA134881185	90780	PYGO2	chr1	154926502	154944258	17756	pygopus family PHD finger 2
PA134967485	149628	PYHIN1	chr1	158891337	158949849	58512	pyrin and HIN domain family, member 1
PA162400525	79912	PYROXD1	chr12	21580538	21627184	46646	pyridine nucleotide-disulphide oxidoreductase domain 1
PA165549043	84795	PYROXD2	chr10	100140322	100184978	44656	pyridine nucleotide-disulphide oxidoreductase domain 2
PA34090	5697	PYY	chr17	42027101	42091837	64736	peptide YY
PA34092	5858	PZP	chr12	9298436	9370966	72530	pregnancy-zone protein
PA34093	5859	QARS	chr3	49130365	49152562	22197	glutaminyl-tRNA synthetase
PA34094	5860	QDPR	chr4	17485016	17523857	38841	quinoid dihydropteridine reductase
PA134912180	9444	QKI	chr6	163825675	164002628	176953	QKI, KH domain containing, RNA binding
PA34095	25797	QPCT	chr2	37561742	37603465	41723	glutaminyl-peptide cyclotransferase
PA134922163	54814	QPCTL	chr19	46185741	46210248	24507	glutaminyl-peptide cyclotransferase-like
PA34096	23475	QPRT	chr16	29680334	29712324	31990	quinolinate phosphoribosyltransferase
PA162400554	347148	QRFP	chr9	133765815	133779225	13410	pyroglutamylated RFamide peptide
PA164725243	84109	QRFPR	chr4	122246797	122312181	65384	pyroglutamylated RFamide peptide receptor
PA142671106	54870	QRICH1	chr3	49064140	49141504	77364	glutamine-rich 1
PA142671107	84074	QRICH2	chr17	74267130	74314771	47641	glutamine rich 2
PA128394680	55278	QRSL1	chr6	107067441	107119292	51851	glutaminyl-tRNA synthase (glutamine-hydrolyzing)-like 1
PA143485589	79832	QSER1	chr11	32904792	33004816	100024	glutamine and serine rich 1
PA162400559	5768	QSOX1	chr1	180113968	180172430	58462	quiescin Q6 sulfhydryl oxidase 1
PA162400588	169714	QSOX2	chr9	139095179	139147687	52508	quiescin Q6 sulfhydryl oxidase 2
PA134963074	81890	QTRT1	chr19	10802112	10827043	24931	queuine tRNA-ribosyltransferase 1
PA134925851	79691	QTRTD1	chr3	113765582	113810269	44687	queuine tRNA-ribosyltransferase domain containing 1
PA142671108	203069	R3HCC1	chr8	23135442	23156792	21350	R3H domain and coiled-coil containing 1
PA134939071	27291	R3HCC1L	chr10	99884381	100007654	123273	R3H domain and coiled-coil containing 1-like
PA34098	23518	R3HDM1	chr2	136279036	136485839	206803	R3H domain containing 1
PA143485590	22864	R3HDM2	chr12	57644547	57834782	190235	R3H domain containing 2
PA134902004	91300	R3HDM4	chr19	893503	923225	29722	R3H domain containing 4
PA34099	140902	R3HDML	chr20	42955798	42982432	26634	R3H domain containing-like
PA34100	10890	RAB10	chr2	26246729	26363323	116594	RAB10, member RAS oncogene family
PA34101	8766	RAB11A	chr15	66151629	66187329	35700	RAB11A, member RAS oncogene family
PA34102	9230	RAB11B	chr19	8445205	8472318	27113	RAB11B, member RAS oncogene family
PA134937501	80223	RAB11FIP1	chr8	37713465	37767015	53550	RAB11 family interacting protein 1 (class I)
PA134961225	22841	RAB11FIP2	chr10	119761427	119816297	54870	RAB11 family interacting protein 2 (class I)
PA134950896	9727	RAB11FIP3	chr16	465649	575485	109836	RAB11 family interacting protein 3 (class II)
PA134978007	84440	RAB11FIP4	chr17	29708642	29868232	159590	RAB11 family interacting protein 4 (class II)
PA134971129	26056	RAB11FIP5	chr2	73297510	73350146	52636	RAB11 family interacting protein 5 (class I)
PA142671102	201475	RAB12	chr18	8599443	8642380	42937	RAB12, member RAS oncogene family
PA34103	5872	RAB13	chr1	153951093	153968853	17760	RAB13, member RAS oncogene family
PA34104	51552	RAB14	chr9	123937415	123974365	36950	RAB14, member RAS oncogene family
PA134901572	376267	RAB15	chr14	65409532	65449016	39484	RAB15, member RAS oncogene family
PA34105	64284	RAB17	chr2	238479965	238509769	29804	RAB17, member RAS oncogene family
PA34106	22931	RAB18	chr10	27783103	27834166	51063	RAB18, member RAS oncogene family
PA162400617	401409	RAB19	chr7	140093843	140129653	35810	RAB19, member RAS oncogene family
PA34107	5861	RAB1A	chr2	65310988	65367435	56447	RAB1A, member RAS oncogene family
PA34108	81876	RAB1B	chr11	66026056	66047963	21907	RAB1B, member RAS oncogene family
PA34110	55647	RAB20	chr13	111172413	111224071	51658	RAB20, member RAS oncogene family
PA34111	23011	RAB21	chr12	72138658	72184150	45492	RAB21, member RAS oncogene family
PA34112	57403	RAB22A	chr20	56874771	56945563	70792	RAB22A, member RAS oncogene family
PA34113	51715	RAB23	chr6	57048790	57097112	48322	RAB23, member RAS oncogene family
PA34114	53917	RAB24	chr5	176725199	176740744	15545	RAB24, member RAS oncogene family
PA34115	57111	RAB25	chr1	156020966	156043295	22329	RAB25, member RAS oncogene family
PA34116	25837	RAB26	chr16	2188145	2207141	18996	RAB26, member RAS oncogene family
PA34117	5873	RAB27A	chr15	55492164	55592034	99870	RAB27A, member RAS oncogene family
PA34118	5874	RAB27B	chr18	52375097	52565747	190650	RAB27B, member RAS oncogene family
PA34119	9364	RAB28	chr4	13340863	13495989	155126	RAB28, member RAS oncogene family
PA34151	8934	RAB29	chr1	205734114	205754610	20496	RAB29, member RAS oncogene family
PA162400618	5862	RAB2A	chr8	61419469	61539203	119734	RAB2A, member RAS oncogene family
PA134865942	84932	RAB2B	chr14	21924179	21955132	30953	RAB2B, member RAS oncogene family
PA34121	27314	RAB30	chr11	82681177	82792965	111788	RAB30, member RAS oncogene family
PA34122	11031	RAB31	chr18	9698228	9865553	167325	RAB31, member RAS oncogene family
PA34123	10981	RAB32	chr6	146854828	146879086	24258	RAB32, member RAS oncogene family
PA34124	9363	RAB33A	chrX	129295773	129321844	26071	RAB33A, member RAS oncogene family
PA34125	83452	RAB33B	chr4	140364961	140400070	35109	RAB33B, member RAS oncogene family
PA34126	83871	RAB34	chr17	27038299	27055286	16987	RAB34, member RAS oncogene family
PA34127	11021	RAB35	chr12	120529899	120564643	34744	RAB35, member RAS oncogene family
PA34128	9609	RAB36	chr22	23477513	23509531	32018	RAB36, member RAS oncogene family
PA134901093	326624	RAB37	chr17	72657256	72746474	89218	RAB37, member RAS oncogene family
PA34129	23682	RAB38	chr11	87843415	87918635	75220	RAB38, member RAS oncogene family
PA34130	54734	RAB39A	chr11	107789277	107837208	47931	RAB39A, member RAS oncogene family
PA34131	116442	RAB39B	chrX	154484526	154503852	19326	RAB39B, member RAS oncogene family
PA34132	5864	RAB3A	chr19	18304609	18324874	20265	RAB3A, member RAS oncogene family
PA34133	5865	RAB3B	chr1	52370628	52466436	95808	RAB3B, member RAS oncogene family
PA134874100	115827	RAB3C	chr5	57867950	58158221	290271	RAB3C, member RAS oncogene family
PA34134	9545	RAB3D	chr19	11429722	11460344	30622	RAB3D, member RAS oncogene family
PA134969639	22930	RAB3GAP1	chr2	135799835	135931280	131445	RAB3 GTPase activating protein subunit 1 (catalytic)
PA142671105	25782	RAB3GAP2	chr1	220318610	220455843	137233	RAB3 GTPase activating protein subunit 2 (non-catalytic)
PA34135	5866	RAB3IL1	chr11	61661706	61723747	62041	RAB3A interacting protein (rabin3)-like 1
PA34136	117177	RAB3IP	chr12	70122466	70219984	97518	RAB3A interacting protein
PA34137	142684	RAB40A	chrX	102750053	102784417	34364	RAB40A, member RAS oncogene family
PA142671103	282808	RAB40AL	chrX	102182200	102196228	14028	RAB40A, member RAS oncogene family-like
PA34138	10966	RAB40B	chr17	80611943	80666598	54655	RAB40B, member RAS oncogene family
PA34139	57799	RAB40C	chr16	629357	682273	52916	RAB40C, member RAS oncogene family
PA34140	347517	RAB41	chrX	69492022	69507852	15830	RAB41, member RAS oncogene family
PA134976516	115273	RAB42	chr1	28908712	28924098	15386	RAB42, member RAS oncogene family
PA134968262	339122	RAB43	chr3	128803412	128850993	47581	RAB43, member RAS oncogene family
PA34141	5867	RAB4A	chr1	229396809	229444641	47832	RAB4A, member RAS oncogene family
PA34142	53916	RAB4B	chr19	41273670	41305849	32179	RAB4B, member RAS oncogene family
PA34143	5868	RAB5A	chr3	19978572	20029667	51095	RAB5A, member RAS oncogene family
PA34144	5869	RAB5B	chr12	56357697	56393467	35770	RAB5B, member RAS oncogene family
PA34145	5878	RAB5C	chr17	40273994	40317062	43068	RAB5C, member RAS oncogene family
PA34146	5870	RAB6A	chr11	73383683	73482201	98518	RAB6A, member RAS oncogene family
PA34147	51560	RAB6B	chr3	133540079	133624691	84612	RAB6B, member RAS oncogene family
PA34148	84084	RAB6C	chr2	130727235	130743311	16076	RAB6C, member RAS oncogene family
PA162400619	7879	RAB7A	chr3	128434975	128536641	101666	RAB7A, member RAS oncogene family
PA30743	4218	RAB8A	chr19	16212490	16247445	34955	RAB8A, member RAS oncogene family
PA134944620	51762	RAB8B	chr15	63471728	63562975	91247	RAB8B, member RAS oncogene family
PA34152	9367	RAB9A	chrX	13697240	13730944	33704	RAB9A, member RAS oncogene family
PA34153	51209	RAB9B	chrX	103074255	103097212	22957	RAB9B, member RAS oncogene family
PA34155	10567	RABAC1	chr19	42457833	42473530	15697	Rab acceptor 1 (prenylated)
PA134884097	9135	RABEP1	chr17	5175558	5292132	116574	rabaptin, RAB GTPase binding effector protein 1
PA134952719	79874	RABEP2	chr16	28912742	28947339	34597	rabaptin, RAB GTPase binding effector protein 2
PA142671100	10244	RABEPK	chr9	127952821	127999438	46617	Rab9 effector protein with kelch motifs
PA134977298	23637	RABGAP1	chr9	125693288	125870147	176859	RAB GTPase activating protein 1
PA134940645	9910	RABGAP1L	chr1	174118552	174967445	848893	RAB GTPase activating protein 1-like
PA134946532	27342	RABGEF1	chr7	66137151	66279451	142300	RAB guanine nucleotide exchange factor (GEF) 1
PA34156	5875	RABGGTA	chr14	24731744	24750833	19089	Rab geranylgeranyltransferase, alpha subunit
PA34157	5876	RABGGTB	chr1	76241879	76263775	21896	Rab geranylgeranyltransferase, beta subunit
PA34158	5877	RABIF	chr1	202844410	202868385	23975	RAB interacting factor
PA34159	11159	RABL2A	chr2	114374814	114403975	29161	RAB, member of RAS oncogene family-like 2A
PA34160	11158	RABL2B	chr22	51202920	51232103	29183	RAB, member of RAS oncogene family-like 2B
PA34161	285282	RABL3	chr3	120402528	120471384	68856	RAB, member of RAS oncogene family-like 3
PA134868176	55684	RABL6	chr9	139692374	139738639	46265	RAB, member RAS oncogene family-like 6
PA34162	5879	RAC1	chr7	6404126	6446598	42472	ras-related C3 botulinum toxin substrate 1 (rho family, small GTP binding protein Rac1)
PA34163	5880	RAC2	chr22	37618301	37650339	32038	ras-related C3 botulinum toxin substrate 2 (rho family, small GTP binding protein Rac2)
PA34164	5881	RAC3	chr17	79979532	79995080	15548	ras-related C3 botulinum toxin substrate 3 (rho family, small GTP binding protein Rac3)
PA34165	29127	RACGAP1	chr12	50379945	50435586	55641	Rac GTPase activating protein 1
PA34166	5810	RAD1	chr5	34902365	34925780	23415	RAD1 checkpoint DNA exonuclease
PA34167	5884	RAD17	chr5	68655124	68713628	58504	RAD17 homolog (S. pombe)
PA134912253	56852	RAD18	chr3	8915880	9015159	99279	RAD18 E3 ubiquitin protein ligase
PA34170	5885	RAD21	chr8	117855173	117897105	41932	RAD21 homolog (S. pombe)
PA34171	642636	RAD21L1	chr20	1196707	1238988	42281	RAD21-like 1 (S. pombe)
PA34172	5886	RAD23A	chr19	13046628	13067457	20829	RAD23 homolog A (S. cerevisiae)
PA34173	5887	RAD23B	chr9	110035517	110097475	61958	RAD23 homolog B (S. cerevisiae)
PA34175	10111	RAD50	chr5	131882616	131983313	100697	RAD50 homolog (S. cerevisiae)
PA34176	5888	RAD51	chr15	40977327	41027356	50029	RAD51 recombinase
PA134871784	10635	RAD51AP1	chr12	4637940	4672213	34273	RAD51 associated protein 1
PA164725260	729475	RAD51AP2	chr2	17688851	17711847	22996	RAD51 associated protein 2
PA34178	5890	RAD51B	chr14	68276496	69152889	876393	RAD51 paralog B
PA34177	5889	RAD51C	chr17	56759934	56814703	54769	RAD51 paralog C
PA34179	5892	RAD51D	chr17	33423811	33456888	33077	RAD51 paralog D
PA34180	5893	RAD52	chr12	1018255	1109774	91519	RAD52 homolog (S. cerevisiae)
PA134927202	25788	RAD54B	chr8	95381188	95497343	116155	RAD54 homolog B (S. cerevisiae)
PA34181	8438	RAD54L	chr1	46703367	46747145	43778	RAD54-like (S. cerevisiae)
PA143485591	23132	RAD54L2	chr3	51565596	51700634	135038	RAD54-like 2 (S. cerevisiae)
PA294	5883	RAD9A	chr11	67149423	67168883	19460	RAD9 homolog A (S. pombe)
PA134889252	144715	RAD9B	chr12	110930005	110976952	46947	RAD9 homolog B (S. pombe)
PA164725261	55698	RADIL	chr7	4835736	4933335	97599	Ras association and DIL domains
PA34182	8480	RAE1	chr20	55916145	55956519	40374	ribonucleic acid export 1
PA134913788	135250	RAET1E	chr6	150201511	150227195	25684	retinoic acid early transcript 1E
PA134897742	353091	RAET1G	chr6	150235014	150254269	19255	retinoic acid early transcript 1G
PA134918665	154064	RAET1L	chr6	150338266	150356668	18402	retinoic acid early transcript 1L
PA34183	5894	RAF1	chr3	12622100	12715700	93600	Raf-1 proto-oncogene, serine/threonine kinase
PA34185	5896	RAG1	chr11	36522053	36604312	82259	recombination activating gene 1
PA34186	5897	RAG2	chr11	36610493	36629829	19336	recombination activating gene 2
PA34188	10743	RAI1	chr17	17574787	17717767	142980	retinoic acid induced 1
PA34189	26064	RAI14	chr5	34646342	34835717	189375	retinoic acid induced 14
PA34193	10742	RAI2	chrX	17815169	17889457	74288	retinoic acid induced 2
PA34197	5898	RALA	chr7	39653152	39750723	97571	v-ral simian leukemia viral oncogene homolog A (ras related)
PA34198	5899	RALB	chr2	120987646	121055287	67641	v-ral simian leukemia viral oncogene homolog B
PA34199	10928	RALBP1	chr18	9465530	9541106	75576	ralA binding protein 1
PA165479278	253959	RALGAPA1	chr14	36004558	36288432	283874	Ral GTPase activating protein, alpha subunit 1 (catalytic)
PA25784	57186	RALGAPA2	chr20	20367202	20703281	336079	Ral GTPase activating protein, alpha subunit 2 (catalytic)
PA165392608	57148	RALGAPB	chr20	37091486	37210504	119018	Ral GTPase activating protein, beta subunit (non-catalytic)
PA34200	5900	RALGDS	chr9	135970107	136034607	64500	ral guanine nucleotide dissociation stimulator
PA134907502	9649	RALGPS1	chr9	129667053	129988445	321392	Ral GEF with PH domain and SH3 binding motif 1
PA134864387	55103	RALGPS2	chr1	178684300	178893975	209675	Ral GEF with PH domain and SH3 binding motif 2
PA34201	22913	RALY	chr20	32571458	32673991	102533	RALY heterogeneous nuclear ribonucleoprotein
PA162400636	138046	RALYL	chr8	85085453	85837079	751626	RALY RNA binding protein-like
PA34202	10267	RAMP1	chr2	238758187	238823756	65569	receptor (G protein-coupled) activity modifying protein 1
PA34203	10266	RAMP2	chr17	40903145	40918063	14918	receptor (G protein-coupled) activity modifying protein 2
PA34204	10268	RAMP3	chr7	45187367	45226849	39482	receptor (G protein-coupled) activity modifying protein 3
PA34205	5901	RAN	chr12	131346617	131365220	18603	RAN, member RAS oncogene family
PA34206	5902	RANBP1	chr22	20093461	20117880	24419	RAN binding protein 1
PA134929520	57610	RANBP10	chr16	67753973	67850788	96815	RAN binding protein 10
PA34208	64901	RANBP17	chr5	170278880	170730454	451574	RAN binding protein 17
PA34209	5903	RANBP2	chr2	109325902	109405267	79365	RAN binding protein 2
PA34211	8498	RANBP3	chr19	5913150	5988320	75170	RAN binding protein 3
PA162400660	202151	RANBP3L	chr5	36244950	36312011	67061	RAN binding protein 3-like
PA34212	26953	RANBP6	chr9	6008019	6025640	17621	RAN binding protein 6
PA34215	10048	RANBP9	chr6	13618730	13721796	103066	RAN binding protein 9
PA34216	5905	RANGAP1	chr22	41637781	41692255	54474	Ran GTPase activating protein 1
PA162400661	29098	RANGRF	chr17	8181745	8196409	14664	RAN guanine nucleotide release factor
PA34217	5906	RAP1A	chr1	112152405	112259807	107402	RAP1A, member of RAS oncogene family
PA34219	5908	RAP1B	chr12	68994619	69057385	62766	RAP1B, member of RAS oncogene family
PA34220	5909	RAP1GAP	chr1	21919708	22006010	86302	RAP1 GTPase activating protein
PA165432528	23108	RAP1GAP2	chr17	2649050	2944035	294985	RAP1 GTPase activating protein 2
PA34221	5910	RAP1GDS1	chr4	99172527	99368012	195485	RAP1, GTP-GDP dissociation stimulator 1
PA34222	5911	RAP2A	chr13	98076475	98123252	46777	RAP2A, member of RAS oncogene family
PA34223	5912	RAP2B	chr3	152870001	152891413	21412	RAP2B, member of RAS oncogene family
PA134899238	57826	RAP2C	chrX	131334052	131363508	29456	RAP2C, member of RAS oncogene family
PA28964	2889	RAPGEF1	chr9	134449157	134625364	176207	Rap guanine nucleotide exchange factor (GEF) 1
PA130413152	9693	RAPGEF2	chr4	160015224	160284314	269090	Rap guanine nucleotide exchange factor (GEF) 2
PA134910959	10411	RAPGEF3	chr12	48125453	48174846	49393	Rap guanine nucleotide exchange factor (GEF) 3
PA134861108	11069	RAPGEF4	chr2	173590525	173920621	330096	Rap guanine nucleotide exchange factor (GEF) 4
PA134902361	9771	RAPGEF5	chr7	22154908	22406751	251843	Rap guanine nucleotide exchange factor (GEF) 5
PA134885793	51735	RAPGEF6	chr5	130756614	130980929	224315	Rap guanine nucleotide exchange factor (GEF) 6
PA134884826	51195	RAPGEFL1	chr17	38324242	38354906	30664	Rap guanine nucleotide exchange factor (GEF)-like 1
PA24749	65059	RAPH1	chr2	204295538	204410058	114520	Ras association (RalGDS/AF-6) and pleckstrin homology domains 1
PA34224	5913	RAPSN	chr11	47456308	47480730	24422	receptor-associated protein of the synapse
PA34225	5914	RARA	chr17	38455423	38516895	61472	retinoic acid receptor, alpha
PA34226	5915	RARB	chr3	25205638	25642423	436785	retinoic acid receptor, beta
PA34227	5916	RARG	chr12	53601350	53636040	34690	retinoic acid receptor, gamma
PA34228	5918	RARRES1	chr3	158411892	158460642	48750	retinoic acid receptor responder (tazarotene induced) 1
PA34229	5919	RARRES2	chr7	150028033	150048773	20740	retinoic acid receptor responder (tazarotene induced) 2
PA34230	5920	RARRES3	chr11	63294273	63316930	22657	retinoic acid receptor responder (tazarotene induced) 3
PA34231	5917	RARS	chr5	167903463	167949311	45848	arginyl-tRNA synthetase
PA162400662	57038	RARS2	chr6	88220656	88309735	89079	arginyl-tRNA synthetase 2, mitochondrial
PA34232	5921	RASA1	chr5	86554070	86690743	136673	RAS p21 protein activator (GTPase activating protein) 1
PA34233	5922	RASA2	chr3	141195891	141337186	141295	RAS p21 protein activator 2
PA134905447	22821	RASA3	chr13	114744194	114908095	163901	RAS p21 protein activator 3
PA134889495	10156	RASA4	chr7	102217093	102267205	50112	RAS p21 protein activator 4
PA164725296	100271927	RASA4B	chr7	102120586	102168224	47638	RAS p21 protein activator 4B
PA34234	8437	RASAL1	chr12	113533624	113584044	50420	RAS protein activator like 1 (GAP1 like)
PA34235	9462	RASAL2	chr1	178052864	178451649	398785	RAS protein activator like 2
PA164725297	64926	RASAL3	chr19	15559435	15585382	25947	RAS protein activator like 3
PA34236	51655	RASD1	chr17	17394751	17409709	14958	RAS, dexamethasone-induced 1
PA34237	23551	RASD2	chr22	35926556	35953048	26492	RASD family, member 2
PA134867201	158158	RASEF	chr9	85591500	85688043	96543	RAS and EF-hand domain containing
PA134884893	221002	RASGEF1A	chr10	43686983	43772367	85384	RasGEF domain family, member 1A
PA134927621	153020	RASGEF1B	chr4	82344547	82403082	58535	RasGEF domain family, member 1B
PA134895897	255426	RASGEF1C	chr5	179524795	179646130	121335	RasGEF domain family, member 1C
PA34238	5923	RASGRF1	chr15	79249289	79393215	143926	Ras protein-specific guanine nucleotide-releasing factor 1
PA34239	5924	RASGRF2	chr5	80246491	80528981	282490	Ras protein-specific guanine nucleotide-releasing factor 2
PA34240	10125	RASGRP1	chr15	38777302	38867661	90359	RAS guanyl releasing protein 1 (calcium and DAG-regulated)
PA34241	10235	RASGRP2	chr11	64491383	64522928	31545	RAS guanyl releasing protein 2 (calcium and DAG-regulated)
PA134937092	25780	RASGRP3	chr2	33651416	33792798	141382	RAS guanyl releasing protein 3 (calcium and DAG-regulated)
PA38770	115727	RASGRP4	chr19	38896695	38926945	30250	RAS guanyl releasing protein 4
PA134875519	54922	RASIP1	chr19	49220842	49254136	33294	Ras interacting protein 1
PA162400707	10633	RASL10A	chr22	29705922	29721745	15823	RAS-like, family 10, member A
PA134936888	91608	RASL10B	chr17	34048679	34073540	24861	RAS-like, family 10, member B
PA134906253	387496	RASL11A	chr13	27834464	27850828	16364	RAS-like, family 11, member A
PA134872992	65997	RASL11B	chr4	53718495	53736002	17507	RAS-like, family 11, member B
PA134920029	51285	RASL12	chr15	65334919	65370707	35788	RAS-like, family 12
PA34245	11186	RASSF1	chr3	50364217	50388367	24150	Ras association (RalGDS/AF-6) domain family member 1
PA162400718	644943	RASSF10	chr11	13020970	13036653	15683	Ras association (RalGDS/AF-6) domain family (N-terminal) member 10
PA34246	9770	RASSF2	chr20	4757669	4814291	56622	Ras association (RalGDS/AF-6) domain family member 2
PA34247	283349	RASSF3	chr12	64994293	65094347	100054	Ras association (RalGDS/AF-6) domain family member 3
PA134951366	83937	RASSF4	chr10	45445183	45494337	49154	Ras association (RalGDS/AF-6) domain family member 4
PA134958571	83593	RASSF5	chr1	206670866	206765616	94750	Ras association (RalGDS/AF-6) domain family member 5
PA134900075	166824	RASSF6	chr4	74434267	74496348	62081	Ras association (RalGDS/AF-6) domain family member 6
PA25480	8045	RASSF7	chr11	550309	567025	16716	Ras association (RalGDS/AF-6) domain family (N-terminal) member 7
PA25502	11228	RASSF8	chr12	26101964	26235825	133861	Ras association (RalGDS/AF-6) domain family (N-terminal) member 8
PA162400725	9182	RASSF9	chr12	86195331	86240318	44987	Ras association (RalGDS/AF-6) domain family (N-terminal) member 9
PA144596390	125950	RAVER1	chr19	10423888	10454314	30426	ribonucleoprotein, PTB-binding 1
PA144596391	55225	RAVER2	chr1	65200778	65301915	101137	ribonucleoprotein, PTB-binding 2
PA38626	30062	RAX	chr18	56931267	56950625	19358	retina and anterior neural fold homeobox
PA162400734	84839	RAX2	chr19	3766087	3782219	16132	retina and anterior neural fold homeobox 2
PA295	5925	RB1	chr13	48867883	49059026	191143	retinoblastoma 1
PA34248	9821	RB1CC1	chr8	53532018	53637026	105008	RB1-inducible coiled-coil 1
PA162400745	57786	RBAK	chr7	5075452	5112119	36667	RB-associated KRAB zinc finger
PA34251	5928	RBBP4	chr1	33106749	33154812	48063	retinoblastoma binding protein 4
PA34252	5929	RBBP5	chr1	205052270	205101150	48880	retinoblastoma binding protein 5
PA34253	5930	RBBP6	chr16	24540866	24587184	46318	retinoblastoma binding protein 6
PA34254	5931	RBBP7	chrX	16859773	16898565	38792	retinoblastoma binding protein 7
PA34255	5932	RBBP8	chr18	20503295	20609451	106156	retinoblastoma binding protein 8
PA25693	140893	RBBP8NL	chr20	60982293	61012629	30336	RBBP8 N-terminal like
PA34256	10741	RBBP9	chr20	18464184	18487899	23715	retinoblastoma binding protein 9
PA25723	10616	RBCK1	chr20	378696	414610	35914	RanBP-type and C3HC4-type zinc finger containing 1
PA134885774	79863	RBFA	chr18	77784346	77813652	29306	ribosome binding factor A (putative)
PA34272	23543	RBFOX2	chr22	36131783	36434679	302896	RNA binding protein, fox-1 homolog (C. elegans) 2
PA134951602	64080	RBKS	chr2	28001266	28123223	121957	ribokinase
PA34257	5933	RBL1	chr20	35621752	35734403	112651	retinoblastoma-like 1
PA34258	5934	RBL2	chr16	53458351	53528560	70209	retinoblastoma-like 2
PA34259	8241	RBM10	chrX	46994617	47049214	54597	RNA binding motif protein 10
PA34260	54033	RBM11	chr21	15578466	15603693	25227	RNA binding motif protein 11
PA34261	10137	RBM12	chr20	34233847	34262878	29031	RNA binding motif protein 12
PA142671098	389677	RBM12B	chr8	94739798	94763268	23470	RNA binding motif protein 12B
PA34263	10432	RBM14	chr11	66374053	66400405	26352	RNA binding motif protein 14
PA34264	64783	RBM15	chr1	110871945	110892303	20358	RNA binding motif protein 15
PA134870079	29890	RBM15B	chr3	51418699	51438339	19640	RNA binding motif protein 15B
PA134860993	84991	RBM17	chr10	6120949	6162422	41473	RNA binding motif protein 17
PA134928031	92400	RBM18	chr9	124998834	125037143	38309	RNA binding motif protein 18
PA134886784	9904	RBM19	chr12	114251543	114414176	162633	RNA binding motif protein 19
PA134934622	282996	RBM20	chr10	112394155	112602227	208072	RNA binding motif protein 20
PA134982384	55696	RBM22	chr5	150067352	150090669	23317	RNA binding motif protein 22
PA134974852	55147	RBM23	chr14	23366854	23398396	31542	RNA binding motif protein 23
PA134964569	221662	RBM24	chr6	17271739	17297102	25363	RNA binding motif protein 24
PA134912024	58517	RBM25	chr14	73515221	73591749	76528	RNA binding motif protein 25
PA134982324	64062	RBM26	chr13	79882962	79990393	107431	RNA binding motif protein 26
PA134925458	54439	RBM27	chr5	145573113	145671786	98673	RNA binding motif protein 27
PA134867266	55131	RBM28	chr7	127947429	127993962	46533	RNA binding motif protein 28
PA34265	5935	RBM3	chrX	48422741	48442553	19812	RNA binding motif (RNP1, RRM) protein 3
PA142671093	155435	RBM33	chr7	155427188	155577179	149991	RNA binding motif protein 33
PA142671094	23029	RBM34	chr1	235291498	235334571	43073	RNA binding motif protein 34
PA34449	55544	RBM38	chr20	55956454	55987389	30935	RNA binding motif protein 38
PA34450	9584	RBM39	chr20	34288531	34340258	51727	RNA binding motif protein 39
PA34266	5936	RBM4	chr11	66396088	66438856	42768	RNA binding motif protein 4
PA145148155	55285	RBM41	chrX	106302115	106372057	69942	RNA binding motif protein 41
PA162400760	79171	RBM42	chr19	36109980	36131587	21607	RNA binding motif protein 42
PA162400761	375287	RBM43	chr2	152101728	152128389	26661	RNA binding motif protein 43
PA162400774	375316	RBM44	chr2	238697032	238754451	57419	RNA binding motif protein 44
PA162400809	129831	RBM45	chr2	178967149	178997383	30234	RNA binding motif protein 45
PA162400810	166863	RBM46	chr4	155692424	155752965	60541	RNA binding motif protein 46
PA162400825	54502	RBM47	chr4	40422272	40642958	220686	RNA binding motif protein 47
PA164717383	84060	RBM48	chr7	92148079	92170319	22240	RNA binding motif protein 48
PA134977404	83759	RBM4B	chr11	66429469	66455348	25879	RNA binding motif protein 4B
PA34267	10181	RBM5	chr3	50116341	50159397	43056	RNA binding motif protein 5
PA34268	10180	RBM6	chr3	49967474	50117685	150211	RNA binding motif protein 6
PA34269	10179	RBM7	chr11	114261283	114282636	21353	RNA binding motif protein 7
PA34270	9939	RBM8A	chr1	145497557	145516536	18979	RNA binding motif protein 8A
PA34273	5937	RBMS1	chr2	161125662	161360366	234704	RNA binding motif, single stranded interacting protein 1
PA34275	5939	RBMS2	chr12	56905607	56997859	92252	RNA binding motif, single stranded interacting protein 2
PA34276	27303	RBMS3	chr3	29312351	30054886	742535	RNA binding motif, single stranded interacting protein 3
PA34277	27316	RBMX	chrX	135948353	135972939	24586	RNA binding motif protein, X-linked
PA134872051	51634	RBMX2	chrX	129525943	129550317	24374	RNA binding motif protein, X-linked 2
PA165752300	494115	RBMXL1	chr1	89442139	89468643	26504	RNA binding motif protein, X-linked-like 1
PA162400840	27288	RBMXL2	chr11	7100165	7115379	15214	RNA binding motif protein, X-linked-like 2
PA164725338	139804	RBMXL3	chrX	114413963	114430536	16573	RNA binding motif protein, X-linked-like 3
PA34279	5940	RBMY1A1	chrY	23686799	23714212	27413	RNA binding motif protein, Y-linked, family 1, member A1
PA134872137	378948	RBMY1B	chrY	23663224	23690672	27448	RNA binding motif protein, Y-linked, family 1, member B
PA134863616	378949	RBMY1D	chrY	24023223	24050633	27410	RNA binding motif protein, Y-linked, family 1, member D
PA134905273	378950	RBMY1E	chrY	24046765	24074174	27409	RNA binding motif protein, Y-linked, family 1, member E
PA134991920	159163	RBMY1F	chrY	24311689	24339089	27400	RNA binding motif protein, Y-linked, family 1, member F
PA134946298	378951	RBMY1J	chrY	24539623	24567028	27405	RNA binding motif protein, Y-linked, family 1, member J
PA34286	5947	RBP1	chr3	139233276	139268671	35395	retinol binding protein 1, cellular
PA34287	5948	RBP2	chr3	139168726	139209662	40936	retinol binding protein 2, cellular
PA34288	5949	RBP3	chr10	48378487	48400991	22504	retinol binding protein 3, interstitial
PA34289	5950	RBP4	chr10	95348593	95371101	22508	retinol binding protein 4, plasma
PA164742366	83758	RBP5	chr12	7273280	7291466	18186	retinol binding protein 5, cellular
PA134988307	116362	RBP7	chr1	10047255	10079078	31823	retinol binding protein 7, cellular
PA34292	3516	RBPJ	chr4	26155077	26439753	284676	recombination signal binding protein for immunoglobulin kappa J region
PA162400876	11317	RBPJL	chr20	43925483	43949464	23981	recombination signal binding protein for immunoglobulin kappa J region-like
PA134985584	11030	RBPMS	chr8	30232017	30432778	200761	RNA binding protein with multiple splicing
PA134871904	348093	RBPMS2	chr15	65029093	65077770	48677	RNA binding protein with multiple splicing 2
PA34299	9978	RBX1	chr22	41337351	41372019	34668	ring-box 1, E3 ubiquitin protein ligase
PA142671090	149041	RC3H1	chr1	173897352	173972210	74858	ring finger and CCCH-type domains 1
PA162400905	54542	RC3H2	chr9	125603835	125677562	73727	ring finger and CCCH-type domains 2
PA162400946	1827	RCAN1	chr21	35885782	35997382	111600	regulator of calcineurin 1
PA162400959	10231	RCAN2	chr6	46185467	46469804	284337	regulator of calcineurin 2
PA162400972	11123	RCAN3	chr1	24818841	24866510	47669	RCAN family member 3
PA134955699	55213	RCBTB1	chr13	50103082	50169742	66660	regulator of chromosome condensation (RCC1) and BTB (POZ) domain containing protein 1
PA26450	1102	RCBTB2	chr13	49060099	49117341	57242	regulator of chromosome condensation (RCC1) and BTB (POZ) domain containing protein 2
PA26449	1104	RCC1	chr1	28822455	28868708	46253	regulator of chromosome condensation 1
PA142671091	55920	RCC2	chr1	17730251	17776250	45999	regulator of chromosome condensation 2
PA142671092	91433	RCCD1	chr15	91488106	91509355	21249	RCC1 domain containing 1
PA34302	9986	RCE1	chr11	66600883	66617003	16120	Ras converting CAAX endopeptidase 1
PA38240	25898	RCHY1	chr4	76401247	76449884	48637	ring finger and CHY zinc finger domain containing 1, E3 ubiquitin protein ligase
PA134894364	10171	RCL1	chr9	4782834	4864066	81232	RNA terminal phosphate cyclase-like 1
PA34303	5954	RCN1	chr11	32102477	32130272	27795	reticulocalbin 1, EF-hand calcium binding domain
PA34304	5955	RCN2	chr15	77213962	77245601	31639	reticulocalbin 2, EF-hand calcium binding domain
PA134880380	57333	RCN3	chr19	50020875	50049891	29016	reticulocalbin 3, EF-hand calcium binding domain
PA34305	23186	RCOR1	chr14	103048996	103199913	150917	REST corepressor 1
PA134876257	283248	RCOR2	chr11	63675693	63694407	18714	REST corepressor 2
PA134917623	55758	RCOR3	chr1	211422708	211492727	70019	REST corepressor 3
PA142671088	92241	RCSD1	chr1	167589474	167680933	91459	RCSD domain containing 1
PA162400987	5957	RCVRN	chr17	9798027	9818684	20657	recoverin
PA162400998	343035	RD3	chr1	211646864	211676259	29395	retinal degeneration 3
PA134989620	157506	RDH10	chr8	74196837	74240520	43683	retinol dehydrogenase 10 (all-trans)
PA134981588	51109	RDH11	chr14	68140517	68172510	31993	retinol dehydrogenase 11 (all-trans/9-cis/11-cis)
PA134864793	145226	RDH12	chr14	68158603	68204168	45565	retinol dehydrogenase 12 (all-trans/9-cis/11-cis)
PA134897935	112724	RDH13	chr19	55552684	55590914	38230	retinol dehydrogenase 13 (all-trans/9-cis)
PA134872714	57665	RDH14	chr2	18732989	18751959	18970	retinol dehydrogenase 14 (all-trans/9-cis/11-cis)
PA142671089	8608	RDH16	chr12	57342215	57363158	20943	retinol dehydrogenase 16 (all-trans)
PA34308	5959	RDH5	chr12	56104151	56121526	17375	retinol dehydrogenase 5 (11-cis/9-cis)
PA34309	50700	RDH8	chr19	10113925	10135954	22029	retinol dehydrogenase 8 (all-trans)
PA134932526	201299	RDM1	chr17	34242084	34267780	25696	RAD52 motif containing 1
PA34311	5962	RDX	chr11	110042605	110177437	134832	radixin
PA162378269	283677	REC114	chr15	73725499	73855354	129855	REC114 meiotic recombination protein
PA162401009	9985	REC8	chr14	24631062	24652735	21673	REC8 meiotic recombination protein
PA34314	8434	RECK	chr9	36026910	36127452	100542	reversion-inducing-cysteine-rich protein with kazal motifs
PA34315	5965	RECQL	chr12	21618844	21664603	45759	RecQ helicase-like
PA34316	9401	RECQL4	chr8	145733667	145753210	19543	RecQ protein-like 4
PA34317	9400	RECQL5	chr17	73619925	73673270	53345	RecQ protein-like 5
PA134906680	65055	REEP1	chr2	86438116	86575206	137090	receptor accessory protein 1
PA134920985	51308	REEP2	chr5	137764690	137785658	20968	receptor accessory protein 2
PA134863406	221035	REEP3	chr10	65271113	65387883	116770	receptor accessory protein 3
PA134890554	80346	REEP4	chr8	21992533	22009448	16915	receptor accessory protein 4
PA134882361	7905	REEP5	chr5	112209081	112268339	59258	receptor accessory protein 5
PA134892881	92840	REEP6	chr19	1481165	1500924	19759	receptor accessory protein 6
PA34318	5967	REG1A	chr2	79337584	79353545	15961	regenerating islet-derived 1 alpha
PA34319	5968	REG1B	chr2	79309149	79325150	16001	regenerating islet-derived 1 beta
PA34320	5969	REG1P	chr2	79359629	79375553	15924	regenerating islet-derived 1 pseudogene
PA32931	5068	REG3A	chr2	79381132	79396880	15748	regenerating islet-derived 3 alpha
PA142671087	130120	REG3G	chr2	79242812	79258630	15818	regenerating islet-derived 3 gamma
PA134888932	83998	REG4	chr1	120333641	120364203	30562	regenerating islet-derived family, member 4
PA34321	5966	REL	chr2	61098709	61174410	75701	v-rel avian reticuloendotheliosis viral oncogene homolog
PA296	5970	RELA	chr11	65418067	65440443	22376	v-rel avian reticuloendotheliosis viral oncogene homolog A
PA34322	5971	RELB	chr19	45494707	45544456	49749	v-rel avian reticuloendotheliosis viral oncogene homolog B
PA162401054	768211	RELL1	chr4	37589422	37697999	108577	RELT-like 1
PA162401073	285613	RELL2	chr5	141006517	141023918	17401	RELT-like 2
PA34323	5649	RELN	chr7	103109231	103639963	530732	reelin
PA162401092	84957	RELT	chr11	73077405	73111519	34114	RELT tumor necrosis factor receptor
PA34324	28954	REM1	chr20	30053091	30075708	22617	RAS (RAD and GEM)-like GTP-binding 1
PA134916581	161253	REM2	chr14	23342374	23359889	17515	RAS (RAD and GEM)-like GTP binding 2
PA297	5972	REN	chr1	204120944	204145465	24521	renin
PA34325	5973	RENBP	chrX	153197722	153220232	22510	renin binding protein
PA165513308	387849	REP15	chr12	27839428	27853566	14138	RAB15 effector protein
PA134933473	29803	REPIN1	chr7	150055361	150074133	18772	replication initiator 1
PA34329	85021	REPS1	chr6	139222620	139319419	96799	RALBP1 associated Eps domain containing 1
PA34330	9185	REPS2	chrX	16954814	17174403	219589	RALBP1 associated Eps domain containing 2
PA134901074	11079	RER1	chr1	2313214	2339883	26669	retention in endoplasmic reticulum sorting receptor 1
PA34332	473	RERE	chr1	8409464	8887699	478235	arginine-glutamic acid dipeptide (RE) repeats
PA34333	85004	RERG	chr12	15257716	15384411	126695	RAS-like, estrogen-regulated, growth inhibitor
PA162401119	79785	RERGL	chr12	18230803	18253139	22336	RERG/RAS-like
PA34334	5978	REST	chr4	57764042	57805010	40968	RE1-silencing transcription factor
PA34335	5979	RET	chr10	43562517	43628799	66282	ret proto-oncogene
PA422	56729	RETN	chr19	7723972	7738340	14368	resistin
PA134906814	84666	RETNLB	chr3	108471486	108486130	14644	resistin like beta
PA145007867	54884	RETSAT	chr2	85566078	85591821	25743	retinol saturase (all-trans-retinol 13,14-reductase)
PA162401120	51455	REV1	chr2	100013938	100116480	102542	REV1, polymerase (DNA directed)
PA34337	5980	REV3L	chr6	111617234	111814421	197187	REV3-like, polymerase (DNA directed), zeta, catalytic subunit
PA142671077	57455	REXO1	chr19	1812245	1858520	46275	REX1, RNA exonuclease 1 homolog (S. cerevisiae)
PA142671078	254958	REXO1L1	chr8	86565533	86585726	20193	REX1, RNA exonuclease 1 homolog (S. cerevisiae)-like 1
PA142671085	25996	REXO2	chr11	114300108	114324001	23893	RNA exonuclease 2
PA37414	57109	REXO4	chr9	136268182	136293292	25110	REX4, RNA exonuclease 4 homolog (S. cerevisiae)
PA34338	5981	RFC1	chr4	39286069	39378001	91932	replication factor C (activator 1) 1, 145kDa
PA34339	5982	RFC2	chr7	73642832	73678788	35956	replication factor C (activator 1) 2, 40kDa
PA34340	5983	RFC3	chr13	34382206	34543695	161489	replication factor C (activator 1) 3, 38kDa
PA34341	5984	RFC4	chr3	186504681	186534484	29803	replication factor C (activator 1) 4, 37kDa
PA34342	5985	RFC5	chr12	118444506	118473044	28538	replication factor C (activator 1) 5, 36.5kDa
PA162401171	317671	RFESD	chr5	94972471	94995849	23378	Rieske (Fe-S) domain containing
PA142671086	117584	RFFL	chr17	33333131	33426348	93217	ring finger and FYVE-like domain containing E3 ubiquitin protein ligase
PA134916697	55312	RFK	chr9	78997433	79019444	22011	riboflavin kinase
PA34343	5986	RFNG	chr17	80002778	80019650	16872	RFNG O-fucosylpeptide 3-beta-N-acetylglucosaminyltransferase
PA34346	5988	RFPL1	chr22	29824572	29841444	16872	ret finger protein-like 1
PA34348	10739	RFPL2	chr22	32583422	32613223	29801	ret finger protein-like 2
PA34349	10738	RFPL3	chr22	32740872	32760148	19276	ret finger protein-like 3
PA162401186	342931	RFPL4A	chr19	56260507	56277541	17034	ret finger protein-like 4A
PA162401195	442247	RFPL4B	chr6	112658532	112675498	16966	ret finger protein-like 4B
PA134960002	91869	RFT1	chr3	53119499	53174480	54981	RFT1 homolog (S. cerevisiae)
PA162401206	23180	RFTN1	chr3	16354352	16565222	210870	raftlin, lipid raft linker 1
PA162401231	130132	RFTN2	chr2	198432524	198550774	118250	raftlin family member 2
PA134952161	64326	RFWD2	chr1	175910967	176186386	275419	ring finger and WD repeat domain 2, E3 ubiquitin protein ligase
PA134960063	55159	RFWD3	chr16	74652297	74710779	58482	ring finger and WD repeat domain 3
PA34352	5989	RFX1	chr19	14069342	14127134	57792	regulatory factor X, 1 (influences HLA class II expression)
PA34353	5990	RFX2	chr19	5990175	6120664	130489	regulatory factor X, 2 (influences HLA class II expression)
PA34354	5991	RFX3	chr9	3215297	3535992	320695	regulatory factor X, 3 (influences HLA class II expression)
PA34355	5992	RFX4	chr12	106966685	107159582	192897	regulatory factor X, 4 (influences HLA class II expression)
PA34356	5993	RFX5	chr1	151310116	151329785	19669	regulatory factor X, 5 (influences HLA class II expression)
PA162401254	222546	RFX6	chr6	117188376	117256326	67950	regulatory factor X, 6
PA162401255	64864	RFX7	chr15	56376479	56545728	169249	regulatory factor X, 7
PA165697419	731220	RFX8	chr2	102010823	102101165	90342	RFX family member 8, lacking RFX DNA binding domain
PA34357	8625	RFXANK	chr19	19293008	19315678	22670	regulatory factor X-associated ankyrin-containing protein
PA34358	5994	RFXAP	chr13	37383339	37406740	23401	regulatory factor X-associated protein
PA134934891	57529	RGAG1	chrX	109592044	109702562	110518	retrotransposon gag domain containing 1
PA134992098	340526	RGAG4	chrX	71343960	71361751	17791	retrotransposon gag domain containing 4
PA134895181	28984	RGCC	chr13	42021542	42048013	26471	regulator of cell cycle
PA134934636	23179	RGL1	chr1	183595208	183900666	305458	ral guanine nucleotide dissociation stimulator-like 1
PA34120	5863	RGL2	chr6	33256431	33277386	20955	ral guanine nucleotide dissociation stimulator-like 2
PA134979213	57139	RGL3	chr19	11501732	11540018	38286	ral guanine nucleotide dissociation stimulator-like 3
PA162401277	266747	RGL4	chr22	24023048	24044444	21396	ral guanine nucleotide dissociation stimulator-like 4
PA128394693	56963	RGMA	chr15	93583636	93642443	58807	repulsive guidance molecule family member a
PA134868641	285704	RGMB	chr5	98094999	98135198	40199	repulsive guidance molecule family member b
PA34359	9104	RGN	chrX	46927775	46955712	27937	regucalcin
PA162401278	9827	RGP1	chr9	35739277	35756264	16987	RGP1 retrograde golgi transport homolog (S. cerevisiae)
PA142671070	400966	RGPD1	chr2	87130890	87244099	113209	RANBP2-like and GRIP domain containing 1
PA142671071	729857	RGPD2	chr2	88053717	88135331	81614	RANBP2-like and GRIP domain containing 2
PA142671072	653489	RGPD3	chr2	107018136	107094801	76665	RANBP2-like and GRIP domain containing 3
PA142671073	285190	RGPD4	chr2	108433388	108512000	78612	RANBP2-like and GRIP domain containing 4
PA142671074	84220	RGPD5	chr2	110540335	110618268	77933	RANBP2-like and GRIP domain containing 5
PA142671075	729540	RGPD6	chr2	111268379	111346309	77930	RANBP2-like and GRIP domain containing 6
PA34210	727851	RGPD8	chr2	113122946	113201222	78276	RANBP2-like and GRIP domain containing 8
PA34360	5995	RGR	chr10	85994809	86021944	27135	retinal G protein coupled receptor
PA34361	5996	RGS1	chr1	192534857	192552159	17302	regulator of G-protein signaling 1
PA34362	6001	RGS10	chr10	121256339	121312222	55883	regulator of G-protein signaling 10
PA34363	8786	RGS11	chr16	315300	335941	20641	regulator of G-protein signaling 11
PA34364	6002	RGS12	chr4	3305874	3444640	138766	regulator of G-protein signaling 12
PA34365	6003	RGS13	chr1	192595268	192632441	37173	regulator of G-protein signaling 13
PA34366	10636	RGS14	chr5	176774704	176802599	27895	regulator of G-protein signaling 14
PA34367	6004	RGS16	chr1	182564758	182583548	18790	regulator of G-protein signaling 16
PA34368	26575	RGS17	chr6	153329026	153462389	133363	regulator of G-protein signaling 17
PA34369	64407	RGS18	chr1	192117592	192157945	40353	regulator of G-protein signaling 18
PA34370	10287	RGS19	chr20	62701534	62721356	19822	regulator of G-protein signaling 19
PA34372	5997	RGS2	chr1	192768169	192784407	16238	regulator of G-protein signaling 2
PA34373	8601	RGS20	chr8	54754368	54874863	120495	regulator of G-protein signaling 20
PA134875582	431704	RGS21	chr1	192276122	192339415	63293	regulator of G-protein signaling 21
PA142671068	26166	RGS22	chr8	100970164	101128344	158180	regulator of G-protein signaling 22
PA34374	5998	RGS3	chr9	116197009	116363023	166014	regulator of G-protein signaling 3
PA34375	5999	RGS4	chr1	163028396	163049592	21196	regulator of G-protein signaling 4
PA34376	8490	RGS5	chr1	163109089	163301581	192492	regulator of G-protein signaling 5
PA34377	9628	RGS6	chr14	72388817	73036238	647421	regulator of G-protein signaling 6
PA34378	6000	RGS7	chr1	240935817	241530505	594688	regulator of G-protein signaling 7
PA162401279	401190	RGS7BP	chr5	63791774	63912285	120511	regulator of G-protein signaling 7 binding protein
PA34379	85397	RGS8	chr1	182610036	182663502	53466	regulator of G-protein signaling 8
PA34380	8787	RGS9	chr17	63123456	63226821	103365	regulator of G-protein signaling 9
PA162401280	388531	RGS9BP	chr19	33156313	33172206	15893	regulator of G protein signaling 9 binding protein
PA134870196	353299	RGSL1	chr1	182409256	182532732	123476	regulator of G-protein signaling like 1
PA34381	6005	RHAG	chr6	49569888	49614587	44699	Rh-associated glycoprotein
PA143485593	84236	RHBDD1	chr2	227690652	227866926	176274	rhomboid domain containing 1
PA134864375	57414	RHBDD2	chr7	75498317	75521244	22927	rhomboid domain containing 2
PA25887	25807	RHBDD3	chr22	29652844	29674147	21303	rhomboid domain containing 3
PA25563	64285	RHBDF1	chr16	105058	136354	31296	rhomboid 5 homolog 1 (Drosophila)
PA134980674	79651	RHBDF2	chr17	74463975	74507509	43534	rhomboid 5 homolog 2 (Drosophila)
PA34382	9028	RHBDL1	chr16	715666	731268	15602	rhomboid, veinlet-like 1 (Drosophila)
PA34383	54933	RHBDL2	chr1	39347614	39417456	69842	rhomboid, veinlet-like 2 (Drosophila)
PA34384	162494	RHBDL3	chr17	30583195	30654680	71485	rhomboid, veinlet-like 3 (Drosophila)
PA34385	57127	RHBG	chr1	156328980	156358013	29033	Rh family, B glycoprotein (gene/pseudogene)
PA34386	6006	RHCE	chr1	25684853	25757363	72510	Rh blood group, CcEe antigens
PA134876043	51458	RHCG	chr15	90011638	90049799	38161	Rh family, C glycoprotein
PA34387	6007	RHD	chr1	25588884	25659936	71052	Rh blood group, D antigen
PA34389	6009	RHEB	chr7	151160098	151227010	66912	Ras homolog enriched in brain
PA134984759	121268	RHEBL1	chr12	49455467	49473808	18341	Ras homolog enriched in brain like 1
PA34390	6010	RHO	chr3	129237482	129257187	19705	rhodopsin
PA134865095	387	RHOA	chr3	49393569	49459526	65957	ras homolog family member A
PA24950	388	RHOB	chr2	20636835	20652201	15366	ras homolog family member B
PA38664	9886	RHOBTB1	chr10	62626196	62771198	145002	Rho-related BTB domain containing 1
PA38678	23221	RHOBTB2	chr8	22834930	22880710	45780	Rho-related BTB domain containing 2
PA38679	22836	RHOBTB3	chr5	95039181	95135071	95890	Rho-related BTB domain containing 3
PA24951	389	RHOC	chr1	113240749	113260025	19276	ras homolog family member C
PA24952	29984	RHOD	chr11	66814289	66842488	28199	ras homolog family member D
PA24954	54509	RHOF	chr12	122212660	122241594	28934	ras homolog family member F (in filopodia)
PA24955	391	RHOG	chr11	3845208	3872213	27005	ras homolog family member G
PA24979	399	RHOH	chr4	40182631	40249384	66753	ras homolog family member H
PA24981	57381	RHOJ	chr14	63661080	63763230	102150	ras homolog family member J
PA134904280	23433	RHOQ	chr2	46759867	46814827	54960	ras homolog family member Q
PA134906318	55288	RHOT1	chr17	30459473	30555746	96273	ras homolog family member T1
PA134889674	89941	RHOT2	chr16	708083	727174	19091	ras homolog family member T2
PA38246	58480	RHOU	chr1	228770394	228885416	115022	ras homolog family member U
PA38313	171177	RHOV	chr15	41161412	41176487	15075	ras homolog family member V
PA162401287	158800	RHOXF1	chrX	119240011	119259847	19836	Rhox homeobox family, member 1
PA162401288	84528	RHOXF2	chrX	119282432	119300933	18501	Rhox homeobox family, member 2
PA162401289	727940	RHOXF2B	chrX	119203229	119221707	18478	Rhox homeobox family, member 2B
PA134987144	114822	RHPN1	chr8	144441025	144469390	28365	rhophilin, Rho GTPase binding protein 1
PA134979284	85415	RHPN2	chr19	33466498	33565824	99326	rhophilin, Rho GTPase binding protein 2
PA134903330	158787	RIBC1	chrX	53439727	53461063	21336	RIB43A domain with coiled-coils 1
PA134967342	26150	RIBC2	chr22	45799572	45831302	31730	RIB43A domain with coiled-coils 2
PA134884486	57589	RIC1	chr9	5619119	5779557	160438	RAB6A GEF complex partner 1
PA142671066	79608	RIC3	chr11	8124597	8200590	75993	RIC3 acetylcholine receptor chaperone
PA142671067	60626	RIC8A	chr11	197499	218113	20614	RIC8 guanine nucleotide exchange factor A
PA142671064	55188	RIC8B	chr12	107158077	107286094	128017	RIC8 guanine nucleotide exchange factor B
PA165660455	253260	RICTOR	chr5	38935022	39084505	149483	RPTOR independent companion of MTOR, complex 2
PA134933858	55183	RIF1	chr2	152256397	152336860	80463	replication timing regulatory factor 1
PA165750490	284485	RIIAD1	chr1	151684013	151705082	21069	regulatory subunit of type II PKA R-subunit (RIIa) domain containing 1
PA134915969	83547	RILP	chr17	1546444	1563392	16948	Rab interacting lysosomal protein
PA162401302	353116	RILPL1	chr12	123952909	124028265	75356	Rab interacting lysosomal protein-like 1
PA162401325	196383	RILPL2	chr12	123896936	123931264	34328	Rab interacting lysosomal protein-like 2
PA143485594	23504	RIMBP2	chr12	130877681	131210828	333147	RIMS binding protein 2
PA162401326	85376	RIMBP3	chr22	20452991	20471786	18795	RIMS binding protein 3
PA162401333	440804	RIMBP3B	chr22	21728040	21746458	18418	RIMS binding protein 3B
PA162401340	150221	RIMBP3C	chr22	21896955	21915750	18795	RIMS binding protein 3C
PA164725339	284716	RIMKLA	chr1	42836468	42892900	56432	ribosomal modification protein rimK-like family member A
PA164725354	57494	RIMKLB	chr12	8824273	8938688	114415	ribosomal modification protein rimK-like family member B
PA38220	22999	RIMS1	chr6	72586406	73115845	529439	regulating synaptic membrane exocytosis 1
PA38445	9699	RIMS2	chr8	104502426	105269656	767230	regulating synaptic membrane exocytosis 2
PA134980870	9783	RIMS3	chr1	41083352	41141324	57972	regulating synaptic membrane exocytosis 3
PA25733	140730	RIMS4	chr20	43377445	43448979	71534	regulating synaptic membrane exocytosis 4
PA38671	9610	RIN1	chr11	66096535	66114000	17465	Ras and Rab interactor 1
PA38672	54453	RIN2	chr20	19728254	19986103	257849	Ras and Rab interactor 2
PA38673	79890	RIN3	chr14	92970125	93158339	188214	Ras and Rab interactor 3
PA34393	6015	RING1	chr6	33166286	33183499	17213	ring finger protein 1
PA162401347	126432	RINL	chr19	39355470	39378919	23449	Ras and Rab interactor-like
PA143485595	60561	RINT1	chr7	105162532	105211131	48599	RAD50 interactor 1
PA134928236	83732	RIOK1	chr6	7380062	7421270	41208	RIO kinase 1
PA134885533	55781	RIOK2	chr5	96493571	96529005	35434	RIO kinase 2
PA36248	8780	RIOK3	chr18	21022787	21066104	43317	RIO kinase 3
PA34394	8737	RIPK1	chr6	3054201	3118421	64220	receptor (TNFRSF)-interacting serine-threonine kinase 1
PA34395	8767	RIPK2	chr8	90759335	90806292	46957	receptor-interacting serine-threonine kinase 2
PA34396	11035	RIPK3	chr14	24802227	24819242	17015	receptor-interacting serine-threonine kinase 3
PA24805	54101	RIPK4	chr21	43156529	43197249	40720	receptor-interacting serine-threonine kinase 4
PA162401348	92129	RIPPLY1	chrX	106140293	106156561	16268	ripply transcriptional repressor 1
PA162401349	134701	RIPPLY2	chr6	84552985	84570234	17249	ripply transcriptional repressor 2
PA27499	53820	RIPPLY3	chr21	38368456	38394959	26503	ripply transcriptional repressor 3
PA35528	6016	RIT1	chr1	155864599	155891193	26594	Ras-like without CAAX 1
PA35527	6014	RIT2	chr18	40320183	40705676	385493	Ras-like without CAAX 2
PA143485381	84934	RITA1	chr12	113613555	113633119	19564	RBPJ interacting and tubulin associated 1
PA34397	6017	RLBP1	chr15	89750098	89774922	24824	retinaldehyde binding protein 1
PA34398	6018	RLF	chr1	40617041	40709593	92552	rearranged L-myc fusion
PA164725373	51132	RLIM	chrX	73799811	73844461	44650	ring finger protein, LIM domain interacting
PA34399	6013	RLN1	chr9	5304637	5349873	45236	relaxin 1
PA34400	6019	RLN2	chr9	5296864	5314611	17747	relaxin 2
PA34401	117579	RLN3	chr19	14129017	14144783	15766	relaxin 3
PA162401371	146206	RLTPR	chr16	67669030	67694472	25442	RGD motif, leucine rich repeats, tropomodulin domain and proline-rich containing
PA142671849	51115	RMDN1	chr8	87476627	87536567	59940	regulator of microtubule dynamics 1
PA162387925	151393	RMDN2	chr2	38142462	38297285	154823	regulator of microtubule dynamics 2
PA162387926	55177	RMDN3	chr15	41025085	41057458	32373	regulator of microtubule dynamics 3
PA134939007	80010	RMI1	chr9	86585321	86621989	36668	RecQ mediated genome instability 1
PA145149635	116028	RMI2	chr16	11429311	11448617	19306	RecQ mediated genome instability 2
PA162401372	55005	RMND1	chr6	151722897	151783316	60419	required for meiotic nuclear division 1 homolog (S. cerevisiae)
PA144596388	64795	RMND5A	chr2	86937414	87008164	70750	required for meiotic nuclear division 5 homolog A (S. cerevisiae)
PA144596389	64777	RMND5B	chr5	177548002	177578567	30565	required for meiotic nuclear division 5 homolog B (S. cerevisiae)
PA34412	6035	RNASE1	chr14	21266515	21281036	14521	ribonuclease, RNase A family, 1 (pancreatic)
PA134878150	338879	RNASE10	chr14	20963696	20982314	18618	ribonuclease, RNase A family, 10 (non-active)
PA134929509	122651	RNASE11	chr14	21048051	21088037	39986	ribonuclease, RNase A family, 11 (non-active)
PA134948996	493901	RNASE12	chr14	21055239	21069532	14293	ribonuclease, RNase A family, 12 (non-active)
PA134922548	440163	RNASE13	chr14	21497979	21512944	14965	ribonuclease, RNase A family, 13 (non-active)
PA34413	6036	RNASE2	chr14	21413630	21427594	13964	ribonuclease, RNase A family, 2 (liver, eosinophil-derived neurotoxin)
PA34414	6037	RNASE3	chr14	21349562	21363507	13945	ribonuclease, RNase A family, 3
PA34415	6038	RNASE4	chr14	21142259	21171761	29502	ribonuclease, RNase A family, 4
PA34416	6039	RNASE6	chr14	21239210	21253626	14416	ribonuclease, RNase A family, k6
PA134939592	84659	RNASE7	chr14	21500385	21515393	15008	ribonuclease, RNase A family, 7
PA134930162	122665	RNASE8	chr14	21516052	21529516	13464	ribonuclease, RNase A family, 8
PA134887351	390443	RNASE9	chr14	21021252	21039125	17873	ribonuclease, RNase A family, 9 (non-active)
PA38543	246243	RNASEH1	chr2	3589675	3615957	26282	ribonuclease H1
PA38565	10535	RNASEH2A	chr19	12902863	12927462	24599	ribonuclease H2, subunit A
PA162401418	79621	RNASEH2B	chr13	51473814	51547596	73782	ribonuclease H2, subunit B
PA162401445	84153	RNASEH2C	chr11	65482144	65498409	16265	ribonuclease H2, subunit C
PA162401458	440400	RNASEK	chr17	6905736	6920852	15116	ribonuclease, RNase K
PA34418	6041	RNASEL	chr1	182539769	182568420	28651	ribonuclease L (2',5'-oligoisoadenylate synthetase-dependent)
PA128394541	8635	RNASET2	chr6	167339992	167380077	40085	ribonuclease T2
PA134972408	27289	RND1	chr12	49247916	49269653	21737	Rho family GTPase 1
PA134936989	8153	RND2	chr17	41167258	41187058	19800	Rho family GTPase 2
PA24953	390	RND3	chr2	151321707	151354209	32502	Rho family GTPase 3
PA34419	9921	RNF10	chr12	120962132	121018397	56265	ring finger protein 10
PA37448	7844	RNF103	chr2	86827516	86861000	33484	ring finger protein 103
PA34420	26994	RNF11	chr1	51691945	51742119	50174	ring finger protein 11
PA134868772	54778	RNF111	chr15	59269865	59392618	122753	ring finger protein 111
PA162401469	7732	RNF112	chr17	19304491	19323589	19098	ring finger protein 112
PA37556	7737	RNF113A	chrX	119001495	119015791	14296	ring finger protein 113A
PA38217	140432	RNF113B	chr13	98825039	98839521	14482	ring finger protein 113B
PA162401502	55905	RNF114	chr20	48542914	48573422	30508	ring finger protein 114
PA162401519	27246	RNF115	chr1	145600990	145692005	91015	ring finger protein 115
PA134985388	55298	RNF121	chr11	71629768	71711643	81875	ring finger protein 121
PA134892945	79845	RNF122	chr8	33402272	33434646	32374	ring finger protein 122
PA134916827	63891	RNF123	chr3	49716950	49761962	45012	ring finger protein 123
PA134950383	54941	RNF125	chr18	29588445	29656154	67709	ring finger protein 125, E3 ubiquitin protein ligase
PA134876469	55658	RNF126	chr19	644526	673313	28787	ring finger protein 126
PA134868457	79589	RNF128	chrX	105927068	106043246	116178	ring finger protein 128, E3 ubiquitin protein ligase
PA34422	11342	RNF13	chr3	149520475	149682926	162451	ring finger protein 13
PA134871556	55819	RNF130	chr5	179379067	179509118	130051	ring finger protein 130
PA134991267	168433	RNF133	chr7	122334766	122349208	14442	ring finger protein 133
PA134978537	84282	RNF135	chr17	29286224	29329929	43705	ring finger protein 135
PA134952071	51444	RNF138	chr18	29661818	29714524	52706	ring finger protein 138, E3 ubiquitin protein ligase
PA134945850	11236	RNF139	chr8	125477008	125503859	26851	ring finger protein 139
PA34423	9604	RNF14	chr5	141336402	141372856	36454	ring finger protein 14
PA134981805	50862	RNF141	chr11	10530225	10572774	42549	ring finger protein 141
PA162401542	9781	RNF144A	chr2	7047523	7212011	164488	ring finger protein 144A
PA162401565	255488	RNF144B	chr6	18267602	18472105	204503	ring finger protein 144B
PA134876286	153830	RNF145	chr5	158581417	158647061	65644	ring finger protein 145
PA134910489	81847	RNF146	chr6	127577827	127612707	34880	ring finger protein 146
PA134918676	378925	RNF148	chr7	122338720	122353021	14301	ring finger protein 148
PA134895641	284996	RNF149	chr2	101884681	101935178	50497	ring finger protein 149
PA134918555	57484	RNF150	chr4	141783708	142064630	280922	ring finger protein 150
PA134992556	146310	RNF151	chr16	2006843	2021976	15133	ring finger protein 151
PA134984811	220441	RNF152	chr18	59472300	59571634	99334	ring finger protein 152
PA134974884	114804	RNF157	chr17	74135534	74246448	110914	ring finger protein 157
PA134972127	494470	RNF165	chr18	43896772	44044159	147387	ring finger protein 165
PA134915234	115992	RNF166	chr16	88759903	88782829	22926	ring finger protein 166
PA134953711	26001	RNF167	chr17	4833328	4851517	18189	ring finger protein 167
PA134945219	165918	RNF168	chr3	196192654	196240639	47985	ring finger protein 168, E3 ubiquitin protein ligase
PA142671054	254225	RNF169	chr11	74449913	74556458	106545	ring finger protein 169
PA34424	56163	RNF17	chr13	25328301	25457059	128758	ring finger protein 17
PA134922560	81790	RNF170	chr8	42701780	42761866	60086	ring finger protein 170
PA134909663	285533	RNF175	chr4	154628312	154691387	63075	ring finger protein 175
PA134980027	285671	RNF180	chr5	63451671	63671704	220033	ring finger protein 180
PA162401586	51255	RNF181	chr2	85812391	85827831	15440	ring finger protein 181
PA134975171	221687	RNF182	chr6	13914677	13983240	68563	ring finger protein 182
PA142671055	138065	RNF183	chr9	116056373	116075554	19181	ring finger protein 183
PA142671056	91445	RNF185	chr22	31546138	31606005	59867	ring finger protein 185
PA142671057	54546	RNF186	chr1	20137522	20151771	14249	ring finger protein 186
PA142671058	149603	RNF187	chr1	228664277	228700598	36321	ring finger protein 187
PA162401601	25897	RNF19A	chr8	101266285	101358446	92161	ring finger protein 19A, RBR E3 ubiquitin protein ligase
PA162401626	127544	RNF19B	chr1	33399050	33440467	41417	ring finger protein 19B
PA34426	6045	RNF2	chr1	185004482	185074740	70258	ring finger protein 2
PA34427	56254	RNF20	chr9	104286131	104328626	42495	ring finger protein 20, E3 ubiquitin protein ligase
PA145148144	388591	RNF207	chr1	6256189	6284359	28170	ring finger protein 207
PA162401649	727800	RNF208	chr9	140111699	140125775	14076	ring finger protein 208
PA162401656	285498	RNF212	chr4	1047039	1117352	70313	ring finger protein 212
PA134863571	100507650	RNF212B	chr14	-1	-1	0	ring finger protein 212B
PA162401681	57674	RNF213	chr17	78224643	78375586	150943	ring finger protein 213
PA162401772	257160	RNF214	chr11	117093341	117159404	66063	ring finger protein 214
PA162401807	200312	RNF215	chr22	30771801	30793302	21501	ring finger protein 215
PA162401829	54476	RNF216	chr7	5656672	5831361	174689	ring finger protein 216
PA162401868	154214	RNF217	chr6	125273680	125416779	143099	ring finger protein 217
PA162401869	79596	RNF219	chr13	79185421	79243314	57893	ring finger protein 219
PA162401886	55182	RNF220	chr1	44860837	45120396	259559	ring finger protein 220
PA164725453	643904	RNF222	chr17	8291022	8311144	20122	ring finger protein 222
PA34428	11237	RNF24	chr20	3909068	4006216	97148	ring finger protein 24
PA34429	64320	RNF25	chr2	219525587	219546781	21194	ring finger protein 25
PA34430	79102	RNF26	chr11	119195210	119211024	15814	ring finger protein 26
PA134906471	55072	RNF31	chr14	24606101	24632870	26769	ring finger protein 31
PA34435	140545	RNF32	chr7	156422971	156473377	50406	ring finger protein 32
PA34436	80196	RNF34	chr12	121827886	121865155	37269	ring finger protein 34, E3 ubiquitin protein ligase
PA34438	152006	RNF38	chr9	36333395	36497568	164173	ring finger protein 38
PA134949953	80352	RNF39	chr6	30035043	30053628	18585	ring finger protein 39
PA34439	6047	RNF4	chr4	2460795	2520586	59791	ring finger protein 4
PA34440	9810	RNF40	chr16	30762933	30790628	27695	ring finger protein 40, E3 ubiquitin protein ligase
PA134875033	10193	RNF41	chr12	56593288	56625753	32465	ring finger protein 41, E3 ubiquitin protein ligase
PA34441	54894	RNF43	chr17	56428037	56504931	76894	ring finger protein 43
PA38819	22838	RNF44	chr5	175950700	175975026	24326	ring finger protein 44
PA34442	6048	RNF5	chr6	32136162	32151570	15408	ring finger protein 5, E3 ubiquitin protein ligase
PA34443	6049	RNF6	chr13	26783894	26806686	22792	ring finger protein (C3H2C3 type) 6
PA34444	9616	RNF7	chr3	141447051	141468645	21594	ring finger protein 7
PA34445	9025	RNF8	chr6	37311748	37365514	53766	ring finger protein 8, E3 ubiquitin protein ligase
PA162401921	51136	RNFT1	chr17	58026723	58052117	25394	ring finger protein, transmembrane 1
PA162401944	84900	RNFT2	chr12	117166096	117294436	128340	ring finger protein, transmembrane 2
PA34446	8732	RNGTT	chr6	89316988	89683440	366452	RNA guanylyltransferase and 5'-phosphatase
PA34447	6050	RNH1	chr11	491512	517283	25771	ribonuclease/angiogenin inhibitor 1
PA165549084	55328	RNLS	chr10	90030621	90353611	322990	renalase, FAD-dependent amine oxidase
PA34448	8731	RNMT	chr18	13716659	13767555	50896	RNA (guanine-7-) methyltransferase
PA38341	55178	RNMTL1	chr17	675513	698741	23228	RNA methyltransferase like 1
PA134865246	55599	RNPC3	chr1	104058323	104100861	42538	RNA-binding region (RNP1, RRM) containing 3
PA34451	6051	RNPEP	chr1	201941766	201978275	36509	arginyl aminopeptidase (aminopeptidase B)
PA34452	57140	RNPEPL1	chr2	241497952	241521149	23197	arginyl aminopeptidase (aminopeptidase B)-like 1
PA34453	10921	RNPS1	chr16	2300100	2328413	28313	RNA binding protein S1, serine-rich domain
PA34620	6091	ROBO1	chr3	78643388	79827059	1183671	roundabout, axon guidance receptor, homolog 1 (Drosophila)
PA34621	6092	ROBO2	chr3	75945845	77702115	1756270	roundabout, axon guidance receptor, homolog 2 (Drosophila)
PA134896648	64221	ROBO3	chr11	124725305	124754370	29065	roundabout, axon guidance receptor, homolog 3 (Drosophila)
PA34622	54538	ROBO4	chr11	124751114	124777857	26743	roundabout, axon guidance receptor, homolog 4 (Drosophila)
PA34623	6093	ROCK1	chr18	18526701	18701812	175111	Rho-associated, coiled-coil containing protein kinase 1
PA34624	9475	ROCK2	chr2	11316894	11494711	177817	Rho-associated, coiled-coil containing protein kinase 2
PA143485597	79641	ROGDI	chr16	4843963	4862951	18988	rogdi homolog (Drosophila)
PA34626	6094	ROM1	chr11	62370213	62385592	15379	retinal outer segment membrane protein 1
PA164725540	140823	ROMO1	chr20	34277232	34291902	14670	reactive oxygen species modulator 1
PA134952827	54763	ROPN1	chr3	123684862	123721017	36155	rhophilin associated tail protein 1
PA142671053	152015	ROPN1B	chr3	125677987	125705297	27310	rhophilin associated tail protein 1B
PA134956127	83853	ROPN1L	chr5	10431974	10468138	36164	rhophilin associated tail protein 1-like
PA34628	4919	ROR1	chr1	64229690	64650181	420491	receptor tyrosine kinase-like orphan receptor 1
PA34629	4920	ROR2	chr9	94481878	94722444	240566	receptor tyrosine kinase-like orphan receptor 2
PA34630	6095	RORA	chr15	60777483	61531502	754019	RAR-related orphan receptor A
PA34631	6096	RORB	chr9	77102252	77306534	204282	RAR-related orphan receptor B
PA34632	6097	RORC	chr1	151775547	151814348	38801	RAR-related orphan receptor C
PA34633	6098	ROS1	chr6	117606530	117757018	150488	ROS proto-oncogene 1 , receptor tyrosine kinase
PA34635	6101	RP1	chr8	55518627	55685524	166897	retinitis pigmentosa 1 (autosomal dominant)
PA34640	94137	RP1L1	chr8	10460859	10522617	61758	retinitis pigmentosa 1-like 1
PA34641	6102	RP2	chrX	46686347	46744793	58446	retinitis pigmentosa 2 (X-linked recessive)
PA34650	6100	RP9	chr7	33131409	33159002	27593	retinitis pigmentosa 9 (autosomal dominant)
PA34651	6117	RPA1	chr17	1723273	1805848	82575	replication protein A1, 70kDa
PA34652	6118	RPA2	chr1	28215035	28251255	36220	replication protein A2, 32kDa
PA34653	6119	RPA3	chr7	7673347	7768238	94891	replication protein A3, 14kDa
PA134988548	29935	RPA4	chrX	96128907	96143466	14559	replication protein A4, 30kDa
PA145007849	84268	RPAIN	chr17	5312961	5339340	26379	RPA interacting protein
PA134914340	26015	RPAP1	chr15	41806374	41846464	40090	RNA polymerase II associated protein 1
PA162401981	79871	RPAP2	chr1	92754522	92856732	102210	RNA polymerase II associated protein 2
PA162401982	79657	RPAP3	chr12	48052715	48109844	57129	RNA polymerase II associated protein 3
PA34654	6120	RPE	chr2	210857289	210892784	35495	ribulose-5-phosphate-3-epimerase
PA34655	6121	RPE65	chr1	68891507	68925642	34135	retinal pigment epithelium-specific protein 65kDa
PA165752348	80135	RPF1	chr1	84934920	84967033	32113	ribosome production factor 1 homolog (S. cerevisiae)
PA165618192	84154	RPF2	chr6	111293274	111350299	57025	ribosome production factor 2 homolog (S. cerevisiae)
PA34656	6103	RPGR	chrX	38125423	38196817	71394	retinitis pigmentosa GTPase regulator
PA34657	57096	RPGRIP1	chr14	21746136	21822460	76324	retinitis pigmentosa GTPase regulator interacting protein 1
PA162401983	23322	RPGRIP1L	chr16	53630818	53747771	116953	RPGRIP1-like
PA134886118	22895	RPH3A	chr12	113219343	113339686	120343	rabphilin 3A
PA34658	9501	RPH3AL	chr17	59180	212633	153453	rabphilin 3A-like (without C2 domains)
PA34659	22934	RPIA	chr2	88981176	89053452	72276	ribose 5-phosphate isomerase A
PA34660	6134	RPL10	chrX	153616571	153633901	17330	ribosomal protein L10
PA34661	4736	RPL10A	chr6	35426178	35441558	15380	ribosomal protein L10a
PA34662	140801	RPL10L	chr14	47117213	47131041	13828	ribosomal protein L10-like
PA34664	6135	RPL11	chr1	24008269	24025915	17646	ribosomal protein L11
PA34665	6136	RPL12	chr9	130206953	130223711	16758	ribosomal protein L12
PA34670	6137	RPL13	chr16	89603324	89636237	32913	ribosomal protein L13
PA38122	23521	RPL13A	chr19	49980811	49998565	17754	ribosomal protein L13a
PA34673	9045	RPL14	chr3	40488783	40506863	18080	ribosomal protein L14
PA34674	6138	RPL15	chr3	23948295	23968187	19892	ribosomal protein L15
PA34676	6139	RPL17	chr18	47011851	47028935	17084	ribosomal protein L17
PA34679	6141	RPL18	chr19	49115584	49132675	17091	ribosomal protein L18
PA34680	6142	RPL18A	chr19	17960687	17977133	16446	ribosomal protein L18a
PA34681	6143	RPL19	chr17	37346536	37363980	17444	ribosomal protein L19
PA34683	6144	RPL21	chr13	27815692	27833705	18013	ribosomal protein L21
PA142671025	729484	RPL21P18	chr12	66420975	66434524	13549	ribosomal protein L21 pseudogene 18
PA34688	6146	RPL22	chr1	6242080	6269679	27599	ribosomal protein L22
PA142671026	200916	RPL22L1	chr3	170579664	170598045	18381	ribosomal protein L22-like 1
PA34690	9349	RPL23	chr17	37003321	37020053	16732	ribosomal protein L23
PA34691	6147	RPL23A	chr17	27037000	27054374	17374	ribosomal protein L23a
PA34701	6152	RPL24	chr3	101396934	101415564	18630	ribosomal protein L24
PA34705	6154	RPL26	chr17	8277834	8296565	18731	ribosomal protein L26
PA34706	51121	RPL26L1	chr5	172375917	172399774	23857	ribosomal protein L26-like 1
PA34707	6155	RPL27	chr17	41140446	41157976	17530	ribosomal protein L27
PA34708	6157	RPL27A	chr11	8693995	8714419	20424	ribosomal protein L27a
PA34710	6158	RPL28	chr19	55887300	55917616	30316	ribosomal protein L28
PA34711	6159	RPL29	chr3	52024644	52039958	15314	ribosomal protein L29
PA34713	6122	RPL3	chr22	39705887	39725670	19783	ribosomal protein L3
PA34714	6156	RPL30	chr8	99050938	99067818	16880	ribosomal protein L30
PA34715	6160	RPL31	chr2	101608691	101639155	30464	ribosomal protein L31
PA34719	6161	RPL32	chr3	12873444	12893081	19637	ribosomal protein L32
PA34723	6164	RPL34	chr4	109531722	109554640	22918	ribosomal protein L34
PA34727	11224	RPL35	chr9	127617158	127634240	17082	ribosomal protein L35
PA34728	6165	RPL35A	chr3	197667023	197685722	18699	ribosomal protein L35a
PA34730	25873	RPL36	chr19	5680272	5694678	14406	ribosomal protein L36
PA164742367	6173	RPL36A	chrX	100635878	100654142	18264	ribosomal protein L36a
PA34732	6166	RPL36AL	chr14	50082406	50097403	14997	ribosomal protein L36a-like
PA34736	6167	RPL37	chr5	40828430	40845387	16957	ribosomal protein L37
PA34737	6168	RPL37A	chr2	217353520	217369190	15670	ribosomal protein L37a
PA34741	6169	RPL38	chr17	72189795	72209019	19224	ribosomal protein L38
PA34743	6170	RPL39	chrX	118917467	118935622	18155	ribosomal protein L39
PA34744	116832	RPL39L	chr3	186835741	186867263	31522	ribosomal protein L39-like
PA34746	6123	RPL3L	chr16	1991580	2014679	23099	ribosomal protein L3-like
PA34749	6124	RPL4	chr15	66788653	66826870	38217	ribosomal protein L4
PA34750	6171	RPL41	chr12	56500374	56514616	14242	ribosomal protein L41
PA34755	6125	RPL5	chr1	93287594	93310481	22887	ribosomal protein L5
PA34758	6128	RPL6	chr12	112839994	112866647	26653	ribosomal protein L6
PA34759	6129	RPL7	chr8	74199874	74215869	15995	ribosomal protein L7
PA34760	6130	RPL7A	chr9	136205069	136221280	16211	ribosomal protein L7a
PA134977157	285855	RPL7L1	chr6	42837354	42860627	23273	ribosomal protein L7-like 1
PA34768	6132	RPL8	chr8	146012152	146027805	15653	ribosomal protein L8
PA34769	6133	RPL9	chr4	39452744	39470568	17824	ribosomal protein L9
PA34772	6175	RPLP0	chr12	120631502	120649014	17512	ribosomal protein, large, P0
PA34775	6176	RPLP1	chr15	69735159	69750884	15725	ribosomal protein, large, P1
PA34776	6181	RPLP2	chr11	798841	830592	31751	ribosomal protein, large, P2
PA34777	6184	RPN1	chr3	128335813	128379719	43906	ribophorin I
PA34778	6185	RPN2	chr20	35797454	35873026	75572	ribophorin II
PA134896894	11102	RPP14	chr3	58281972	58308920	26948	ribonuclease P/MRP 14kDa subunit
PA134960979	79897	RPP21	chr6	30302897	30317635	14738	ribonuclease P/MRP 21kDa subunit
PA134990737	54913	RPP25	chr15	75244443	75259775	15332	ribonuclease P/MRP 25kDa subunit
PA134989644	138716	RPP25L	chr9	34607482	34622110	14628	ribonuclease P/MRP 25kDa subunit-like
PA134876345	10556	RPP30	chr10	92621709	92671312	49603	ribonuclease P/MRP 30kDa subunit
PA134957031	10557	RPP38	chr10	15129179	15149256	20077	ribonuclease P/MRP 38kDa subunit
PA134911809	10799	RPP40	chr6	4992280	5014292	22012	ribonuclease P/MRP 40kDa subunit
PA162402042	55197	RPRD1A	chr18	33566787	33657538	90751	regulation of nuclear pre-mRNA domain containing 1A
PA162402043	58490	RPRD1B	chr20	36651864	36759182	107318	regulation of nuclear pre-mRNA domain containing 1B
PA162402062	23248	RPRD2	chr1	150326624	150452042	125418	regulation of nuclear pre-mRNA domain containing 2
PA134937494	56475	RPRM	chr2	154330852	154345322	14470	reprimo, TP53 dependent G2 arrest mediator candidate
PA142670990	388394	RPRML	chr17	45052522	45066614	14092	reprimo-like
PA34779	6204	RPS10	chr6	34382231	34403902	21671	ribosomal protein S10
PA34782	6205	RPS11	chr19	49989622	50005969	16347	ribosomal protein S11
PA34784	6206	RPS12	chr6	133125708	133145007	19299	ribosomal protein S12
PA34785	6207	RPS13	chr11	17092939	17109220	16281	ribosomal protein S13
PA34786	6208	RPS14	chr5	149819712	149839351	19639	ribosomal protein S14
PA34787	6209	RPS15	chr19	1428363	1443494	15131	ribosomal protein S15
PA34788	6210	RPS15A	chr16	18791277	18811656	20379	ribosomal protein S15a
PA34796	6217	RPS16	chr19	39920847	39936660	15813	ribosomal protein S16
PA34797	6218	RPS17	chr15	82818161	82834865	16704	ribosomal protein S17
PA34801	6222	RPS18	chr6	33229852	33247281	17429	ribosomal protein S18
PA34803	6223	RPS19	chr19	42353988	42378484	24496	ribosomal protein S19
PA143485599	91582	RPS19BP1	chr22	39922098	39938860	16762	ribosomal protein S19 binding protein 1
PA34806	6187	RPS2	chr16	2009059	2024827	15768	ribosomal protein S2
PA34807	6224	RPS20	chr8	56977739	56997140	19401	ribosomal protein S20
PA34812	6227	RPS21	chr20	60952121	60966576	14455	ribosomal protein S21
PA34813	6228	RPS23	chr5	81566139	81584235	18096	ribosomal protein S23
PA34815	6229	RPS24	chr10	79783518	79819571	36053	ribosomal protein S24
PA34817	6230	RPS25	chr11	118883422	118899057	15635	ribosomal protein S25
PA34818	6231	RPS26	chr12	56425686	56441007	15321	ribosomal protein S26
PA34820	6232	RPS27	chr1	153953239	153967631	14392	ribosomal protein S27
PA34821	6233	RPS27A	chr2	55449039	55465989	16950	ribosomal protein S27a
PA38546	51065	RPS27L	chr15	63442539	63459741	17202	ribosomal protein S27-like
PA34825	6234	RPS28	chr19	8376384	8390280	13896	ribosomal protein S28
PA34826	6235	RPS29	chr14	50040390	50063134	22744	ribosomal protein S29
PA34829	6188	RPS3	chr11	75100535	75136346	35811	ribosomal protein S3
PA34830	6189	RPS3A	chr4	152010725	152028804	18079	ribosomal protein S3A
PA34839	6191	RPS4X	chrX	71489453	71507141	17688	ribosomal protein S4, X-linked
PA34840	6192	RPS4Y1	chrY	2699623	2737997	38374	ribosomal protein S4, Y-linked 1
PA38563	140032	RPS4Y2	chrY	22907954	22945918	37964	ribosomal protein S4, Y-linked 2
PA34841	6193	RPS5	chr19	58888636	58909171	20535	ribosomal protein S5
PA34844	6194	RPS6	chr9	19373253	19390272	17019	ribosomal protein S6
PA34845	6195	RPS6KA1	chr1	26846249	26904520	58271	ribosomal protein S6 kinase, 90kDa, polypeptide 1
PA34846	6196	RPS6KA2	chr6	166819854	167285948	466094	ribosomal protein S6 kinase, 90kDa, polypeptide 2
PA34847	6197	RPS6KA3	chrX	20165029	20295523	130494	ribosomal protein S6 kinase, 90kDa, polypeptide 3
PA34848	8986	RPS6KA4	chr11	64116625	64142687	26062	ribosomal protein S6 kinase, 90kDa, polypeptide 4
PA34849	9252	RPS6KA5	chr14	91332086	91536993	204907	ribosomal protein S6 kinase, 90kDa, polypeptide 5
PA34850	27330	RPS6KA6	chrX	83310354	83452943	142589	ribosomal protein S6 kinase, 90kDa, polypeptide 6
PA34851	6198	RPS6KB1	chr17	57960407	58030787	70380	ribosomal protein S6 kinase, 70kDa, polypeptide 1
PA34852	6199	RPS6KB2	chr11	67185935	67205879	19944	ribosomal protein S6 kinase, 70kDa, polypeptide 2
PA34854	26750	RPS6KC1	chr1	213214588	213449808	235220	ribosomal protein S6 kinase, 52kDa, polypeptide 1
PA134868364	83694	RPS6KL1	chr14	75367657	75399985	32328	ribosomal protein S6 kinase-like 1
PA34855	6201	RPS7	chr2	3612853	3631509	18656	ribosomal protein S7
PA34856	6202	RPS8	chr1	45231213	45247427	16214	ribosomal protein S8
PA34857	6203	RPS9	chr19	54694608	54714515	19907	ribosomal protein S9
PA30287	3921	RPSA	chr3	39438204	39457033	18829	ribosomal protein SA
PA142670970	126638	RPTN	chr1	152123071	152141704	18633	repetin
PA165432629	57521	RPTOR	chr17	78508625	78943173	434548	regulatory associated protein of MTOR, complex 1
PA25556	113000	RPUSD1	chr16	831974	848383	16409	RNA pseudouridylate synthase domain containing 1
PA134866412	27079	RPUSD2	chr15	40851503	40869666	18163	RNA pseudouridylate synthase domain containing 2
PA134924883	285367	RPUSD3	chr3	9876533	9895702	19169	RNA pseudouridylate synthase domain containing 3
PA134875000	84881	RPUSD4	chr11	126068989	126091587	22598	RNA pseudouridylate synthase domain containing 4
PA34859	9125	RQCD1	chr2	219423303	219464158	40855	RCD1 required for cell differentiation1 homolog (S. pombe)
PA34860	6236	RRAD	chr16	66952582	66969439	16857	Ras-related associated with diabetes
PA134980509	10670	RRAGA	chr9	19039372	19054023	14651	Ras-related GTP binding A
PA134902397	10325	RRAGB	chrX	55734110	55788766	54656	Ras-related GTP binding B
PA134862062	64121	RRAGC	chr1	39300869	39335495	34626	Ras-related GTP binding C
PA134957148	58528	RRAGD	chr6	90071335	90131995	60660	Ras-related GTP binding D
PA34861	6237	RRAS	chr19	50135552	50153400	17848	related RAS viral (r-ras) oncogene homolog
PA34862	22800	RRAS2	chr11	14296466	14396052	99586	related RAS viral (r-ras) oncogene homolog 2
PA34863	6238	RRBP1	chr20	17591323	17672934	81611	ribosome binding protein 1
PA34864	6239	RREB1	chr6	7097830	7255213	157383	ras responsive element binding protein 1
PA34865	10692	RRH	chr4	110739150	110768863	29713	retinal pigment epithelium-derived rhodopsin homolog
PA298	6240	RRM1	chr11	4105791	4163116	57325	ribonucleotide reductase M1
PA299	6241	RRM2	chr2	10252695	10274546	21851	ribonucleotide reductase M2
PA34866	50484	RRM2B	chr8	103213729	103261346	47617	ribonucleotide reductase M2 B (TP53 inducible)
PA134878601	54700	RRN3	chr16	15150879	15198168	47289	RRN3 RNA polymerase I transcription factor homolog (S. cerevisiae)
PA142672516	51093	RRNAD1	chr1	156688263	156709752	21489	ribosomal RNA adenine dimethylase domain containing 1
PA162402091	8568	RRP1	chr21	45199418	45226983	27565	ribosomal RNA processing 1
PA162402122	23223	RRP12	chr10	99113458	99171127	57669	ribosomal RNA processing 12 homolog (S. cerevisiae)
PA162402123	51018	RRP15	chr1	218448629	218514325	65696	ribosomal RNA processing 15 homolog (S. cerevisiae)
PA162402138	23076	RRP1B	chr21	45069432	45118960	49528	ribosomal RNA processing 1B
PA165618219	88745	RRP36	chr6	42979385	43000337	20952	ribosomal RNA processing 36 homolog (S. cerevisiae)
PA162402175	27341	RRP7A	chr22	42901341	42925829	24488	ribosomal RNA processing 7 homolog A (S. cerevisiae)
PA164725550	23378	RRP8	chr11	6618144	6634884	16740	ribosomal RNA processing 8, methyltransferase, homolog (yeast)
PA162402176	9136	RRP9	chr3	51964442	51985957	21515	ribosomal RNA processing 9, small subunit (SSU) processome component, homolog (yeast)
PA134993138	23212	RRS1	chr8	67331263	67345968	14705	RRS1 ribosome biogenesis regulator homolog (S. cerevisiae)
PA34871	6247	RS1	chrX	18654808	18700223	45415	retinoschisin 1
PA134945325	55316	RSAD1	chr17	48546190	48566336	20146	radical S-adenosyl methionine domain containing 1
PA134937442	91543	RSAD2	chr2	7007796	7041370	33574	radical S-adenosyl methionine domain containing 2
PA134869532	54665	RSBN1	chr1	114301454	114365070	63616	round spermatid basic protein 1
PA134948776	222194	RSBN1L	chr7	77315743	77412120	96377	round spermatid basic protein 1-like
PA34872	6248	RSC1A1	chr1	15976364	15991217	14853	regulatory solute carrier protein, family 1, member 1
PA29210	51773	RSF1	chr11	77368047	77541915	173868	remodeling and spacing factor 1
PA142672473	79363	RSG1	chr1	16555182	16573659	18477	REM2 and RAB-like small GTPase 1
PA142670966	26156	RSL1D1	chr16	11925053	11955442	30389	ribosomal L1 domain containing 1
PA164725551	51187	RSL24D1	chr15	55470512	55499231	28719	ribosomal L24 domain containing 1
PA162402177	89765	RSPH1	chr21	43889596	43926417	36821	radial spoke head 1 homolog (Chlamydomonas)
PA162402200	222967	RSPH10B	chr7	5962777	6020322	57545	radial spoke head 10 homolog B (Chlamydomonas)
PA162402247	728194	RSPH10B2	chr7	6783732	6841396	57664	radial spoke head 10 homolog B2 (Chlamydomonas)
PA34878	27156	RSPH14	chr22	23398593	23494241	95648	radial spoke head 14 homolog (Chlamydomonas)
PA162402248	83861	RSPH3	chr6	159395077	159431424	36347	radial spoke 3 homolog (Chlamydomonas)
PA164725568	345895	RSPH4A	chr6	116927642	116957148	29506	radial spoke head 4 homolog A (Chlamydomonas)
PA34873	81492	RSPH6A	chr19	46295968	46328605	32637	radial spoke head 6 homolog A (Chlamydomonas)
PA164725569	221421	RSPH9	chr6	43602767	43641935	39168	radial spoke head 9 homolog (Chlamydomonas)
PA142670967	284654	RSPO1	chr1	38073821	38110595	36774	R-spondin 1
PA142670968	340419	RSPO2	chr8	108908544	109105913	197369	R-spondin 2
PA134885289	84870	RSPO3	chr6	127429844	127523626	93782	R-spondin 3
PA25726	343637	RSPO4	chr20	936095	992907	56812	R-spondin 4
PA143485602	89970	RSPRY1	chr16	57210026	57277385	67359	ring finger and SPRY domain containing 1
PA142670969	51319	RSRC1	chr3	157813690	158265624	451934	arginine/serine-rich coiled-coil 1
PA162402249	65117	RSRC2	chr12	122986190	123021560	35370	arginine/serine-rich coiled-coil 2
PA142672513	57035	RSRP1	chr1	25565740	25583985	18245	arginine/serine-rich protein 1
PA34876	6251	RSU1	chr10	16629615	16869509	239894	Ras suppressor protein 1
PA144596387	83546	RTBDN	chr19	12933291	12956242	22951	retbindin
PA34877	8634	RTCA	chr1	100721714	100761325	39611	RNA 3'-terminal phosphate cyclase
PA145149387	51493	RTCB	chr22	32780562	32818274	37712	RNA 2',3'-cyclic phosphate and 5'-OH ligase
PA134915625	51750	RTEL1	chr20	62279163	62330606	51443	regulator of telomere elongation helicase 1
PA134961778	23168	RTF1	chr15	41699302	41778761	79459	Rtf1, Paf1/RNA polymerase II complex component, homolog (S. cerevisiae)
PA25756	51507	RTFDC1	chr20	55033641	55096942	63301	replication termination factor 2 domain containing 1
PA34879	6242	RTKN	chr2	74649988	74679060	29072	rhotekin
PA162402276	219790	RTKN2	chr10	63939794	64038570	98776	rhotekin 2
PA143485603	388015	RTL1	chr14	101343569	101369826	26257	retrotransposon-like 1
PA34880	6252	RTN1	chr14	60059694	60347557	287863	reticulon 1
PA34881	6253	RTN2	chr19	45985546	46010313	24767	reticulon 2
PA34882	10313	RTN3	chr11	63438922	63530363	91441	reticulon 3
PA34883	57142	RTN4	chr2	55196325	55317770	121445	reticulon 4
PA38619	84816	RTN4IP1	chr6	107015903	107087373	71470	reticulon 4 interacting protein 1
PA38600	65078	RTN4R	chr22	20225938	20265816	39878	reticulon 4 receptor
PA134973992	146760	RTN4RL1	chr17	1834971	1938178	103207	reticulon 4 receptor-like 1
PA134964131	349667	RTN4RL2	chr11	57217926	57247384	29458	reticulon 4 receptor-like 2
PA143485604	132112	RTP1	chr3	186905274	186922253	16979	receptor (chemosensory) transporter protein 1
PA143485605	344892	RTP2	chr3	187413047	187430345	17298	receptor (chemosensory) transporter protein 2
PA37981	83597	RTP3	chr3	46529485	46545439	15954	receptor (chemosensory) transporter protein 3
PA143485606	64108	RTP4	chr3	187076168	187092372	16204	receptor (chemosensory) transporter protein 4
PA164717177	285093	RTP5	chr2	242801886	242818482	16596	receptor (chemosensory) transporter protein 5 (putative)
PA38622	25914	RTTN	chr18	67668040	67882962	214922	rotatin
PA134944787	80230	RUFY1	chr5	178967562	179040027	72465	RUN and FYVE domain containing 1
PA134935922	55680	RUFY2	chr10	70097864	70177051	79187	RUN and FYVE domain containing 2
PA142670961	22902	RUFY3	chr4	71560647	71677336	116689	RUN and FYVE domain containing 3
PA147357421	285180	RUFY4	chr2	218889657	218958304	68647	RUN and FYVE domain containing 4
PA134956633	146923	RUNDC1	chr17	41122527	41148713	26186	RUN domain containing 1
PA142670962	84127	RUNDC2A	chr16	12060603	12150142	89539	RUN domain containing 2A
PA162402277	10900	RUNDC3A	chr17	42375786	42399039	23253	RUN domain containing 3A
PA162402278	154661	RUNDC3B	chr7	87247729	87464613	216884	RUN domain containing 3B
PA34884	861	RUNX1	chr21	36157098	36431595	274497	runt-related transcription factor 1
PA26111	862	RUNX1T1	chr8	92964195	93125454	161259	runt-related transcription factor 1; translocated to, 1 (cyclin D-related)
PA34885	860	RUNX2	chr6	45286054	45521819	235765	runt-related transcription factor 2
PA34886	864	RUNX3	chr1	25223002	25301648	78646	runt-related transcription factor 3
PA134947113	23623	RUSC1	chr1	155280640	155303909	23269	RUN and SH3 domain containing 1
PA134956488	9853	RUSC2	chr9	35480007	35564895	84888	RUN and SH3 domain containing 2
PA34887	8607	RUVBL1	chr3	127796800	127882752	85952	RuvB-like AAA ATPase 1
PA34888	10856	RUVBL2	chr19	49486738	49522183	35445	RuvB-like AAA ATPase 2
PA134967923	51389	RWDD1	chr6	116882583	116917438	34855	RWD domain containing 1
PA162402307	112611	RWDD2A	chr6	83893032	83911654	18622	RWD domain containing 2A
PA162402318	10069	RWDD2B	chr21	30375080	30401685	26605	RWD domain containing 2B
PA134974302	25950	RWDD3	chr1	95689711	95715781	26070	RWD domain containing 3
PA142670965	201965	RWDD4	chr4	184557789	184590331	32542	RWD domain containing 4
PA134868312	59350	RXFP1	chr4	159432866	159577524	144658	relaxin/insulin-like family peptide receptor 1
PA134918556	122042	RXFP2	chr13	32303679	32380009	76330	relaxin/insulin-like family peptide receptor 2
PA134868535	51289	RXFP3	chr5	33926491	33942023	15532	relaxin/insulin-like family peptide receptor 3
PA28848	339403	RXFP4	chr1	155901480	155915625	14145	relaxin/insulin-like family peptide receptor 4
PA34890	6256	RXRA	chr9	137208316	137335431	127115	retinoid X receptor, alpha
PA34891	6257	RXRB	chr6	33158362	33178630	20268	retinoid X receptor, beta
PA34892	6258	RXRG	chr1	165367159	165424592	57433	retinoid X receptor, gamma
PA34893	23429	RYBP	chr3	72420744	72505774	85030	RING1 and YY1 binding protein
PA34894	6259	RYK	chr3	133872978	133979586	106608	receptor-like tyrosine kinase
PA34896	6261	RYR1	chr19	38914340	39081204	166864	ryanodine receptor 1 (skeletal)
PA300	6262	RYR2	chr1	237195510	238000288	804778	ryanodine receptor 2 (cardiac)
PA34897	6263	RYR3	chr15	33593177	34161304	568127	ryanodine receptor 3
PA34898	6271	S100A1	chr1	153590873	153607513	16640	S100 calcium binding protein A1
PA34899	6281	S100A10	chr1	151952386	151976714	24328	S100 calcium binding protein A10
PA34900	6282	S100A11	chr1	152001982	152019511	17529	S100 calcium binding protein A11
PA34901	6283	S100A12	chr1	153343184	153358075	14891	S100 calcium binding protein A12
PA34902	6284	S100A13	chr1	153588275	153616582	28307	S100 calcium binding protein A13
PA134905502	57402	S100A14	chr1	153583731	153598808	15077	S100 calcium binding protein A14
PA134931606	140576	S100A16	chr1	153576362	153595514	19152	S100 calcium binding protein A16
PA34904	6273	S100A2	chr1	153530584	153548306	17722	S100 calcium binding protein A2
PA34905	6274	S100A3	chr1	153516805	153531734	14929	S100 calcium binding protein A3
PA34906	6275	S100A4	chr1	153513095	153528282	15187	S100 calcium binding protein A4
PA34907	6276	S100A5	chr1	153506623	153525772	19149	S100 calcium binding protein A5
PA34908	6277	S100A6	chr1	153504076	153518717	14641	S100 calcium binding protein A6
PA34909	6278	S100A7	chr1	153427220	153446559	19339	S100 calcium binding protein A7
PA162402333	338324	S100A7A	chr1	153379000	153398701	19701	S100 calcium binding protein A7A
PA134903327	645922	S100A7L2	chr1	153406471	153422503	16032	S100 calcium binding protein A7-like 2
PA34910	6279	S100A8	chr1	153359508	153405054	45546	S100 calcium binding protein A8
PA34911	6280	S100A9	chr1	153320330	153336503	16173	S100 calcium binding protein A9
PA34912	6285	S100B	chr21	48015531	48035035	19504	S100 calcium binding protein B
PA26028	795	S100G	chrX	16658281	16675791	17510	S100 calcium binding protein G
PA34913	6286	S100P	chr4	6685566	6701897	16331	S100 calcium binding protein P
PA142670958	64766	S100PBP	chr1	33272368	33327480	55112	S100P binding protein
PA134902118	170591	S100Z	chr5	76135826	76220056	84230	S100 calcium binding protein Z
PA162402344	1901	S1PR1	chr1	101692305	101710076	17771	sphingosine-1-phosphate receptor 1
PA162402353	9294	S1PR2	chr19	10329109	10351948	22839	sphingosine-1-phosphate receptor 2
PA162402362	1903	S1PR3	chr9	91596324	91623070	26746	sphingosine-1-phosphate receptor 3
PA162402371	8698	S1PR4	chr19	3168250	3183335	15085	sphingosine-1-phosphate receptor 4
PA162402378	53637	S1PR5	chr19	10620418	10638668	18250	sphingosine-1-phosphate receptor 5
PA34921	6288	SAA1	chr11	18277754	18309424	31670	serum amyloid A1
PA34922	6289	SAA2	chr11	18256780	18280221	23441	serum amyloid A2
PA34924	6291	SAA4	chr11	18249902	18268384	18482	serum amyloid A4, constitutive
PA142670959	113174	SAAL1	chr11	18098890	18137638	38748	serum amyloid A-like 1
PA142670960	29901	SAC3D1	chr11	64798376	64815300	16924	SAC3 domain containing 1
PA34925	22908	SACM1L	chr3	45720754	45789901	69147	SAC1 suppressor of actin mutations 1-like (yeast)
PA34927	26278	SACS	chr13	23899962	24017867	117905	sacsin molecular chaperone
PA162402387	10055	SAE1	chr19	47624080	47716893	92813	SUMO1 activating enzyme subunit 1
PA34928	6294	SAFB	chr19	5613046	5671489	58443	scaffold attachment factor B
PA134987683	9667	SAFB2	chr19	5584007	5632991	48984	scaffold attachment factor B2
PA34929	6295	SAG	chr2	234206309	234258701	52392	S-antigen; retina and pineal gland (arrestin)
PA134909712	55511	SAGE1	chrX	134965785	134998221	32436	sarcoma antigen 1
PA34932	6299	SALL1	chr16	51166886	51195183	28297	spalt-like transcription factor 1
PA34934	6297	SALL2	chr14	21986231	22015337	29106	spalt-like transcription factor 2
PA34935	27164	SALL3	chr18	76730275	76762770	32495	spalt-like transcription factor 3
PA34936	57167	SALL4	chr20	50397551	50429059	31508	spalt-like transcription factor 4
PA34937	90378	SAMD1	chr19	14196229	14211232	15003	sterile alpha motif domain containing 1
PA25678	140700	SAMD10	chr20	62602466	62621182	18716	sterile alpha motif domain containing 10
PA134968665	148398	SAMD11	chr1	849993	882961	32968	sterile alpha motif domain containing 11
PA134993493	401474	SAMD12	chr8	119198694	119644184	445490	sterile alpha motif domain containing 12
PA142670952	148418	SAMD13	chr1	84754049	84819481	65432	sterile alpha motif domain containing 13
PA142670953	201191	SAMD14	chr17	48185673	48217246	31573	sterile alpha motif domain containing 14
PA134903169	161394	SAMD15	chr14	77833762	77860587	26825	sterile alpha motif domain containing 15
PA134880481	154075	SAMD3	chr6	130462447	130696570	234123	sterile alpha motif domain containing 3
PA128394596	23034	SAMD4A	chr14	55023815	55263033	239218	sterile alpha motif domain containing 4A
PA143485607	55095	SAMD4B	chr19	39823108	39879340	56232	sterile alpha motif domain containing 4B
PA134888862	389432	SAMD5	chr6	147819807	148061677	241870	sterile alpha motif domain containing 5
PA134861212	344658	SAMD7	chr3	169619360	169659963	40603	sterile alpha motif domain containing 7
PA134868247	142891	SAMD8	chr10	76861275	76944881	83606	sterile alpha motif domain containing 8
PA25948	54809	SAMD9	chr7	92725826	92757336	31510	sterile alpha motif domain containing 9
PA25949	219285	SAMD9L	chr7	92756368	92787689	31321	sterile alpha motif domain containing 9-like
PA34938	25939	SAMHD1	chr20	35516285	35590246	73961	SAM domain and HD domain 1
PA142670954	25813	SAMM50	chr22	44341261	44395412	54151	SAMM50 sorting and assembly machinery component
PA34939	64092	SAMSN1	chr21	15854549	15965723	111174	SAM domain, SH3 domain and nuclear localization signals 1
PA143485608	79595	SAP130	chr2	128695791	128795667	99876	Sin3A-associated protein, 130kDa
PA34940	10284	SAP18	chr13	21704653	21726224	21571	Sin3A-associated protein, 18kDa
PA34941	8819	SAP30	chr4	174282093	174301683	19590	Sin3A-associated protein, 30kDa
PA142670955	29115	SAP30BP	chr17	73653399	73707139	53740	SAP30 binding protein
PA144596386	79685	SAP30L	chr5	153815517	153843613	28096	SAP30-like
PA134974558	401251	SAPCD1	chr6	31720773	31735627	14854	suppressor APC domain containing 1
PA134959870	89958	SAPCD2	chr9	139953579	139975028	21449	suppressor APC domain containing 2
PA34942	56681	SAR1A	chr10	71906960	71940285	33325	secretion associated, Ras related GTPase 1A
PA142670957	344988	SAR1AP3	chr4	121253135	121269015	15880	SAR1 homolog A (S. cerevisiae) pseudogene 3
PA34943	51128	SAR1B	chr5	133933839	133978533	44694	secretion associated, Ras related GTPase 1B
PA142670779	51669	SARAF	chr8	29917631	29950649	33018	store-operated calcium entry-associated regulatory factor
PA34944	1757	SARDH	chr9	136525682	136615077	89395	sarcosine dehydrogenase
PA134971180	23098	SARM1	chr17	26688683	26731062	42379	sterile alpha and TIR motif containing 1
PA165513309	84324	SARNP	chr12	56143247	56221540	78293	SAP domain containing ribonucleoprotein
PA34945	6301	SARS	chr1	109746515	109783804	37289	seryl-tRNA synthetase
PA134899753	54938	SARS2	chr19	39402904	39431536	28632	seryl-tRNA synthetase 2, mitochondrial
PA34947	9092	SART1	chr11	65719160	65750607	31447	squamous cell carcinoma antigen recognized by T cells
PA34948	9733	SART3	chr12	108912991	108965165	52174	squamous cell carcinoma antigen recognized by T cells 3
PA134984521	23328	SASH1	chr6	148653729	148876185	222456	SAM and SH3 domain containing 1
PA162402388	54440	SASH3	chrX	128903892	128932177	28285	SAM and SH3 domain containing 3
PA142670950	163786	SASS6	chr1	100546100	100608518	62418	spindle assembly 6 homolog (C. elegans)
PA162402389	6303	SAT1	chrX	23791275	23807327	16052	spermidine/spermine N1-acetyltransferase 1
PA134979941	112483	SAT2	chr17	7526552	7541194	14642	spermidine/spermine N1-acetyltransferase family member 2
PA34951	6304	SATB1	chr3	18386133	18490265	104132	SATB homeobox 1
PA128394624	23314	SATB2	chr2	200131223	200345989	214766	SATB homeobox 2
PA134969637	340562	SATL1	chrX	84344292	84373974	29682	spermidine/spermine N1-acetyl transferase-like 1
PA134875018	60485	SAV1	chr14	51097298	51145071	47773	salvador family WW domain containing protein 1
PA128394689	55776	SAYSD1	chr6	39068840	39092865	24025	SAYSVFN motif domain containing 1
PA134978742	51119	SBDS	chr7	66449690	66470588	20898	Shwachman-Bodian-Diamond syndrome
PA34953	6305	SBF1	chr22	50880429	50923467	43038	SET binding factor 1
PA26649	81846	SBF2	chr11	9797214	10325754	528540	SET binding factor 2
PA134887617	388228	SBK1	chr16	28260041	28338170	78129	SH3 domain binding kinase 1
PA164725571	646643	SBK2	chr19	56037780	56058435	20655	SH3 domain binding kinase family, member 2
PA134967986	55206	SBNO1	chr12	123770656	123859756	89100	strawberry notch homolog 1 (Drosophila)
PA162402390	22904	SBNO2	chr19	1104633	1184282	79649	strawberry notch homolog 2 (Drosophila)
PA144596385	374897	SBSN	chr19	36011269	36029253	17984	suprabasin
PA164717487	157869	SBSPON	chr8	73973778	74015507	41729	somatomedin B and thrombospondin, type 1 domain containing
PA34957	6309	SC5D	chr11	121153388	121187119	33731	sterol-C5-desaturase
PA162402459	58506	SCAF1	chr19	50135382	50164906	29524	SR-related CTD-associated factor 1
PA35700	9169	SCAF11	chr12	46309914	46395898	85984	SR-related CTD-associated factor 11
PA134903281	57466	SCAF4	chr21	33040313	33114431	74118	SR-related CTD-associated factor 4
PA128394587	22828	SCAF8	chr6	155044512	155285708	241196	SR-related CTD-associated factor 8
PA165586233	286205	SCAI	chr9	127701887	127915838	213951	suppressor of cancer cell invasion
PA34976	9522	SCAMP1	chr5	77646339	77779562	133223	secretory carrier membrane protein 1
PA34977	10066	SCAMP2	chr15	75134197	75175670	41473	secretory carrier membrane protein 2
PA34978	10067	SCAMP3	chr1	155222770	155242176	19406	secretory carrier membrane protein 3
PA134983341	113178	SCAMP4	chr19	1895213	1929012	33799	secretory carrier membrane protein 4
PA134962580	192683	SCAMP5	chr15	75277876	75316836	38960	secretory carrier membrane protein 5
PA34979	51282	SCAND1	chr20	34538539	34553281	14742	SCAN domain containing 1
PA162402461	22937	SCAP	chr3	47452184	47527603	75419	SREBF chaperone
PA162402512	49855	SCAPER	chr15	76637526	77207796	570270	S-phase cyclin A-associated protein in the ER
PA38775	51435	SCARA3	chr8	27481100	27537286	56186	scavenger receptor class A, member 3
PA142670948	286133	SCARA5	chr8	27724399	27860369	135970	scavenger receptor class A, member 5
PA97	949	SCARB1	chr12	125259174	125358519	99345	scavenger receptor class B, member 1
PA35038	950	SCARB2	chr4	77076890	77145052	68162	scavenger receptor class B, member 2
PA38420	8578	SCARF1	chr17	1534152	1559083	24931	scavenger receptor class F, member 1
PA134908523	91179	SCARF2	chr22	20775874	20802146	26272	scavenger receptor class F, member 2
PA142670949	51097	SCCPDH	chr1	246877378	246934439	57061	saccharopine dehydrogenase (putative)
PA34984	6319	SCD	chr10	102096772	102127588	30816	stearoyl-CoA desaturase (delta-9-desaturase)
PA134934692	79966	SCD5	chr4	83547690	83730010	182320	stearoyl-CoA desaturase 5
PA34986	8796	SCEL	chr13	78099809	78222398	122589	sciellin
PA134946073	23256	SCFD1	chr14	31081460	31208034	126574	sec1 family domain containing 1
PA134953686	152579	SCFD2	chr4	53735797	54242242	506445	sec1 family domain containing 2
PA34987	7857	SCG2	chr2	224458658	224477217	18559	secretogranin II
PA34988	29106	SCG3	chr15	51963550	52016223	52673	secretogranin III
PA35724	6447	SCG5	chr15	32923757	32992299	68542	secretogranin V (7B2 protein)
PA34989	7356	SCGB1A1	chr11	62176507	62193678	17171	secretoglobin, family 1A, member 1 (uteroglobin)
PA134928324	147199	SCGB1C1	chr11	178101	197575	19474	secretoglobin, family 1C, member 1
PA34990	10648	SCGB1D1	chr11	61947710	61964009	16299	secretoglobin, family 1D, member 1
PA34991	10647	SCGB1D2	chr11	61999102	62015280	16178	secretoglobin, family 1D, member 2
PA142670946	404552	SCGB1D4	chr11	62060754	62076536	15782	secretoglobin, family 1D, member 4
PA34992	4246	SCGB2A1	chr11	61966140	61984411	18271	secretoglobin, family 2A, member 1
PA34993	4250	SCGB2A2	chr11	62027630	62043628	15998	secretoglobin, family 2A, member 2
PA164725574	284402	SCGB2B2	chr19	35081346	35095490	14144	secretoglobin, family 2B, member 2
PA34994	92304	SCGB3A1	chr5	180014105	180028487	14382	secretoglobin, family 3A, member 1
PA34995	117156	SCGB3A2	chr5	147248274	147264756	16482	secretoglobin, family 3A, member 2
PA38428	10590	SCGN	chr6	25642429	25705011	62582	secretagogin, EF-hand calcium binding protein
PA34997	29970	SCHIP1	chr3	158981036	159618155	637119	schwannomin interacting protein 1
PA162378517	388325	SCIMP	chr17	5109215	5148997	39782	SLP adaptor and CSK interacting membrane protein
PA134981389	85477	SCIN	chr7	12599989	12696228	96239	scinderin
PA147357369	132320	SCLT1	chr4	129802148	130024764	222616	sodium channel and clathrin linker 1
PA134979359	51540	SCLY	chr2	238959565	239011054	51489	selenocysteine lyase
PA134870272	22955	SCMH1	chr1	41489871	41717815	227944	sex comb on midleg homolog 1 (Drosophila)
PA34998	6322	SCML1	chrX	17745591	17776105	30514	sex comb on midleg-like 1 (Drosophila)
PA34999	10389	SCML2	chrX	18254433	18382844	128411	sex comb on midleg-like 2 (Drosophila)
PA134946179	256380	SCML4	chr6	108020361	108155521	135160	sex comb on midleg-like 4 (Drosophila)
PA35000	6336	SCN10A	chr3	38735837	38845501	109664	sodium channel, voltage-gated, type X, alpha subunit
PA35001	11280	SCN11A	chr3	38884260	39005136	120876	sodium channel, voltage-gated, type XI, alpha subunit
PA301	6323	SCN1A	chr2	166842670	167015642	172972	sodium channel, voltage-gated, type I, alpha subunit
PA302	6324	SCN1B	chr19	35511555	35534353	22798	sodium channel, voltage-gated, type I, beta subunit
PA35004	6326	SCN2A	chr2	165976659	166251820	275161	sodium channel, voltage-gated, type II, alpha subunit
PA303	6327	SCN2B	chr11	118030519	118057337	26818	sodium channel, voltage-gated, type II, beta subunit
PA35005	6328	SCN3A	chr2	165941030	166070577	129547	sodium channel, voltage-gated, type III, alpha subunit
PA130546912	55800	SCN3B	chr11	123496895	123535315	38420	sodium channel, voltage-gated, type III, beta subunit
PA35006	6329	SCN4A	chr17	62012914	62076876	63962	sodium channel, voltage-gated, type IV, alpha subunit
PA35007	6330	SCN4B	chr11	118001092	118033630	32538	sodium channel, voltage-gated, type IV, beta subunit
PA304	6331	SCN5A	chr3	38586553	38701164	114611	sodium channel, voltage-gated, type V, alpha subunit
PA35008	6332	SCN7A	chr2	167257083	167353481	96398	sodium channel, voltage-gated, type VII, alpha subunit
PA35009	6334	SCN8A	chr12	51974050	52209648	235598	sodium channel, voltage gated, type VIII, alpha subunit
PA35010	6335	SCN9A	chr2	167048695	167242497	193802	sodium channel, voltage-gated, type IX, alpha subunit
PA134958437	79005	SCNM1	chr1	151128482	151145773	17291	sodium channel modifier 1
PA305	6337	SCNN1A	chr12	6453009	6496896	43887	sodium channel, non-voltage-gated 1 alpha subunit
PA306	6338	SCNN1B	chr16	23303591	23395620	92029	sodium channel, non-voltage-gated 1, beta subunit
PA35011	6339	SCNN1D	chr1	1205816	1230409	24593	sodium channel, non-voltage-gated 1, delta subunit
PA307	6340	SCNN1G	chr16	23184040	23231201	47161	sodium channel, non-voltage-gated 1, gamma subunit
PA35012	6341	SCO1	chr17	10580649	10610885	30236	SCO1 cytochrome c oxidase assembly protein
PA35013	9997	SCO2	chr22	50958997	50974868	15871	SCO2 cytochrome c oxidase assembly protein
PA134972148	60592	SCOC	chr4	141168440	141306710	138270	short coiled-coil protein
PA35014	6342	SCP2	chr1	53382901	53520289	137388	sterol carrier protein 2
PA25788	140856	SCP2D1	chr20	18784370	18798036	13666	SCP2 sterol-binding domain containing 1
PA134960711	59342	SCPEP1	chr17	55045468	55087129	41661	serine carboxypeptidase 1
PA165664478	11341	SCRG1	chr4	174306299	174330617	24318	stimulator of chondrogenesis 1
PA134936275	23513	SCRIB	chr8	144870090	144907890	37800	scribbled planar cell polarity protein
PA134874373	9805	SCRN1	chr7	29956719	30039905	83186	secernin 1
PA134964266	90507	SCRN2	chr17	45912047	45928699	16652	secernin 2
PA134974313	79634	SCRN3	chr2	175250457	175297303	46846	secernin 3
PA35015	83482	SCRT1	chr8	145551228	145569943	18715	scratch family zinc finger 1
PA35016	85508	SCRT2	chr20	639240	666823	27583	scratch family zinc finger 2
PA35017	6343	SCT	chr11	623313	637173	13860	secretin
PA35018	6344	SCTR	chr2	120194419	120292028	97609	secretin receptor
PA35019	80274	SCUBE1	chr22	43596229	43749394	153165	signal peptide, CUB domain, EGF-like 1
PA134908812	57758	SCUBE2	chr11	9038047	9123150	85103	signal peptide, CUB domain, EGF-like 2
PA134977856	222663	SCUBE3	chr6	35171824	35223856	52032	signal peptide, CUB domain, EGF-like 3
PA142670943	642658	SCX	chr8	145311517	145326045	14528	scleraxis basic helix-loop-helix transcription factor
PA142670942	100129885	SCXA	chr8	145480603	145495131	14528	scleraxis homolog A (mouse)
PA31812	57410	SCYL1	chr11	65282537	65309182	26645	SCY1-like 1 (S. cerevisiae)
PA134887807	55681	SCYL2	chr12	100650918	100738502	87584	SCY1-like 2 (S. cerevisiae)
PA142670945	57147	SCYL3	chr1	169819215	169873100	53885	SCY1-like 3 (S. cerevisiae)
PA134961441	55153	SDAD1	chr4	76868064	76922115	54051	SDA1 domain containing 1
PA35588	6382	SDC1	chr2	20397558	20435194	37636	syndecan 1
PA35589	6383	SDC2	chr8	97495579	97627037	131458	syndecan 2
PA35590	9672	SDC3	chr1	31339313	31391480	52167	syndecan 3
PA35591	6385	SDC4	chr20	43950928	43987064	36136	syndecan 4
PA35592	6386	SDCBP	chr8	59455566	59498419	42853	syndecan binding protein (syntenin)
PA38033	27111	SDCBP2	chr20	1287553	1319879	32326	syndecan binding protein (syntenin) 2
PA35597	10807	SDCCAG3	chr9	139293374	139315054	21680	serologically defined colon cancer antigen 3
PA35601	10806	SDCCAG8	chr1	243409307	243666393	257086	serologically defined colon cancer antigen 8
PA142672506	163859	SDE2	chr1	226167403	226197099	29696	SDE2 telomere maintenance homolog (S. pombe)
PA35603	6388	SDF2	chr17	26972374	26999207	26833	stromal cell-derived factor 2
PA35604	23753	SDF2L1	chr22	21986542	22001588	15046	stromal cell-derived factor 2-like 1
PA142670940	51150	SDF4	chr1	1149288	1177447	28159	stromal cell derived factor 4
PA35605	6389	SDHA	chr5	208338	259815	51477	succinate dehydrogenase complex, subunit A, flavoprotein (Fp)
PA165394270	644096	SDHAF1	chr19	36476090	36490220	14130	succinate dehydrogenase complex assembly factor 1
PA165543618	54949	SDHAF2	chr11	61187514	61217239	29725	succinate dehydrogenase complex assembly factor 2
PA35606	6390	SDHB	chr1	17342217	17390665	48448	succinate dehydrogenase complex, subunit B, iron sulfur (Ip)
PA35607	6391	SDHC	chr1	161274166	161337541	63375	succinate dehydrogenase complex, subunit C, integral membrane protein, 15kDa
PA35608	6392	SDHD	chr11	111947548	111969525	21977	succinate dehydrogenase complex, subunit D, integral membrane protein
PA134957188	221935	SDK1	chr7	3331080	4311632	980552	sidekick cell adhesion molecule 1
PA134981456	54549	SDK2	chr17	71327523	71650227	322704	sidekick cell adhesion molecule 2
PA35615	8436	SDPR	chr2	192696031	192722006	25975	serum deprivation response
PA164725585	195814	SDR16C5	chr8	57209570	57243335	33765	short chain dehydrogenase/reductase family 16C, member 5
PA164725619	56948	SDR39U1	chr14	24905972	24922042	16070	short chain dehydrogenase/reductase family 39U, member 1
PA164725636	93517	SDR42E1	chr16	82028251	82055093	26842	short chain dehydrogenase/reductase family 42E, member 1
PA164725647	100288072	SDR42E2	chr16	-1	-1	0	short chain dehydrogenase/reductase family 42E, member 2
PA164725648	121214	SDR9C7	chr12	57313938	57338189	24251	short chain dehydrogenase/reductase family 9C, member 7
PA35616	10993	SDS	chr12	113827250	113851692	24442	serine dehydratase
PA134862016	113675	SDSL	chr12	113850042	113879081	29039	serine dehydratase-like
PA162402574	645832	SEBOX	chr17	26688290	26702265	13975	SEBOX homeobox
PA162402586	23478	SEC11A	chr15	85209768	85269691	59923	SEC11 homolog A (S. cerevisiae)
PA134871731	157708	SEC11B	chr8	55432050	55445941	13891	SEC11 homolog B (S. cerevisiae)
PA162402587	90701	SEC11C	chr18	56796709	56829069	32360	SEC11 homolog C (S. cerevisiae)
PA35620	6396	SEC13	chr3	10339613	10372872	33259	SEC13 homolog (S. cerevisiae)
PA35621	6397	SEC14L1	chr17	75074725	75216183	141458	SEC14-like 1 (S. cerevisiae)
PA35622	23541	SEC14L2	chr22	30782930	30824291	41361	SEC14-like 2 (S. cerevisiae)
PA134960743	266629	SEC14L3	chr22	30840946	30878034	37088	SEC14-like 3 (S. cerevisiae)
PA134979694	284904	SEC14L4	chr22	30881877	30911698	29821	SEC14-like 4 (S. cerevisiae)
PA142670939	9717	SEC14L5	chr16	4998318	5072156	73838	SEC14-like 5 (S. cerevisiae)
PA162402611	9919	SEC16A	chr9	139331548	139389297	57749	SEC16 homolog A (S. cerevisiae)
PA162402680	89866	SEC16B	chr1	177889825	177949188	59363	SEC16 homolog B (S. cerevisiae)
PA134921956	26984	SEC22A	chr3	122910774	122995983	85209	SEC22 vesicle trafficking protein homolog A (S. cerevisiae)
PA134952972	9117	SEC22C	chr3	42586459	42652572	66113	SEC22 vesicle trafficking protein homolog C (S. cerevisiae)
PA35624	10484	SEC23A	chr14	39498123	39582447	84324	Sec23 homolog A (S. cerevisiae)
PA35625	10483	SEC23B	chr20	18478188	18545059	66871	Sec23 homolog B (S. cerevisiae)
PA134964657	11196	SEC23IP	chr10	121642085	121707170	65085	SEC23 interacting protein
PA35626	10802	SEC24A	chr5	133974472	134066601	92129	SEC24 family member A
PA35627	10427	SEC24B	chr4	110344969	110464615	119646	SEC24 family member B
PA35628	9632	SEC24C	chr10	75494039	75534933	40894	SEC24 family member C
PA35629	9871	SEC24D	chr4	119640978	119769838	128860	SEC24 family member D
PA162402737	22872	SEC31A	chr4	83736814	83822419	85605	SEC31 homolog A (S. cerevisiae)
PA162402792	25956	SEC31B	chr10	102243397	102289711	46314	SEC31 homolog B (S. cerevisiae)
PA134901772	29927	SEC61A1	chr3	127760402	127793526	33124	Sec61 alpha 1 subunit (S. cerevisiae)
PA134861382	55176	SEC61A2	chr10	12161640	12214957	53317	Sec61 alpha 2 subunit (S. cerevisiae)
PA134888963	10952	SEC61B	chr9	101974570	101995901	21331	Sec61 beta subunit
PA134939045	23480	SEC61G	chr7	54816940	54836939	19999	Sec61 gamma subunit
PA162402849	7095	SEC62	chr3	169674580	169719161	44581	SEC62 homolog (S. cerevisiae)
PA134936990	11231	SEC63	chr6	108185960	108289482	103522	SEC63 homolog (S. cerevisiae)
PA134863749	79048	SECISBP2	chr9	91923394	91977561	54167	SECIS binding protein 2
PA164725649	9728	SECISBP2L	chr15	49277835	49348760	70925	SECIS binding protein 2-like
PA35630	6398	SECTM1	chr17	80275900	80301921	26021	secreted and transmembrane 1
PA134912135	81929	SEH1L	chr18	12937983	12990536	52553	SEH1-like (S. cerevisiae)
PA35639	6400	SEL1L	chr14	81934891	82010205	75314	sel-1 suppressor of lin-12-like (C. elegans)
PA162402870	80343	SEL1L2	chr20	13826635	13985979	159344	sel-1 suppressor of lin-12-like 2 (C. elegans)
PA165664479	23231	SEL1L3	chr4	25746049	25874647	128598	sel-1 suppressor of lin-12-like 3 (C. elegans)
PA35640	6401	SELE	chr1	169688781	169713220	24439	selectin E
PA35641	8991	SELENBP1	chr1	151333778	151355210	21432	selenium binding protein 1
PA35642	6402	SELL	chr1	169656806	169690843	34037	selectin L
PA35643	6403	SELP	chr1	169555087	169609377	54290	selectin P (granule membrane protein 140kDa, antigen CD62)
PA35644	6404	SELPLG	chr12	109012671	109037735	25064	selectin P ligand
PA35645	10371	SEMA3A	chr7	83584659	84132040	547381	sema domain, immunoglobulin domain (Ig), short basic domain, secreted, (semaphorin) 3A
PA35646	7869	SEMA3B	chr3	50295040	50317573	22533	sema domain, immunoglobulin domain (Ig), short basic domain, secreted, (semaphorin) 3B
PA35647	10512	SEMA3C	chr7	80368854	80561695	192841	sema domain, immunoglobulin domain (Ig), short basic domain, secreted, (semaphorin) 3C
PA35648	223117	SEMA3D	chr7	84621508	84826171	204663	sema domain, immunoglobulin domain (Ig), short basic domain, secreted, (semaphorin) 3D
PA35649	9723	SEMA3E	chr7	82990222	83288479	298257	sema domain, immunoglobulin domain (Ig), short basic domain, secreted, (semaphorin) 3E
PA35650	6405	SEMA3F	chr3	50182562	50229508	46946	sema domain, immunoglobulin domain (Ig), short basic domain, secreted, (semaphorin) 3F
PA142670937	56920	SEMA3G	chr3	52464268	52489112	24844	sema domain, immunoglobulin domain (Ig), short basic domain, secreted, (semaphorin) 3G
PA35651	64218	SEMA4A	chr1	156107145	156150542	43397	sema domain, immunoglobulin domain (Ig), transmembrane domain (TM) and short cytoplasmic domain, (semaphorin) 4A
PA35652	10509	SEMA4B	chr15	90717985	90775897	57912	sema domain, immunoglobulin domain (Ig), transmembrane domain (TM) and short cytoplasmic domain, (semaphorin) 4B
PA35653	54910	SEMA4C	chr2	97522473	97546680	24207	sema domain, immunoglobulin domain (Ig), transmembrane domain (TM) and short cytoplasmic domain, (semaphorin) 4C
PA35654	10507	SEMA4D	chr9	91972706	92122906	150200	sema domain, immunoglobulin domain (Ig), transmembrane domain (TM) and short cytoplasmic domain, (semaphorin) 4D
PA35656	10505	SEMA4F	chr2	74871355	74913981	42626	sema domain, immunoglobulin domain (Ig), transmembrane domain (TM) and short cytoplasmic domain, (semaphorin) 4F
PA35657	57715	SEMA4G	chr10	102719254	102748373	29119	sema domain, immunoglobulin domain (Ig), transmembrane domain (TM) and short cytoplasmic domain, (semaphorin) 4G
PA35658	9037	SEMA5A	chr5	9032138	9556233	524095	sema domain, seven thrombospondin repeats (type 1 and type 1-like), transmembrane domain (TM) and short cytoplasmic domain, (semaphorin) 5A
PA35659	54437	SEMA5B	chr3	122625040	122757452	132412	sema domain, seven thrombospondin repeats (type 1 and type 1-like), transmembrane domain (TM) and short cytoplasmic domain, (semaphorin) 5B
PA35660	57556	SEMA6A	chr5	115776251	115920551	144300	sema domain, transmembrane domain (TM), and cytoplasmic domain, (semaphorin) 6A
PA35661	10501	SEMA6B	chr19	4539600	4569771	30171	sema domain, transmembrane domain (TM), and cytoplasmic domain, (semaphorin) 6B
PA35662	10500	SEMA6C	chr1	151101161	151129146	27985	sema domain, transmembrane domain (TM), and cytoplasmic domain, (semaphorin) 6C
PA134951035	80031	SEMA6D	chr15	47466403	48069420	603017	sema domain, transmembrane domain (TM), and cytoplasmic domain, (semaphorin) 6D
PA35663	8482	SEMA7A	chr15	74698630	74736299	37669	semaphorin 7A, GPI membrane anchor (John Milton Hagen blood group)
PA35664	6406	SEMG1	chr20	43825605	43841414	15809	semenogelin I
PA35665	6407	SEMG2	chr20	43840010	43856099	16089	semenogelin II
PA134947038	29843	SENP1	chr12	48433681	48510091	76410	SUMO1/sentrin specific peptidase 1
PA134955185	59343	SENP2	chr3	185290284	185351889	61605	SUMO1/sentrin/SMT3 specific peptidase 2
PA134933213	26168	SENP3	chr17	7455309	7478287	22978	SUMO1/sentrin/SMT3 specific peptidase 3
PA134917083	205564	SENP5	chr3	196584727	196664585	79858	SUMO1/sentrin specific peptidase 5
PA134893291	26054	SENP6	chr6	76301596	76430997	129401	SUMO1/sentrin specific peptidase 6
PA134925171	57337	SENP7	chr3	101040049	101242085	202036	SUMO1/sentrin specific peptidase 7
PA134866772	123228	SENP8	chr15	72396599	72436311	39712	SUMO/sentrin specific peptidase family member 8
PA134905215	22929	SEPHS1	chr10	13356428	13400298	43870	selenophosphate synthetase 1
PA134868765	22928	SEPHS2	chr16	30451952	30467224	15272	selenophosphate synthetase 2
PA38079	57190	SEPN1	chr1	26116667	26147713	31046	selenoprotein N, 1
PA35672	6414	SEPP1	chr5	42796982	42822024	25042	selenoprotein P, plasma, 1
PA162402915	51091	SEPSECS	chr4	25118627	25172204	53577	Sep (O-phosphoserine) tRNA:Sec (selenocysteine) tRNA synthase
PA24354	1731	SEPT1	chr16	30386454	30404171	17717	septin 1
PA134918683	151011	SEPT10	chr2	110297372	110381783	84411	septin 10
PA128394688	55752	SEPT11	chr4	77860895	77964307	103412	septin 11
PA162402916	124404	SEPT12	chr16	4824615	4848522	23907	septin 12
PA162402917	346288	SEPT14	chr7	55858237	55940482	82245	septin 14
PA31535	4735	SEPT2	chr2	242244723	242296442	51719	septin 2
PA24355	55964	SEPT3	chr22	42362855	42397225	34370	septin 3
PA33487	5414	SEPT4	chr17	56594611	56628179	33568	septin 4
PA33486	5413	SEPT5	chr22	19691987	19713845	21858	septin 5
PA134941944	23157	SEPT6	chrX	118746687	118837333	90646	septin 6
PA26253	989	SEPT7	chr7	35830596	35949715	119119	septin 7
PA134879270	23176	SEPT8	chr5	132083509	132123976	40467	septin 8
PA31132	10801	SEPT9	chr17	75267492	75499678	232186	septin 9
PA35673	6415	SEPW1	chr19	48271842	48290939	19097	selenoprotein W, 1
PA134951844	84947	SERAC1	chr6	158527536	158599312	71776	serine active site containing 1
PA413	26135	SERBP1	chr1	67870493	67906123	35630	SERPINE1 mRNA binding protein 1
PA35675	8293	SERF1A	chr5	70186490	70217357	30867	small EDRK-rich factor 1A (telomeric)
PA35676	728492	SERF1B	chr5	69311078	69341935	30857	small EDRK-rich factor 1B (centromeric)
PA35677	10169	SERF2	chr15	44059294	44091287	31993	small EDRK-rich factor 2
PA143485610	26297	SERGEF	chr11	17806595	18044709	238114	secretion regulating guanine nucleotide exchange factor
PA142670935	253190	SERHL2	chr22	42939858	42973703	33845	serine hydrolase-like 2
PA134973249	57515	SERINC1	chr6	122761493	122803051	41558	serine incorporator 1
PA134933002	347735	SERINC2	chr1	31872412	31910527	38115	serine incorporator 2
PA36418	10955	SERINC3	chr20	43121864	43160726	38862	serine incorporator 3
PA142670936	619189	SERINC4	chr15	44083372	44102295	18923	serine incorporator 4
PA38698	256987	SERINC5	chr5	79404050	79561898	157848	serine incorporator 5
PA162402942	27230	SERP1	chr3	150256780	150274428	17648	stress-associated endoplasmic reticulum protein 1
PA162402953	387923	SERP2	chr13	44937978	44974850	36872	stress-associated endoplasmic reticulum protein family member 2
PA35509	5265	SERPINA1	chr14	94840084	94867029	26945	serpin peptidase inhibitor, clade A (alpha-1 antiproteinase, antitrypsin), member 1
PA38078	51156	SERPINA10	chr14	94746648	94769608	22960	serpin peptidase inhibitor, clade A (alpha-1 antiproteinase, antitrypsin), member 10
PA134988362	256394	SERPINA11	chr14	94905801	94929122	23321	serpin peptidase inhibitor, clade A (alpha-1 antiproteinase, antitrypsin), member 11
PA134863157	145264	SERPINA12	chr14	94950611	94994181	43570	serpin peptidase inhibitor, clade A (alpha-1 antiproteinase, antitrypsin), member 12
PA35020	12	SERPINA3	chr14	95068639	95093395	24756	serpin peptidase inhibitor, clade A (alpha-1 antiproteinase, antitrypsin), member 3
PA35514	5267	SERPINA4	chr14	95017779	95039243	21464	serpin peptidase inhibitor, clade A (alpha-1 antiproteinase, antitrypsin), member 4
PA35505	5104	SERPINA5	chr14	95037706	95062457	24751	serpin peptidase inhibitor, clade A (alpha-1 antiproteinase, antitrypsin), member 5
PA35033	866	SERPINA6	chr14	94767585	94799688	32103	serpin peptidase inhibitor, clade A (alpha-1 antiproteinase, antitrypsin), member 6
PA36347	6906	SERPINA7	chrX	105274190	105292718	18528	serpin peptidase inhibitor, clade A (alpha-1 antiproteinase, antitrypsin), member 7
PA38077	327657	SERPINA9	chr14	94926058	94952670	26612	serpin peptidase inhibitor, clade A (alpha-1 antiproteinase, antitrypsin), member 9
PA35046	1992	SERPINB1	chr6	2829566	2852283	22717	serpin peptidase inhibitor, clade B (ovalbumin), member 1
PA35510	5273	SERPINB10	chr18	61565224	61605948	40724	serpin peptidase inhibitor, clade B (ovalbumin), member 10
PA37860	89778	SERPINB11	chr18	61360194	61394123	33929	serpin peptidase inhibitor, clade B (ovalbumin), member 11 (gene/pseudogene)
PA37859	89777	SERPINB12	chr18	61213393	61237336	23943	serpin peptidase inhibitor, clade B (ovalbumin), member 12
PA35512	5275	SERPINB13	chr18	61244431	61269433	25002	serpin peptidase inhibitor, clade B (ovalbumin), member 13
PA35500	5055	SERPINB2	chr18	61544939	61574124	29185	serpin peptidase inhibitor, clade B (ovalbumin), member 2
PA35538	6317	SERPINB3	chr18	61319431	61339259	19828	serpin peptidase inhibitor, clade B (ovalbumin), member 3
PA35539	6318	SERPINB4	chr18	61301493	61321502	20009	serpin peptidase inhibitor, clade B (ovalbumin), member 4
PA35515	5268	SERPINB5	chr18	61134144	61175318	41174	serpin peptidase inhibitor, clade B (ovalbumin), member 5
PA35516	5269	SERPINB6	chr6	2945393	2982399	37006	serpin peptidase inhibitor, clade B (ovalbumin), member 6
PA37825	8710	SERPINB7	chr18	61410281	61475610	65329	serpin peptidase inhibitor, clade B (ovalbumin), member 7
PA35517	5271	SERPINB8	chr18	61627263	61659608	32345	serpin peptidase inhibitor, clade B (ovalbumin), member 8
PA35519	5272	SERPINB9	chr6	2884499	2913546	29047	serpin peptidase inhibitor, clade B (ovalbumin), member 9
PA35026	462	SERPINC1	chr1	173869938	173896516	26578	serpin peptidase inhibitor, clade C (antithrombin), member 1
PA35053	3053	SERPIND1	chr22	21118383	21145008	26625	serpin peptidase inhibitor, clade D (heparin cofactor), member 1
PA261	5054	SERPINE1	chr7	100760370	100785547	25177	serpin peptidase inhibitor, clade E (nexin, plasminogen activator inhibitor type 1), member 1
PA269	5270	SERPINE2	chr2	224836765	224914036	77271	serpin peptidase inhibitor, clade E (nexin, plasminogen activator inhibitor type 1), member 2
PA164725650	647174	SERPINE3	chr13	51905168	51942555	37387	serpin peptidase inhibitor, clade E (nexin, plasminogen activator inhibitor type 1), member 3
PA35508	5176	SERPINF1	chr17	1655259	1683859	28600	serpin peptidase inhibitor, clade F (alpha-2 antiplasmin, pigment epithelium derived factor), member 1
PA35522	5345	SERPINF2	chr17	1636015	1661562	25547	serpin peptidase inhibitor, clade F (alpha-2 antiplasmin, pigment epithelium derived factor), member 2
PA35029	710	SERPING1	chr11	57355027	57385326	30299	serpin peptidase inhibitor, clade G (C1 inhibitor), member 1
PA35034	871	SERPINH1	chr11	75263101	75286849	23748	serpin peptidase inhibitor, clade H (heat shock protein 47), member 1, (collagen binding protein 1)
PA35511	5274	SERPINI1	chr3	167443432	167546357	102925	serpin peptidase inhibitor, clade I (neuroserpin), member 1
PA35513	5276	SERPINI2	chr3	167156577	167206732	50155	serpin peptidase inhibitor, clade I (pancpin), member 2
PA134957023	29950	SERTAD1	chr19	40925408	40941932	16524	SERTA domain containing 1
PA134948884	9792	SERTAD2	chr2	64855755	64988048	132293	SERTA domain containing 2
PA134941720	29946	SERTAD3	chr19	40943748	40960282	16534	SERTA domain containing 3
PA134897438	56256	SERTAD4	chr1	210396195	210423252	27057	SERTA domain containing 4
PA162378085	400120	SERTM1	chr13	37238049	37274976	36927	serine-rich and transmembrane domain containing 1
PA134927596	27244	SESN1	chr6	109304640	109425708	121068	sestrin 1
PA134882791	83667	SESN2	chr1	28575963	28612002	36039	sestrin 2
PA134914983	143686	SESN3	chr11	94895677	94975705	80028	sestrin 3
PA38534	91404	SESTD1	chr2	179963419	180139350	175931	SEC14 and spectrin domains 1
PA35678	6418	SET	chr9	131435934	131461675	25741	SET nuclear proto-oncogene
PA37982	26040	SETBP1	chr18	42248849	42651475	402626	SET binding protein 1
PA128394556	9739	SETD1A	chr16	30958615	30998985	40370	SET domain containing 1A
PA143485611	23067	SETD1B	chr12	122231879	122273562	41683	SET domain containing 1B
PA143485612	29072	SETD2	chr3	47054898	47215467	160569	SET domain containing 2
PA134883013	84193	SETD3	chr14	99861083	99957228	96145	SET domain containing 3
PA25814	54093	SETD4	chr21	37403839	37442869	39030	SET domain containing 4
PA143485613	55209	SETD5	chr3	9429384	9522838	93454	SET domain containing 5
PA143485614	79918	SETD6	chr16	58539383	58557431	18048	SET domain containing 6
PA143485615	80854	SETD7	chr4	140424192	140487577	63385	SET domain containing (lysine methyltransferase) 7
PA143485616	387893	SETD8	chr12	123858704	123896900	38196	SET domain containing (lysine methyltransferase) 8
PA162380099	133383	SETD9	chr5	56195087	56224359	29272	SET domain containing 9
PA35679	9869	SETDB1	chr1	150888815	150940389	51574	SET domain, bifurcated 1
PA134956285	83852	SETDB2	chr13	50008429	50072139	63710	SET domain, bifurcated 2
PA35680	6419	SETMAR	chr3	4334988	4361949	26961	SET domain and mariner transposase fusion gene
PA24751	23064	SETX	chr9	135133827	135242113	108286	senataxin
PA38065	124925	SEZ6	chr17	27278923	27343458	64535	seizure related 6 homolog (mouse)
PA35681	23544	SEZ6L	chr22	26555440	26782563	227123	seizure related 6 homolog (mouse)-like
PA134924025	26470	SEZ6L2	chr16	29879480	29920585	41105	seizure related 6 homolog (mouse)-like 2
PA37533	7536	SF1	chr11	64529076	64556515	27439	splicing factor 1
PA35683	10291	SF3A1	chr22	30724977	30762931	37954	splicing factor 3a, subunit 1, 120kDa
PA35684	8175	SF3A2	chr19	2226816	2251678	24862	splicing factor 3a, subunit 2, 66kDa
PA35685	10946	SF3A3	chr1	38419647	38466019	46372	splicing factor 3a, subunit 3, 60kDa
PA35686	23451	SF3B1	chr2	198253698	198309815	56117	splicing factor 3b, subunit 1, 155kDa
PA35687	10992	SF3B2	chr11	65809264	65839382	30118	splicing factor 3b, subunit 2, 145kDa
PA35688	23450	SF3B3	chr16	70547691	70614571	66880	splicing factor 3b, subunit 3, 130kDa
PA35689	10262	SF3B4	chr1	149892209	149911449	19240	splicing factor 3b, subunit 4, 49kDa
PA134951632	83443	SF3B5	chr6	144413018	144426754	13736	splicing factor 3b, subunit 5, 10kDa
PA142670930	9814	SFI1	chr22	31882125	32017537	135412	Sfi1 homolog, spindle assembly associated (yeast)
PA134898464	51460	SFMBT1	chr3	52930221	53090089	159868	Scm-like with four mbt domains 1
PA134866013	57713	SFMBT2	chr10	7197586	7463448	265862	Scm-like with four mbt domains 2
PA177	2810	SFN	chr1	27179633	27193947	14314	stratifin
PA35690	6421	SFPQ	chr1	35638981	35668766	29785	splicing factor proline/glutamine-rich
PA134989928	119392	SFR1	chr10	105870059	105889143	19084	SWI5-dependent recombination repair 1
PA35692	6422	SFRP1	chr8	41116476	41176990	60514	secreted frizzled-related protein 1
PA35693	6423	SFRP2	chr4	154698742	154720228	21486	secreted frizzled-related protein 2
PA35694	6424	SFRP4	chr7	37942534	37966525	23991	secreted frizzled-related protein 4
PA35695	6425	SFRP5	chr10	99523508	99541756	18248	secreted frizzled-related protein 5
PA35706	6433	SFSWAP	chr12	132185632	132287283	101651	splicing factor, suppressor of white-apricot family
PA134962126	113402	SFT2D1	chr6	166730516	166765991	35475	SFT2 domain containing 1
PA142670928	375035	SFT2D2	chr1	168185255	168215088	29833	SFT2 domain containing 2
PA142670929	84826	SFT2D3	chr2	128448597	128464407	15810	SFT2 domain containing 3
PA164725669	389376	SFTA2	chr6	30896127	30909952	13825	surfactant associated 2
PA164725680	253970	SFTA3	chr14	36939493	36992990	53497	surfactant associated 3
PA35710	653509	SFTPA1	chr10	81360651	81378199	17548	surfactant protein A1
PA35711	729238	SFTPA2	chr10	81312608	81330177	17569	surfactant protein A2
PA35713	6439	SFTPB	chr2	85881440	85905864	24424	surfactant protein B
PA35714	6440	SFTPC	chr8	22004853	22024992	20139	surfactant protein C
PA35715	6441	SFTPD	chr10	81694496	81718861	24365	surfactant protein D
PA38090	94081	SFXN1	chr5	174895514	174959745	64231	sideroflexin 1
PA38091	118980	SFXN2	chr10	104464298	104501947	37649	sideroflexin 2
PA38092	81855	SFXN3	chr10	102780996	102803998	23002	sideroflexin 3
PA38093	119559	SFXN4	chr10	120897425	120935221	37796	sideroflexin 4
PA38088	94097	SFXN5	chr2	73166165	73308965	142800	sideroflexin 5
PA35716	6442	SGCA	chr17	48233240	48256293	23053	sarcoglycan, alpha (50kDa dystrophin-associated glycoprotein)
PA35717	6443	SGCB	chr4	52882752	52914485	31733	sarcoglycan, beta (43kDa dystrophin-associated glycoprotein)
PA35718	6444	SGCD	chr5	155452147	156197799	745652	sarcoglycan, delta (35kDa dystrophin-associated glycoprotein)
PA35719	8910	SGCE	chr7	94211536	94295521	83985	sarcoglycan, epsilon
PA35720	6445	SGCG	chr13	23745060	23902304	157244	sarcoglycan, gamma (35kDa dystrophin-associated glycoprotein)
PA38378	137868	SGCZ	chr8	13944373	15105792	1161419	sarcoglycan, zeta
PA134909202	84251	SGIP1	chr1	66989066	67213768	224702	SH3-domain GRB2-like (endophilin) interacting protein 1
PA162403013	6446	SGK1	chr6	134487384	134649196	161812	serum/glucocorticoid regulated kinase 1
PA37824	10110	SGK2	chr20	42177566	42217317	39751	serum/glucocorticoid regulated kinase 2
PA35722	23678	SGK3	chr8	67614653	67777257	162604	serum/glucocorticoid regulated kinase family, member 3
PA162403042	259230	SGMS1	chr10	52062345	52393737	331392	sphingomyelin synthase 1
PA162403069	166929	SGMS2	chr4	108735721	108839203	103482	sphingomyelin synthase 2
PA134988556	151648	SGOL1	chr3	20199085	20237724	38639	shugoshin-like 1 (S. pombe)
PA134901462	151246	SGOL2	chr2	201380865	201451818	70953	shugoshin-like 2 (S. pombe)
PA35725	8879	SGPL1	chr10	72565704	72643946	78242	sphingosine-1-phosphate lyase 1
PA134884424	81537	SGPP1	chr14	64147934	64204756	56822	sphingosine-1-phosphate phosphatase 1
PA134956234	130367	SGPP2	chr2	223278771	223430342	151571	sphingosine-1-phosphate phosphatase 2
PA35726	6448	SGSH	chr17	78177515	78204199	26684	N-sulfoglucosamine sulfohydrolase
PA162403086	129049	SGSM1	chr22	25192136	25325813	133677	small G protein signaling modulator 1
PA162403141	9905	SGSM2	chr17	2230806	2287353	56547	small G protein signaling modulator 2
PA162403194	27352	SGSM3	chr22	40756571	40809293	52722	small G protein signaling modulator 3
PA35727	6449	SGTA	chr19	2751711	2793363	41652	small glutamine-rich tetratricopeptide repeat (TPR)-containing, alpha
PA134957805	54557	SGTB	chr5	64958755	65028648	69893	small glutamine-rich tetratricopeptide repeat (TPR)-containing, beta
PA145148084	25970	SH2B1	chr16	28862939	28888534	25595	SH2B adaptor protein 1
PA145148106	10603	SH2B2	chr7	101918405	101965178	46773	SH2B adaptor protein 2
PA145148124	10019	SH2B3	chr12	111833720	111892427	58707	SH2B adaptor protein 3
PA35728	4068	SH2D1A	chrX	123470132	123510010	39878	SH2 domain containing 1A
PA142670926	117157	SH2D1B	chr1	162362056	162391928	29872	SH2 domain containing 1B
PA35729	9047	SH2D2A	chr1	156773035	156796640	23605	SH2 domain containing 2A
PA38192	10045	SH2D3A	chr19	6749171	6777531	28360	SH2 domain containing 3A
PA38191	10044	SH2D3C	chr9	130497596	130551048	53452	SH2 domain containing 3C
PA134891945	63898	SH2D4A	chr8	19161081	19256729	95648	SH2 domain containing 4A
PA134943660	387694	SH2D4B	chr10	82287658	82409316	121658	SH2 domain containing 4B
PA142670927	400745	SH2D5	chr1	21043225	21069133	25908	SH2 domain containing 5
PA162403243	284948	SH2D6	chr2	85650108	85667180	17072	SH2 domain containing 6
PA164725681	646892	SH2D7	chr15	78374927	78399393	24466	SH2 domain containing 7
PA35730	6450	SH3BGR	chr21	40807797	40890433	82636	SH3 domain binding glutamate-rich protein
PA35731	6451	SH3BGRL	chrX	80447303	80557046	109743	SH3 domain binding glutamate-rich protein like
PA37978	83699	SH3BGRL2	chr6	80331000	80416369	85369	SH3 domain binding glutamate-rich protein like 2
PA37979	83442	SH3BGRL3	chr1	26596213	26611013	14800	SH3 domain binding glutamate-rich protein like 3
PA35732	23616	SH3BP1	chr22	38020661	38055119	34458	SH3-domain binding protein 1
PA35733	6452	SH3BP2	chr4	2784750	2845823	61073	SH3-domain binding protein 2
PA35734	23677	SH3BP4	chr2	235850628	235967358	116730	SH3-domain binding protein 4
PA35735	9467	SH3BP5	chr3	15292860	15392901	100041	SH3-domain binding protein 5 (BTK-associated)
PA142670923	80851	SH3BP5L	chr1	249101645	249130154	28509	SH3-binding domain protein 5-like
PA162403244	152503	SH3D19	chr4	152038433	152256797	218364	SH3 domain containing 19
PA142672497	79729	SH3D21	chr1	36761889	36796544	34655	SH3 domain containing 21
PA35736	6455	SH3GL1	chr19	4357364	4410565	53201	SH3-domain GRB2-like 1
PA35737	6456	SH3GL2	chr9	17568953	17800122	231169	SH3-domain GRB2-like 2
PA35738	6457	SH3GL3	chr15	84106091	84290495	184404	SH3-domain GRB2-like 3
PA35739	51100	SH3GLB1	chr1	87160253	87216867	56614	SH3-domain GRB2-like endophilin B1
PA35740	56904	SH3GLB2	chr9	131767313	131800604	33291	SH3-domain GRB2-like endophilin B2
PA37822	30011	SH3KBP1	chrX	19549083	19915744	366661	SH3-domain kinase binding protein 1
PA134956816	9644	SH3PXD2A	chr10	105350784	105625195	274411	SH3 and PX domains 2A
PA134864119	285590	SH3PXD2B	chr5	171749185	171891527	142342	SH3 and PX domains 2B
PA134915904	57630	SH3RF1	chr4	170012407	170202249	189842	SH3 domain containing ring finger 1
PA134944983	153769	SH3RF2	chr5	145306126	145461680	155554	SH3 domain containing ring finger 2
PA162403291	344558	SH3RF3	chr2	110249067	110265207	16140	SH3 domain containing ring finger 3
PA128394666	54436	SH3TC1	chr4	8191060	8245830	54770	SH3 domain and tetratricopeptide repeats 1
PA134951912	79628	SH3TC2	chr5	148358713	148452737	94024	SH3 domain and tetratricopeptide repeats 2
PA128394643	26751	SH3YL1	chr2	215136	274820	59684	SH3 and SYLF domain containing 1
PA37965	50944	SHANK1	chr19	51160052	51230195	70143	SH3 and multiple ankyrin repeat domains 1
PA37867	22941	SHANK2	chr11	70310961	70945808	634847	SH3 and multiple ankyrin repeat domains 2
PA37866	85358	SHANK3	chr22	51103070	51174640	71570	SH3 and multiple ankyrin repeat domains 3
PA142670925	81858	SHARPIN	chr8	145150536	145169140	18604	SHANK-associated RH domain interactor
PA35744	6461	SHB	chr9	37912895	38079210	166315	Src homology 2 domain containing adaptor protein B
PA35745	6462	SHBG	chr17	7507382	7539700	32318	sex hormone-binding globulin
PA35746	6464	SHC1	chr1	154931774	154956959	25185	SHC (Src homology 2 domain containing) transforming protein 1
PA134971076	25759	SHC2	chr19	413583	470996	57413	SHC (Src homology 2 domain containing) transforming protein 2
PA134913435	53358	SHC3	chr9	91617686	91803682	185996	SHC (Src homology 2 domain containing) transforming protein 3
PA142670917	399694	SHC4	chr15	49112934	49265641	152707	SHC (Src homology 2 domain containing) family, member 4
PA134931125	79801	SHCBP1	chr16	46611466	46665311	53845	SHC SH2-domain binding protein 1
PA142670918	56961	SHD	chr19	4268598	4293720	25122	Src homology 2 domain containing transforming protein D
PA142670919	126669	SHE	chr1	154439118	154484786	45668	Src homology 2 domain containing E
PA142670920	90525	SHF	chr15	45456412	45503373	46961	Src homology 2 domain containing F
PA35749	7979	SHFM1	chr7	96315079	96349203	34124	split hand/foot malformation (ectrodactyly) type 1
PA35752	6469	SHH	chr7	155592558	155614967	22409	sonic hedgehog
PA162403292	387914	SHISA2	chr13	26615735	26635198	19463	shisa family member 2
PA162403293	152573	SHISA3	chr4	42389856	42407504	17648	shisa family member 3
PA162403294	149345	SHISA4	chr1	201847797	201864715	16918	shisa family member 4
PA162403295	51246	SHISA5	chr3	48506197	48552259	46062	shisa family member 5
PA165432740	388336	SHISA6	chr17	11134740	11470380	335640	shisa family member 6
PA165394299	729956	SHISA7	chr19	55937105	55964230	27125	shisa family member 7
PA165378367	440829	SHISA8	chr22	42302558	42320671	18113	shisa family member 8
PA165450677	729993	SHISA9	chr16	12985477	13337273	351796	shisa family member 9
PA134954640	92799	SHKBP1	chr19	41072757	41100305	27548	SH3KBP1 binding protein 1
PA35753	6470	SHMT1	chr17	18228187	18276856	48669	serine hydroxymethyltransferase 1 (soluble)
PA35755	6472	SHMT2	chr12	57613356	57631718	18362	serine hydroxymethyltransferase 2 (mitochondrial)
PA37960	8036	SHOC2	chr10	112669301	112776425	107124	soc-2 suppressor of clear homolog (C. elegans)
PA134978644	6473	SHOX	chrY	525079	573146	48067	short stature homeobox
PA35756	6474	SHOX2	chr3	157810800	157833952	23152	short stature homeobox 2
PA162403312	23729	SHPK	chr17	3508556	3549616	41060	sedoheptulokinase
PA134880315	257218	SHPRH	chr6	146202943	146295421	92478	SNF2 histone linker PHD RING helicase, E3 ubiquitin protein ligase
PA142670921	55164	SHQ1	chr3	72795426	72907631	112205	SHQ1, H/ACA ribonucleoprotein assembly factor
PA147357345	134549	SHROOM1	chr5	132154833	132176655	21822	shroom family member 1
PA24916	357	SHROOM2	chrX	9744496	9920585	176089	shroom family member 2
PA147357295	57619	SHROOM3	chr4	77346253	77707406	361153	shroom family member 3
PA147357321	57477	SHROOM4	chrX	50331642	50567044	235402	shroom family member 4
PA35758	6476	SI	chr3	164693686	164806283	112597	sucrase-isomaltase (alpha-glucosidase)
PA142670922	54414	SIAE	chr11	124502685	124556199	53514	sialic acid acetylesterase
PA35759	6477	SIAH1	chr16	48391442	48429229	37787	siah E3 ubiquitin protein ligase 1
PA35760	6478	SIAH2	chr3	150455910	150491263	35353	siah E3 ubiquitin protein ligase 2
PA164725697	283514	SIAH3	chr13	46351405	46435846	84441	siah E3 ubiquitin protein ligase family member 3
PA134923837	54847	SIDT1	chr3	113241218	113351422	110204	SID1 transmembrane family, member 1
PA134910333	51092	SIDT2	chr11	117039626	117071161	31535	SID1 transmembrane family, member 2
PA142670915	59307	SIGIRR	chr11	402716	427454	24738	single immunoglobulin and toll-interleukin 1 receptor (TIR) domain
PA35976	6614	SIGLEC1	chr20	3664617	3703213	38596	sialic acid binding Ig-like lectin 1, sialoadhesin
PA38004	89790	SIGLEC10	chr19	51910275	51931057	20782	sialic acid binding Ig-like lectin 10
PA38005	114132	SIGLEC11	chr19	50449250	50474439	25189	sialic acid binding Ig-like lectin 11
PA37966	89858	SIGLEC12	chr19	51991613	52015043	23430	sialic acid binding Ig-like lectin 12 (gene/pseudogene)
PA162403331	100049587	SIGLEC14	chr19	52142806	52160132	17326	sialic acid binding Ig-like lectin 14
PA162403350	284266	SIGLEC15	chr18	43395545	43425521	29976	sialic acid binding Ig-like lectin 15
PA35775	8778	SIGLEC5	chr19	52111756	52143727	31971	sialic acid binding Ig-like lectin 5
PA35776	946	SIGLEC6	chr19	52017951	52045110	27159	sialic acid binding Ig-like lectin 6
PA35777	27036	SIGLEC7	chr19	51635558	51659783	24225	sialic acid binding Ig-like lectin 7
PA35778	27181	SIGLEC8	chr19	51951251	51971708	20457	sialic acid binding Ig-like lectin 8
PA35779	27180	SIGLEC9	chr19	51618137	51642520	24383	sialic acid binding Ig-like lectin 9
PA165393060	284369	SIGLECL1	chr19	51744332	51775582	31250	SIGLEC family like 1
PA164725706	10280	SIGMAR1	chr9	34631719	34647805	16086	sigma non-opioid intracellular receptor 1
PA164725717	150094	SIK1	chr21	44831395	44857002	25607	salt-inducible kinase 1
PA164725750	23235	SIK2	chr11	111463170	111600635	137465	salt-inducible kinase 2
PA165543631	23387	SIK3	chr11	116711118	116979131	268013	SIK family kinase 3
PA165752371	80143	SIKE1	chr1	115309100	115333308	24208	suppressor of IKBKE 1
PA142670916	64374	SIL1	chr5	138279409	138544065	264656	SIL1 nucleotide exchange factor
PA35782	6492	SIM1	chr6	100829891	100922805	92914	single-minded family bHLH transcription factor 1
PA35783	6493	SIM2	chr21	38061991	38125510	63519	single-minded family bHLH transcription factor 2
PA144596506	375484	SIMC1	chr5	175655370	175775992	120622	SUMO-interacting motifs containing 1
PA134993567	25942	SIN3A	chr15	75658720	75758181	99461	SIN3 transcription regulator family member A
PA134909030	23309	SIN3B	chr19	16930209	16994166	63957	SIN3 transcription regulator family member B
PA35785	6494	SIPA1	chr11	65395578	65421391	25813	signal-induced proliferation-associated 1
PA134940118	26037	SIPA1L1	chr14	71778108	72210761	432653	signal-induced proliferation-associated 1 like 1
PA134933243	57568	SIPA1L2	chr1	232530711	232775907	245196	signal-induced proliferation-associated 1 like 2
PA134866783	23094	SIPA1L3	chr19	38387525	38702009	314484	signal-induced proliferation-associated 1 like 3
PA34006	140885	SIRPA	chr20	1864763	1923540	58777	signal-regulatory protein alpha
PA38051	10326	SIRPB1	chr20	1542029	1610720	68691	signal-regulatory protein beta 1
PA164742382	284759	SIRPB2	chr20	1452236	1482233	29997	signal-regulatory protein beta 2
PA34008	128646	SIRPD	chr20	1511897	1549489	37592	signal-regulatory protein delta
PA38034	55423	SIRPG	chr20	1606522	1648425	41903	signal-regulatory protein gamma
PA37935	23411	SIRT1	chr10	69634427	69681147	46720	sirtuin 1
PA35786	22933	SIRT2	chr19	39366195	39400502	34307	sirtuin 2
PA37936	23410	SIRT3	chr11	212030	246362	34332	sirtuin 3
PA37937	23409	SIRT4	chr12	120720002	120754045	34043	sirtuin 4
PA37938	23408	SIRT5	chr6	13564506	13618390	53884	sirtuin 5
PA37939	51548	SIRT6	chr19	4171106	4192596	21490	sirtuin 6
PA37940	51547	SIRT7	chr17	79866815	79886058	19243	sirtuin 7
PA142670914	27240	SIT1	chr9	35646295	35660947	14652	signaling threshold regulating transmembrane adaptor 1
PA162403351	10572	SIVA1	chr14	105209470	105228996	19526	SIVA1, apoptosis-inducing factor
PA35787	6495	SIX1	chr14	61108417	61126155	17738	SIX homeobox 1
PA35788	10736	SIX2	chr2	45229324	45246580	17256	SIX homeobox 2
PA35789	6496	SIX3	chr2	45159037	45176216	17179	SIX homeobox 3
PA35790	51804	SIX4	chr14	61173256	61201039	27783	SIX homeobox 4
PA35791	147912	SIX5	chr19	46265043	46282497	17454	SIX homeobox 5
PA35792	4990	SIX6	chr14	60965938	60981525	15587	SIX homeobox 6
PA165429102	220134	SKA1	chr18	47891392	47923538	32146	spindle and kinetochore associated complex subunit 1
PA165432792	348235	SKA2	chr17	57184308	57242800	58492	spindle and kinetochore associated complex subunit 2
PA165505498	221150	SKA3	chr13	21724734	21760741	36007	spindle and kinetochore associated complex subunit 3
PA162403362	8631	SKAP1	chr17	46207802	46517596	309794	src kinase associated phosphoprotein 1
PA162403393	8935	SKAP2	chr7	26694397	27044862	350465	src kinase associated phosphoprotein 2
PA35796	6497	SKI	chr1	2150134	2244652	94518	SKI proto-oncogene
PA35797	6498	SKIL	chr3	170065473	170117637	52164	SKI-like proto-oncogene
PA35798	6499	SKIV2L	chr6	31916581	31940532	23951	superkiller viralicidic activity 2-like (S. cerevisiae)
PA134901921	23517	SKIV2L2	chr5	54593576	54724409	130833	superkiller viralicidic activity 2-like 2 (S. cerevisiae)
PA165479509	390598	SKOR1	chr15	68102042	68129498	27456	SKI family transcriptional corepressor 1
PA165429121	652991	SKOR2	chr18	44735460	44785554	50094	SKI family transcriptional corepressor 2
PA162403424	6500	SKP1	chr5	133489082	133522724	33642	S-phase kinase-associated protein 1
PA35801	6502	SKP2	chr5	36142091	36187143	45052	S-phase kinase-associated protein 2, E3 ubiquitin protein ligase
PA35802	6503	SLA	chr8	134045973	134125604	79631	Src-like-adaptor
PA38231	84174	SLA2	chr20	35237922	35284619	46697	Src-like-adaptor 2
PA162403440	122060	SLAIN1	chr13	78261989	78341377	79388	SLAIN motif family, member 1
PA162403457	57606	SLAIN2	chr4	48333497	48431218	97721	SLAIN motif family, member 2
PA35803	6504	SLAMF1	chr1	160576891	160627081	50190	signaling lymphocytic activation molecule family member 1
PA134959277	114836	SLAMF6	chr1	160451820	160503052	51232	SLAM family member 6
PA134977110	57823	SLAMF7	chr1	160698865	160727611	28746	SLAM family member 7
PA134983606	56833	SLAMF8	chr1	159786440	159810282	23842	SLAM family member 8
PA134993219	89886	SLAMF9	chr1	159918282	159934044	15762	SLAM family member 9
PA35804	7884	SLBP	chr4	1691527	1724421	32894	stem-loop binding protein
PA317	6554	SLC10A1	chr14	70239552	70274006	34454	solute carrier family 10 (sodium/bile acid cotransporter), member 1
PA318	6555	SLC10A2	chr13	103693348	103729196	35848	solute carrier family 10 (sodium/bile acid cotransporter), member 2
PA134886398	8273	SLC10A3	chrX	153712645	153729002	16357	solute carrier family 10, member 3
PA134941471	201780	SLC10A4	chr4	48475360	48494541	19181	solute carrier family 10, member 4
PA134933839	347051	SLC10A5	chr8	82602891	82617207	14316	solute carrier family 10, member 5
PA142670910	345274	SLC10A6	chr4	87741477	87780416	38939	solute carrier family 10 (sodium/bile acid cotransporter), member 6
PA162403478	84068	SLC10A7	chr4	147172137	147453123	280986	solute carrier family 10, member 7
PA319	6556	SLC11A1	chr2	219236752	219264617	27865	solute carrier family 11 (proton-coupled divalent metal ion transporter), member 1
PA259	4891	SLC11A2	chr12	51370566	51432118	61552	solute carrier family 11 (proton-coupled divalent metal ion transporter), member 2
PA320	6557	SLC12A1	chr15	48488498	48599275	110777	solute carrier family 12 (sodium/potassium/chloride transporter), member 1
PA35806	6558	SLC12A2	chr5	127409483	127528380	118897	solute carrier family 12 (sodium/potassium/chloride transporter), member 2
PA321	6559	SLC12A3	chr16	56889119	56952762	63643	solute carrier family 12 (sodium/chloride transporter), member 3
PA35807	6560	SLC12A4	chr16	67974377	68012597	38220	solute carrier family 12 (potassium/chloride transporter), member 4
PA37814	57468	SLC12A5	chr20	44640329	44691789	51460	solute carrier family 12 (potassium/chloride transporter), member 5
PA35808	9990	SLC12A6	chr15	34519197	34640265	121068	solute carrier family 12 (potassium/chloride transporter), member 6
PA35809	10723	SLC12A7	chr5	1047489	1122172	74683	solute carrier family 12 (potassium/chloride transporter), member 7
PA37991	84561	SLC12A8	chr3	124798480	124941609	143129	solute carrier family 12, member 8
PA134921585	56996	SLC12A9	chr7	100440337	100467634	27297	solute carrier family 12, member 9
PA322	6561	SLC13A1	chr7	122750588	122850025	99437	solute carrier family 13 (sodium/sulfate symporter), member 1
PA382	9058	SLC13A2	chr17	26790664	26827799	37135	solute carrier family 13 (sodium-dependent dicarboxylate transporter), member 2
PA37881	64849	SLC13A3	chr20	45183462	45323124	139662	solute carrier family 13 (sodium-dependent dicarboxylate transporter), member 3
PA38045	26266	SLC13A4	chr7	135362979	135422943	59964	solute carrier family 13 (sodium/sulfate symporter), member 4
PA134950956	284111	SLC13A5	chr17	6585038	6626886	41848	solute carrier family 13 (sodium-dependent citrate transporter), member 5
PA35810	6563	SLC14A1	chr18	43294088	43335485	41397	solute carrier family 14 (urea transporter), member 1 (Kidd blood group)
PA35811	8170	SLC14A2	chr18	42782947	43266072	483125	solute carrier family 14 (urea transporter), member 2
PA323	6564	SLC15A1	chr13	99333055	99414929	81874	solute carrier family 15 (oligopeptide transporter), member 1
PA35812	6565	SLC15A2	chr3	121603171	121666034	62863	solute carrier family 15 (oligopeptide transporter), member 2
PA134919658	51296	SLC15A3	chr11	60701555	60729257	27702	solute carrier family 15 (oligopeptide transporter), member 3
PA134928948	121260	SLC15A4	chr12	129274739	129318541	43802	solute carrier family 15 (oligopeptide transporter), member 4
PA164725785	729025	SLC15A5	chr12	16338419	16440619	102200	solute carrier family 15, member 5
PA35813	6566	SLC16A1	chr1	113451469	113508975	57506	solute carrier family 16 (monocarboxylate transporter), member 1
PA38197	117247	SLC16A10	chr6	111398728	111547608	148880	solute carrier family 16 (aromatic amino acid transporter), member 10
PA134976903	162515	SLC16A11	chr17	6941949	6957242	15293	solute carrier family 16, member 11
PA134969386	387700	SLC16A12	chr10	91187051	91305497	118446	solute carrier family 16, member 12
PA134991782	201232	SLC16A13	chr17	6929394	6946440	17046	solute carrier family 16, member 13
PA134983567	151473	SLC16A14	chr2	230896690	230943715	47025	solute carrier family 16, member 14
PA35814	6567	SLC16A2	chrX	73631328	73756764	125436	solute carrier family 16, member 2 (thyroid hormone transporter)
PA35815	9123	SLC16A3	chr17	80176282	80200375	24093	solute carrier family 16 (monocarboxylate transporter), member 3
PA35816	9122	SLC16A4	chr1	110902473	110943704	41231	solute carrier family 16, member 4
PA35817	9121	SLC16A5	chr17	73073822	73105257	31435	solute carrier family 16 (monocarboxylate transporter), member 5
PA35818	9120	SLC16A6	chr17	66260167	66297405	37238	solute carrier family 16, member 6
PA35819	9194	SLC16A7	chr12	59979821	60186636	206815	solute carrier family 16 (monocarboxylate transporter), member 7
PA38106	23539	SLC16A8	chr22	38471144	38489170	18026	solute carrier family 16 (monocarboxylate transporter), member 8
PA134991247	220963	SLC16A9	chr10	61407522	61479649	72127	solute carrier family 16, member 9
PA35820	6568	SLC17A1	chr6	25780125	25842287	62162	solute carrier family 17 (organic anion transporter), member 1
PA35821	10246	SLC17A2	chr6	25909982	25940954	30972	solute carrier family 17, member 2
PA35822	10786	SLC17A3	chr6	25842328	25884471	42143	solute carrier family 17 (organic anion transporter), member 3
PA35823	10050	SLC17A4	chr6	25744927	25784403	39476	solute carrier family 17, member 4
PA35824	26503	SLC17A5	chr6	74300102	74373737	73635	solute carrier family 17 (acidic sugar transporter), member 5
PA424	57084	SLC17A6	chr11	22349667	22404049	54382	solute carrier family 17 (vesicular glutamate transporter), member 6
PA423	57030	SLC17A7	chr19	49929655	49955617	25962	solute carrier family 17 (vesicular glutamate transporter), member 7
PA223010	246213	SLC17A8	chr12	100740857	100818837	77980	solute carrier family 17 (vesicular glutamate transporter), member 8
PA164725806	63910	SLC17A9	chr20	61573999	61602949	28950	solute carrier family 17 (vesicular nucleotide transporter), member 9
PA324	6570	SLC18A1	chr8	19999366	20050717	51351	solute carrier family 18 (vesicular monoamine transporter), member 1
PA325	6571	SLC18A2	chr10	118990584	119041941	51357	solute carrier family 18 (vesicular monoamine transporter), member 2
PA326	6572	SLC18A3	chr10	50808347	50823766	15419	solute carrier family 18 (vesicular acetylcholine transporter), member 3
PA134992727	116843	SLC18B1	chr6	133087507	133129747	42240	solute carrier family 18, subfamily B, member 1
PA327	6573	SLC19A1	chr21	46931629	46993045	61416	solute carrier family 19 (folate transporter), member 1
PA35825	10560	SLC19A2	chr1	169430147	169465208	35061	solute carrier family 19 (thiamine transporter), member 2
PA38397	80704	SLC19A3	chr2	228546926	228592814	45888	solute carrier family 19 (thiamine transporter), member 3
PA35826	6505	SLC1A1	chr9	4480427	4590469	110042	solute carrier family 1 (neuronal/epithelial high affinity glutamate transporter, system Xag), member 1
PA35827	6506	SLC1A2	chr11	35269752	35451610	181858	solute carrier family 1 (glial high affinity glutamate transporter), member 2
PA35828	6507	SLC1A3	chr5	36596457	36691436	94979	solute carrier family 1 (glial high affinity glutamate transporter), member 3
PA35829	6509	SLC1A4	chr2	65205579	65253999	48420	solute carrier family 1 (glutamate/neutral amino acid transporter), member 4
PA35830	6510	SLC1A5	chr19	47260587	47302280	41693	solute carrier family 1 (neutral amino acid transporter), member 5
PA35831	6511	SLC1A6	chr19	15057845	15131455	73610	solute carrier family 1 (high affinity aspartate/glutamate transporter), member 6
PA35832	6512	SLC1A7	chr1	53549855	53618304	68449	solute carrier family 1 (glutamate transporter), member 7
PA35833	6574	SLC20A1	chr2	113393434	113424402	30968	solute carrier family 20 (phosphate transporter), member 1
PA35834	6575	SLC20A2	chr8	42270980	42407356	136376	solute carrier family 20 (phosphate transporter), member 2
PA329	6580	SLC22A1	chr6	160532821	160583147	50326	solute carrier family 22 (organic cation transporter), member 1
PA38283	387775	SLC22A10	chr11	63047372	63082246	34874	solute carrier family 22, member 10
PA38295	55867	SLC22A11	chr11	64313098	64342002	28904	solute carrier family 22 (organic anion/urate transporter), member 11
PA38478	116085	SLC22A12	chr11	64348113	64372825	24712	solute carrier family 22 (organic anion/urate transporter), member 12
PA32814	9390	SLC22A13	chr3	38297298	38323161	25863	solute carrier family 22 (organic anion/urate transporter), member 13
PA32815	9389	SLC22A14	chr3	38313785	38363064	49279	solute carrier family 22, member 14
PA134870374	55356	SLC22A15	chr1	116509119	116615675	106556	solute carrier family 22, member 15
PA134911502	85413	SLC22A16	chr6	110742890	110807844	64954	solute carrier family 22 (organic cation/carnitine transporter), member 16
PA134879149	51310	SLC22A17	chr14	23812520	23832380	19860	solute carrier family 22, member 17
PA35846	5002	SLC22A18	chr11	2910951	2949476	38525	solute carrier family 22, member 18
PA35847	5003	SLC22A18AS	chr11	2906327	2935175	28848	solute carrier family 22 (organic cation transporter), member 18 antisense
PA331	6582	SLC22A2	chr6	160634794	160689963	55169	solute carrier family 22 (organic cation transporter), member 2
PA162403493	440044	SLC22A20	chr11	64971311	65013579	42268	solute carrier family 22, member 20
PA162403516	63027	SLC22A23	chr6	3266207	3466954	200747	solute carrier family 22, member 23
PA162403543	283238	SLC22A24	chr11	62844412	62921693	77281	solute carrier family 22, member 24
PA162403567	387601	SLC22A25	chr11	62927523	63015415	87892	solute carrier family 22, member 25
PA330	6581	SLC22A3	chr6	160759405	160876613	117208	solute carrier family 22 (organic cation transporter), member 3
PA332	6583	SLC22A4	chr5	131620145	131682899	62754	solute carrier family 22 (organic cation/zwitterion transporter), member 4
PA333	6584	SLC22A5	chr5	131695396	131734306	38910	solute carrier family 22 (organic cation/carnitine transporter), member 5
PA388	9356	SLC22A6	chr11	62741069	62762495	21426	solute carrier family 22 (organic anion transporter), member 6
PA35848	10864	SLC22A7	chr6	43255737	43276276	20539	solute carrier family 22 (organic anion transporter), member 7
PA389	9376	SLC22A8	chr11	62757296	62793317	36021	solute carrier family 22 (organic anion transporter), member 8
PA38102	114571	SLC22A9	chr11	63127142	63180731	53589	solute carrier family 22 (organic anion transporter), member 9
PA35850	9963	SLC23A1	chr5	138699885	138730632	30747	solute carrier family 23 (ascorbic acid transporter), member 1
PA35849	9962	SLC23A2	chr20	4830002	5000939	170937	solute carrier family 23 (ascorbic acid transporter), member 2
PA134932069	151295	SLC23A3	chr2	220023181	220045549	22368	solute carrier family 23, member 3
PA35851	9187	SLC24A1	chr15	65893618	65956334	62716	solute carrier family 24 (sodium/potassium/calcium exchanger), member 1
PA35852	25769	SLC24A2	chr9	19504450	19799059	294609	solute carrier family 24 (sodium/potassium/calcium exchanger), member 2
PA35853	57419	SLC24A3	chr20	19183290	19706541	523251	solute carrier family 24 (sodium/potassium/calcium exchanger), member 3
PA35854	123041	SLC24A4	chr14	92778925	92970825	191900	solute carrier family 24 (sodium/potassium/calcium exchanger), member 4
PA134868972	283652	SLC24A5	chr15	48403169	48437926	34757	solute carrier family 24 (sodium/potassium/calcium exchanger), member 5
PA35855	6576	SLC25A1	chr22	19160088	19176338	16250	solute carrier family 25 (mitochondrial carrier; citrate transporter), member 1
PA35856	1468	SLC25A10	chr17	79669266	79691046	21780	solute carrier family 25 (mitochondrial carrier; dicarboxylate transporter), member 10
PA35857	8402	SLC25A11	chr17	4837425	4853462	16037	solute carrier family 25 (mitochondrial carrier; oxoglutarate carrier), member 11
PA35858	8604	SLC25A12	chr2	172636915	172760816	123901	solute carrier family 25 (aspartate/glutamate carrier), member 12
PA35859	10165	SLC25A13	chr7	95746532	95961459	214927	solute carrier family 25 (aspartate/glutamate carrier), member 13
PA35860	9016	SLC25A14	chrX	129462689	129510335	47646	solute carrier family 25 (mitochondrial carrier, brain), member 14
PA35861	10166	SLC25A15	chr13	41353547	41389601	36054	solute carrier family 25 (mitochondrial carrier; ornithine transporter) member 15
PA35862	8034	SLC25A16	chr10	70239090	70297280	58190	solute carrier family 25 (mitochondrial carrier), member 16
PA35863	10478	SLC25A17	chr22	41162636	41225403	62767	solute carrier family 25 (mitochondrial carrier; peroxisomal membrane protein, 34kDa), member 17
PA35864	83733	SLC25A18	chr22	18033030	18076651	43621	solute carrier family 25 (glutamate carrier), member 18
PA37879	60386	SLC25A19	chr17	73266061	73295530	29469	solute carrier family 25 (mitochondrial thiamine pyrophosphate carrier), member 19
PA134910073	83884	SLC25A2	chr5	534805	549221	14416	solute carrier family 25 (mitochondrial carrier; ornithine transporter) member 2
PA35031	788	SLC25A20	chr3	48891356	48946426	55070	solute carrier family 25 (carnitine/acylcarnitine translocase), member 20
PA37880	89874	SLC25A21	chr14	37144126	37651865	507739	solute carrier family 25 (mitochondrial oxoadipate carrier), member 21
PA134955826	79751	SLC25A22	chr11	787475	808269	20794	solute carrier family 25 (mitochondrial carrier: glutamate), member 22
PA134932456	79085	SLC25A23	chr19	6433092	6470232	37140	solute carrier family 25 (mitochondrial carrier; phosphate carrier), member 23
PA134978257	29957	SLC25A24	chr1	108674344	108752980	78636	solute carrier family 25 (mitochondrial carrier; phosphate carrier), member 24
PA134952319	114789	SLC25A25	chr9	130820479	130874537	54058	solute carrier family 25 (mitochondrial carrier; phosphate carrier), member 25
PA134987831	115286	SLC25A26	chr3	66261149	66432351	171202	solute carrier family 25 (S-adenosylmethionine carrier), member 26
PA134970102	9481	SLC25A27	chr6	46610652	46648927	38275	solute carrier family 25, member 27
PA134867966	81894	SLC25A28	chr10	101367275	101429039	61764	solute carrier family 25 (mitochondrial iron transporter), member 28
PA134980581	123096	SLC25A29	chr14	100742514	100782884	40370	solute carrier family 25 (mitochondrial carnitine/acylcarnitine carrier), member 29
PA35865	5250	SLC25A3	chr12	98977403	98998778	21375	solute carrier family 25 (mitochondrial carrier; phosphate carrier), member 3
PA134931353	253512	SLC25A30	chr13	45957520	46002549	45029	solute carrier family 25, member 30
PA142670904	83447	SLC25A31	chr4	128641555	128698447	56892	solute carrier family 25 (mitochondrial carrier; adenine nucleotide translocator), member 31
PA142670905	81034	SLC25A32	chr8	104407866	104437563	29697	solute carrier family 25 (mitochondrial folate carrier), member 32
PA162403588	84275	SLC25A33	chr1	9589528	9645831	56303	solute carrier family 25 (pyrimidine nucleotide carrier), member 33
PA142670906	284723	SLC25A34	chr1	16052721	16070884	18163	solute carrier family 25, member 34
PA142670907	399512	SLC25A35	chr17	8188082	8208709	20627	solute carrier family 25, member 35
PA142670908	55186	SLC25A36	chr3	140650662	140701785	51123	solute carrier family 25 (pyrimidine nucleotide carrier ), member 36
PA142670909	51312	SLC25A37	chr8	23376363	23435976	59613	solute carrier family 25 (mitochondrial iron transporter), member 37
PA162403607	54977	SLC25A38	chr3	39414815	39441819	27004	solute carrier family 25, member 38
PA162403626	51629	SLC25A39	chr17	42393993	42412217	18224	solute carrier family 25, member 39
PA35866	291	SLC25A4	chr4	186054417	186074538	20121	solute carrier family 25 (mitochondrial carrier; adenine nucleotide translocator), member 4
PA162403655	55972	SLC25A40	chr7	87459885	87515692	55807	solute carrier family 25, member 40
PA162403684	284427	SLC25A41	chr19	6423048	6443790	20742	solute carrier family 25, member 41
PA162403703	284439	SLC25A42	chr19	19164776	19226839	62063	solute carrier family 25, member 42
PA162403704	203427	SLC25A43	chrX	118523258	118591441	68183	solute carrier family 25, member 43
PA162403705	9673	SLC25A44	chr1	156153728	156185587	31859	solute carrier family 25, member 44
PA162403718	283130	SLC25A45	chr11	65139663	65161172	21509	solute carrier family 25, member 45
PA162403737	91137	SLC25A46	chr5	110063837	110103857	40020	solute carrier family 25, member 46
PA165479287	283600	SLC25A47	chr14	100779679	100799715	20036	solute carrier family 25, member 47
PA165660536	153328	SLC25A48	chr5	135160365	135227326	66961	solute carrier family 25, member 48
PA35867	292	SLC25A5	chrX	118592363	118608359	15996	solute carrier family 25 (mitochondrial carrier; adenine nucleotide translocator), member 5
PA134888553	92014	SLC25A51	chr9	37874572	37914350	39778	solute carrier family 25, member 51
PA134957999	147407	SLC25A52	chr18	29336659	29350843	14184	solute carrier family 25, member 52
PA142671476	401612	SLC25A53	chrX	103340898	103411708	70810	solute carrier family 25, member 53
PA35868	293	SLC25A6	chrY	1452045	1471039	18994	solute carrier family 25 (mitochondrial carrier; adenine nucleotide translocator), member 6
PA400	10861	SLC26A1	chr4	969861	997228	27367	solute carrier family 26 (anion exchanger), member 1
PA37887	65012	SLC26A10	chr12	58003693	58022934	19241	solute carrier family 26, member 10
PA37888	284129	SLC26A11	chr17	78184200	78230308	46108	solute carrier family 26 (anion exchanger), member 11
PA149	1836	SLC26A2	chr5	149330300	149369963	39663	solute carrier family 26 (anion exchanger), member 2
PA35044	1811	SLC26A3	chr7	107402912	107453678	50766	solute carrier family 26 (anion exchanger), member 3
PA35506	5172	SLC26A4	chr7	107291080	107361254	70174	solute carrier family 26 (anion exchanger), member 4
PA33731	375611	SLC26A5	chr7	102990177	103096624	106447	solute carrier family 26 (anion exchanger), member 5
PA37889	65010	SLC26A6	chr3	48660156	48682926	22770	solute carrier family 26 (anion exchanger), member 6
PA37884	115111	SLC26A7	chr8	92251508	92413378	161870	solute carrier family 26 (anion exchanger), member 7
PA37885	116369	SLC26A8	chr6	35908291	36002413	94122	solute carrier family 26 (anion exchanger), member 8
PA37886	115019	SLC26A9	chr1	205879176	205922588	43412	solute carrier family 26 (anion exchanger), member 9
PA35869	376497	SLC27A1	chr19	17571300	17619977	48677	solute carrier family 27 (fatty acid transporter), member 1
PA27971	11001	SLC27A2	chr15	50464393	50531589	67196	solute carrier family 27 (fatty acid transporter), member 2
PA35871	11000	SLC27A3	chr1	153736830	153755633	18803	solute carrier family 27 (fatty acid transporter), member 3
PA35872	10999	SLC27A4	chr9	131092839	131126749	33910	solute carrier family 27 (fatty acid transporter), member 4
PA35873	10998	SLC27A5	chr19	59006700	59033432	26732	solute carrier family 27 (fatty acid transporter), member 5
PA35874	28965	SLC27A6	chr5	128290951	128372335	81384	solute carrier family 27 (fatty acid transporter), member 6
PA387	9154	SLC28A1	chr15	85417794	85492027	74233	solute carrier family 28 (concentrative nucleoside transporter), member 1
PA386	9153	SLC28A2	chr15	45534428	45571132	36704	solute carrier family 28 (concentrative nucleoside transporter), member 2
PA426	64078	SLC28A3	chr9	86887765	86993413	105648	solute carrier family 28 (concentrative nucleoside transporter), member 3
PA154	2030	SLC29A1	chr6	44177242	44204888	27646	solute carrier family 29 (equilibrative nucleoside transporter), member 1
PA191	3177	SLC29A2	chr11	66126992	66149961	22969	solute carrier family 29 (equilibrative nucleoside transporter), member 2
PA134950750	55315	SLC29A3	chr10	73069010	73126147	57137	solute carrier family 29 (equilibrative nucleoside transporter), member 3
PA134976472	222962	SLC29A4	chr7	5312561	5346704	34143	solute carrier family 29 (equilibrative nucleoside transporter), member 4
PA35875	6513	SLC2A1	chr1	43388046	43434847	46801	solute carrier family 2 (facilitated glucose transporter), member 1
PA37769	81031	SLC2A10	chr20	45328279	45367986	39707	solute carrier family 2 (facilitated glucose transporter), member 10
PA37861	66035	SLC2A11	chr22	24189059	24230738	41679	solute carrier family 2 (facilitated glucose transporter), member 11
PA38288	154091	SLC2A12	chr6	134305719	134383789	78070	solute carrier family 2 (facilitated glucose transporter), member 12
PA38066	114134	SLC2A13	chr12	40145823	40509847	364024	solute carrier family 2 (facilitated glucose transporter), member 13
PA134885058	144195	SLC2A14	chr12	7962110	8053792	91682	solute carrier family 2 (facilitated glucose transporter), member 14
PA35876	6514	SLC2A2	chr3	170711137	170754768	43631	solute carrier family 2 (facilitated glucose transporter), member 2
PA35877	6515	SLC2A3	chr12	8068824	8098895	30071	solute carrier family 2 (facilitated glucose transporter), member 3
PA35879	6517	SLC2A4	chr17	7174986	7194367	19381	solute carrier family 2 (facilitated glucose transporter), member 4
PA38052	56731	SLC2A4RG	chr20	62361211	62378403	17192	SLC2A4 regulator
PA35880	6518	SLC2A5	chr1	9094005	9141763	47758	solute carrier family 2 (facilitated glucose/fructose transporter), member 5
PA35881	11182	SLC2A6	chr9	136333216	136354276	21060	solute carrier family 2 (facilitated glucose transporter), member 6
PA37770	155184	SLC2A7	chr1	9060359	9096404	36045	solute carrier family 2 (facilitated glucose transporter), member 7
PA37813	29988	SLC2A8	chr9	130149417	130173177	23760	solute carrier family 2 (facilitated glucose transporter), member 8
PA37771	56606	SLC2A9	chr4	9824848	10051872	227024	solute carrier family 2 (facilitated glucose transporter), member 9
PA35882	7779	SLC30A1	chr1	211745381	211762099	16718	solute carrier family 30 (zinc transporter), member 1
PA142670903	55532	SLC30A10	chr1	220084606	220111993	27387	solute carrier family 30, member 10
PA35883	7780	SLC30A2	chr1	26361513	26383439	21926	solute carrier family 30 (zinc transporter), member 2
PA35884	7781	SLC30A3	chr2	27474440	27511093	36653	solute carrier family 30 (zinc transporter), member 3
PA35885	7782	SLC30A4	chr15	45771676	45825005	53329	solute carrier family 30 (zinc transporter), member 4
PA134865113	64924	SLC30A5	chr5	68379776	68429899	50123	solute carrier family 30 (zinc transporter), member 5
PA134923067	55676	SLC30A6	chr2	32380910	32452181	71271	solute carrier family 30 (zinc transporter), member 6
PA134891595	148867	SLC30A7	chr1	101351632	101555821	204189	solute carrier family 30 (zinc transporter), member 7
PA134915546	169026	SLC30A8	chr8	117952512	118191953	239441	solute carrier family 30 (zinc transporter), member 8
PA25909	10463	SLC30A9	chr4	41982516	42092551	110035	solute carrier family 30 (zinc transporter), member 9
PA118	1317	SLC31A1	chr9	115973808	116029772	55964	solute carrier family 31 (copper transporter), member 1
PA35886	1318	SLC31A2	chr9	115903238	115929422	26184	solute carrier family 31 (copper transporter), member 2
PA401	140679	SLC32A1	chr20	37343105	37361015	17910	solute carrier family 32 (GABA vesicular transporter), member 1
PA24432	9197	SLC33A1	chr3	155541300	155582248	40948	solute carrier family 33 (acetyl-CoA transporter), member 1
PA35887	6569	SLC34A1	chr5	176801432	176828849	27417	solute carrier family 34 (type II sodium/phosphate cotransporter), member 1
PA35888	10568	SLC34A2	chr4	25646853	25683735	36882	solute carrier family 34 (type II sodium/phosphate cotransporter), member 2
PA134930298	142680	SLC34A3	chr9	140115209	140134006	18797	solute carrier family 34 (type II sodium/phosphate cotransporter), member 3
PA35889	10559	SLC35A1	chr6	88172637	88225057	52420	solute carrier family 35 (CMP-sialic acid transporter), member A1
PA35890	7355	SLC35A2	chrX	48757459	48779235	21776	solute carrier family 35 (UDP-galactose transporter), member A2
PA35891	23443	SLC35A3	chr1	100425345	100495535	70190	solute carrier family 35 (UDP-N-acetylglucosamine (UDP-GlcNAc) transporter), member A3
PA134971555	113829	SLC35A4	chr5	139934420	139951683	17263	solute carrier family 35, member A4
PA134947136	55032	SLC35A5	chr3	112270857	112306286	35429	solute carrier family 35, member A5
PA134864001	10237	SLC35B1	chr17	47775296	47795313	20017	solute carrier family 35, member B1
PA134927864	347734	SLC35B2	chr6	44218838	44235283	16445	solute carrier family 35 (adenosine 3'-phospho 5'-phosphosulfate transporter), member B2
PA134889889	51000	SLC35B3	chr6	8410301	8445794	35493	solute carrier family 35 (adenosine 3'-phospho 5'-phosphosulfate transporter), member B3
PA134922110	84912	SLC35B4	chr7	133971089	134011827	40738	solute carrier family 35 (UDP-xylose/UDP-N-acetylglucosamine transporter), member B4
PA134930330	55343	SLC35C1	chr11	45815623	45837568	21945	solute carrier family 35 (GDP-fucose transporter), member C1
PA32850	51006	SLC35C2	chr20	44975167	45003097	27930	solute carrier family 35 (GDP-fucose transporter), member C2
PA134978757	23169	SLC35D1	chr1	67462015	67530080	68065	solute carrier family 35 (UDP-GlcA/UDP-GalNAc transporter), member D1
PA134909604	11046	SLC35D2	chr9	99072719	99155992	83273	solute carrier family 35 (UDP-GlcNAc/UDP-glucose transporter), member D2
PA134876893	340146	SLC35D3	chr6	137233402	137249777	16375	solute carrier family 35, member D3
PA134916810	79939	SLC35E1	chr19	16657648	16693193	35545	solute carrier family 35, member E1
PA134958874	9906	SLC35E2	chr1	1653277	1687438	34161	solute carrier family 35, member E2
PA165752386	728661	SLC35E2B	chr1	1588486	1634243	45757	solute carrier family 35, member E2B
PA128394684	55508	SLC35E3	chr12	69129910	69162853	32943	solute carrier family 35, member E3
PA134883803	339665	SLC35E4	chr22	31021793	31046862	25069	solute carrier family 35, member E4
PA134985447	222553	SLC35F1	chr6	118218689	118641839	423150	solute carrier family 35, member F1
PA134945023	54733	SLC35F2	chr11	107658717	107739914	81197	solute carrier family 35, member F2
PA134938022	148641	SLC35F3	chr1	234030679	234463262	432583	solute carrier family 35, member F3
PA134959551	341880	SLC35F4	chr14	58027640	58342592	314952	solute carrier family 35, member F4
PA134953009	80255	SLC35F5	chr2	114468354	114524400	56046	solute carrier family 35, member F5
PA134913368	54978	SLC35F6	chr2	26977131	27007099	29968	solute carrier family 35, member F6
PA134933626	159371	SLC35G1	chr10	95643730	95666581	22851	solute carrier family 35, member G1
PA134946375	80723	SLC35G2	chr3	136527861	136577734	49873	solute carrier family 35, member G2
PA134902447	146861	SLC35G3	chr17	33516539	33531412	14873	solute carrier family 35, member G3
PA134875980	646000	SLC35G4	chr18	11599595	11613611	14016	solute carrier family 35, member G4
PA24756	83650	SLC35G5	chr8	11178495	11192695	14200	solute carrier family 35, member G5
PA134919830	643664	SLC35G6	chr17	7360504	7389383	28879	solute carrier family 35, member G6
PA134870308	206358	SLC36A1	chr5	150806553	150874940	68387	solute carrier family 36 (proton/amino acid symporter), member 1
PA134899820	153201	SLC36A2	chr5	150691539	150737151	45612	solute carrier family 36 (proton/amino acid symporter), member 2
PA134875494	285641	SLC36A3	chr5	150652926	150693334	40408	solute carrier family 36, member 3
PA134908925	120103	SLC36A4	chr11	92877850	92941095	63245	solute carrier family 36 (proton/amino acid symporter), member 4
PA35892	54020	SLC37A1	chr21	43909742	44004550	94808	solute carrier family 37 (glucose-6-phosphate transporter), member 1
PA134917577	219855	SLC37A2	chr11	124922963	124963412	40449	solute carrier family 37 (glucose-6-phosphate transporter), member 2
PA134895240	84255	SLC37A3	chr7	140030552	140114024	83472	solute carrier family 37, member 3
PA28472	2542	SLC37A4	chr11	118892061	118911616	19555	solute carrier family 37 (glucose-6-phosphate transporter), member 4
PA37772	81539	SLC38A1	chr12	46573838	46673208	99370	solute carrier family 38, member 1
PA162403738	124565	SLC38A10	chr17	79215799	79279233	63434	solute carrier family 38, member 10
PA162403771	151258	SLC38A11	chr2	165751709	165822035	70326	solute carrier family 38, member 11
PA37773	54407	SLC38A2	chr12	46748971	46776645	27674	solute carrier family 38, member 2
PA37908	55089	SLC38A4	chr12	47155544	47236205	80661	solute carrier family 38, member 4
PA38289	92745	SLC38A5	chrX	48313927	48338644	24717	solute carrier family 38, member 5
PA134932150	145389	SLC38A6	chr14	61437832	61553451	115619	solute carrier family 38, member 6
PA162403772	55238	SLC38A7	chr16	58697298	58728674	31376	solute carrier family 38, member 7
PA162403773	146167	SLC38A8	chr16	84040389	84085762	45373	solute carrier family 38, member 8
PA162403774	153129	SLC38A9	chr5	54918673	55018163	99490	solute carrier family 38, member 9
PA37465	27173	SLC39A1	chr1	153928575	153950660	22085	solute carrier family 39 (zinc transporter), member 1
PA134944068	57181	SLC39A10	chr2	196467798	196605426	137628	solute carrier family 39 (zinc transporter), member 10
PA25581	201266	SLC39A11	chr17	70639085	71098853	459768	solute carrier family 39, member 11
PA134956205	221074	SLC39A12	chr10	18230768	18335221	104453	solute carrier family 39 (zinc transporter), member 12
PA134948414	91252	SLC39A13	chr11	47418683	47441051	22368	solute carrier family 39 (zinc transporter), member 13
PA134863701	23516	SLC39A14	chr8	22214762	22294642	79880	solute carrier family 39 (zinc transporter), member 14
PA38202	29986	SLC39A2	chr14	21457414	21473034	15620	solute carrier family 39 (zinc transporter), member 2
PA38203	29985	SLC39A3	chr19	2726925	2750074	23149	solute carrier family 39 (zinc transporter), member 3
PA38204	55630	SLC39A4	chr8	145634798	145652279	17481	solute carrier family 39 (zinc transporter), member 4
PA134872687	283375	SLC39A5	chr12	56613820	56634630	20810	solute carrier family 39 (zinc transporter), member 5
PA134905551	25800	SLC39A6	chr18	33685494	33719357	33863	solute carrier family 39 (zinc transporter), member 6
PA29305	7922	SLC39A7	chr6	33158603	33175214	16611	solute carrier family 39 (zinc transporter), member 7
PA134931507	64116	SLC39A8	chr4	103169198	103276655	107457	solute carrier family 39 (zinc transporter), member 8
PA134889179	55334	SLC39A9	chr14	69855096	69932107	77011	solute carrier family 39, member 9
PA35893	6519	SLC3A1	chr2	44492597	44550963	58366	solute carrier family 3 (amino acid transporter heavy chain), member 1
PA35894	6520	SLC3A2	chr11	62613484	62659355	45871	solute carrier family 3 (amino acid transporter heavy chain), member 2
PA35805	30061	SLC40A1	chr2	190422316	190458478	36162	solute carrier family 40 (iron-regulated transporter), member 1
PA134889327	254428	SLC41A1	chr1	205755221	205792887	37666	solute carrier family 41 (magnesium transporter), member 1
PA134931432	84102	SLC41A2	chr12	105193331	105362476	169145	solute carrier family 41 (magnesium transporter), member 2
PA134878151	54946	SLC41A3	chr3	125722200	125830398	108198	solute carrier family 41, member 3
PA33549	8501	SLC43A1	chr11	57249004	57293192	44188	solute carrier family 43 (amino acid system L transporter), member 1
PA134940765	124935	SLC43A2	chr17	1474678	1542130	67452	solute carrier family 43 (amino acid system L transporter), member 2
PA134924689	29015	SLC43A3	chr11	57171427	57205053	33626	solute carrier family 43, member 3
PA134958011	23446	SLC44A1	chr9	107996906	108203785	206879	solute carrier family 44 (choline transporter), member 1
PA142670899	57153	SLC44A2	chr19	10703121	10758235	55114	solute carrier family 44 (choline transporter), member 2
PA142670900	126969	SLC44A3	chr1	95275898	95363803	87905	solute carrier family 44, member 3
PA25930	80736	SLC44A4	chr6	31827969	31856823	28854	solute carrier family 44, member 4
PA142670901	204962	SLC44A5	chr1	75664816	76091698	426882	solute carrier family 44, member 5
PA134982862	50651	SLC45A1	chr1	8368171	8407227	39056	solute carrier family 45, member 1
PA134897756	51151	SLC45A2	chr5	33941721	33994780	53059	solute carrier family 45, member 2
PA32981	85414	SLC45A3	chr1	205623979	205659630	35651	solute carrier family 45, member 3
PA142670902	57210	SLC45A4	chr8	142214273	142320241	105968	solute carrier family 45, member 4
PA162403775	113235	SLC46A1	chr17	26718661	26743230	24569	solute carrier family 46 (folate transporter), member 1
PA162403790	57864	SLC46A2	chr9	115638200	115663193	24993	solute carrier family 46, member 2
PA162403791	283537	SLC46A3	chr13	29271217	29303150	31933	solute carrier family 46, member 3
PA162403808	55244	SLC47A1	chr17	19427167	19485346	58179	solute carrier family 47 (multidrug and toxin extrusion), member 1
PA162403847	146802	SLC47A2	chr17	19578626	19632990	54364	solute carrier family 47 (multidrug and toxin extrusion), member 2
PA164725837	55652	SLC48A1	chr12	48142426	48179536	37110	solute carrier family 48 (heme transporter), member 1
PA35895	6521	SLC4A1	chr17	42322758	42361654	38896	solute carrier family 4 (anion exchanger), member 1 (Diego blood group)
PA37810	57282	SLC4A10	chr2	162470699	162844786	374087	solute carrier family 4, sodium bicarbonate transporter, member 10
PA38139	83959	SLC4A11	chr20	3205063	3232109	27046	solute carrier family 4, sodium borate transporter, member 11
PA37811	22950	SLC4A1AP	chr2	27876338	27920847	44509	solute carrier family 4 (anion exchanger), member 1, adaptor protein
PA35896	6522	SLC4A2	chr7	150745299	150776614	31315	solute carrier family 4 (anion exchanger), member 2
PA35897	6508	SLC4A3	chr2	220482292	220509702	27410	solute carrier family 4 (anion exchanger), member 3
PA35898	8671	SLC4A4	chr4	72043003	72440804	397801	solute carrier family 4 (sodium bicarbonate cotransporter), member 4
PA164742397	57835	SLC4A5	chr2	74438997	74580534	141537	solute carrier family 4 (sodium bicarbonate cotransporter), member 5
PA35899	9497	SLC4A7	chr3	27411212	27535911	124699	solute carrier family 4, sodium bicarbonate cotransporter, member 7
PA35900	9498	SLC4A8	chr12	51775101	51912547	137446	solute carrier family 4, sodium bicarbonate cotransporter, member 8
PA35901	83697	SLC4A9	chr5	139729787	139757722	27935	solute carrier family 4, sodium bicarbonate cotransporter, member 9
PA142671099	55974	SLC50A1	chr1	155097817	155114334	16517	solute carrier family 50 (sugar efflux transporter), member 1
PA134991217	55065	SLC52A1	chr17	4932711	4965304	32593	solute carrier family 52 (riboflavin transporter), member 1
PA134982935	79581	SLC52A2	chr8	145572217	145587946	15729	solute carrier family 52 (riboflavin transporter), member 2
PA25764	113278	SLC52A3	chr20	737724	766628	28904	solute carrier family 52 (riboflavin transporter), member 3
PA308	6523	SLC5A1	chr22	32429019	32512016	82997	solute carrier family 5 (sodium/glucose cotransporter), member 1
PA134940254	125206	SLC5A10	chr17	18843989	18927004	83015	solute carrier family 5 (sodium/sugar cotransporter), member 10
PA134923660	115584	SLC5A11	chr16	24847184	24925949	78765	solute carrier family 5 (sodium/inositol cotransporter), member 11
PA134873929	159963	SLC5A12	chr11	26685566	26753574	68008	solute carrier family 5 (sodium/monocarboxylate cotransporter), member 12
PA35902	6524	SLC5A2	chr16	31484439	31505091	20652	solute carrier family 5 (sodium/glucose cotransporter), member 2
PA35903	6526	SLC5A3	chr21	35435503	35518334	82831	solute carrier family 5 (sodium/myo-inositol cotransporter), member 3
PA35904	6527	SLC5A4	chr22	32611463	32661318	49855	solute carrier family 5 (glucose activated ion channel), member 4
PA35905	6528	SLC5A5	chr19	17972641	18008983	36342	solute carrier family 5 (sodium/iodide cotransporter), member 5
PA379	8884	SLC5A6	chr2	27419455	27445175	25720	solute carrier family 5 (sodium/multivitamin and iodide cotransporter), member 6
PA37838	60482	SLC5A7	chr2	108592979	108633663	40684	solute carrier family 5 (sodium/choline cotransporter), member 7
PA134989874	160728	SLC5A8	chr12	101546994	101614016	67022	solute carrier family 5 (sodium/monocarboxylate cotransporter), member 8
PA134949681	200010	SLC5A9	chr1	48678339	48717316	38977	solute carrier family 5 (sodium/sugar cotransporter), member 9
PA309	6529	SLC6A1	chr3	11024420	11083935	59515	solute carrier family 6 (neurotransmitter transporter), member 1
PA35907	6538	SLC6A11	chr3	10847917	10983146	135229	solute carrier family 6 (neurotransmitter transporter), member 11
PA35908	6539	SLC6A12	chr12	296243	333740	37497	solute carrier family 6 (neurotransmitter transporter), member 12
PA35909	6540	SLC6A13	chr12	326787	382039	55252	solute carrier family 6 (neurotransmitter transporter), member 13
PA35910	11254	SLC6A14	chrX	115557747	115595625	37878	solute carrier family 6 (amino acid transporter), member 14
PA37799	55117	SLC6A15	chr12	85250267	85316608	66341	solute carrier family 6 (neutral amino acid transporter), member 15
PA37800	28968	SLC6A16	chr19	49789889	49838521	48632	solute carrier family 6, member 16
PA134941636	388662	SLC6A17	chr1	110683132	110747824	64692	solute carrier family 6 (neutral amino acid transporter), member 17
PA134982449	348932	SLC6A18	chr5	1215470	1249304	33834	solute carrier family 6 (neutral amino acid transporter), member 18
PA134968815	340024	SLC6A19	chr5	1191710	1228232	36522	solute carrier family 6 (neutral amino acid transporter), member 19
PA310	6530	SLC6A2	chr16	55679542	55743104	63562	solute carrier family 6 (neurotransmitter transporter), member 2
PA134865308	54716	SLC6A20	chr3	45793941	45848039	54098	solute carrier family 6 (proline IMINO transporter), member 20
PA311	6531	SLC6A3	chr5	1389905	1455543	65638	solute carrier family 6 (neurotransmitter transporter), member 3
PA312	6532	SLC6A4	chr17	28518337	28572986	54649	solute carrier family 6 (neurotransmitter transporter), member 4
PA35911	9152	SLC6A5	chr11	20610946	20679610	68664	solute carrier family 6 (neurotransmitter transporter), member 5
PA35912	6533	SLC6A6	chr3	14434076	14533857	99781	solute carrier family 6 (neurotransmitter transporter), member 6
PA35914	6534	SLC6A7	chr5	149559520	149593635	34115	solute carrier family 6 (neurotransmitter transporter), member 7
PA35915	6535	SLC6A8	chrX	152943752	152965048	21296	solute carrier family 6 (neurotransmitter transporter), member 8
PA35916	6536	SLC6A9	chr1	44459155	44507171	48016	solute carrier family 6 (neurotransmitter transporter, glycine), member 9
PA35917	6541	SLC7A1	chr13	30080551	30179825	99274	solute carrier family 7 (cationic amino acid transporter, y+ system), member 1
PA35918	56301	SLC7A10	chr19	33696570	33726756	30186	solute carrier family 7 (neutral amino acid transporter light chain, asc system), member 10
PA35919	23657	SLC7A11	chr4	139082248	139173572	91324	solute carrier family 7 (anionic amino acid transporter light chain, xc- system), member 11
PA134980828	157724	SLC7A13	chr8	87223288	87252609	29321	solute carrier family 7 (anionic amino acid transporter), member 13
PA142670913	57709	SLC7A14	chr3	170174342	170313863	139521	solute carrier family 7, member 14
PA35920	6542	SLC7A2	chr8	17344597	17431077	86480	solute carrier family 7 (cationic amino acid transporter, y+ system), member 2
PA35921	84889	SLC7A3	chrX	70142429	70160975	18546	solute carrier family 7 (cationic amino acid transporter, y+ system), member 3
PA35922	6545	SLC7A4	chr22	21379995	21397163	17168	solute carrier family 7, member 4
PA35923	8140	SLC7A5	chr16	87860629	87913100	52471	solute carrier family 7 (amino acid transporter light chain, L system), member 5
PA35924	9057	SLC7A6	chr16	68288419	68338726	50307	solute carrier family 7 (amino acid transporter light chain, y+L system), member 6
PA142670912	84138	SLC7A6OS	chr16	68315043	68354868	39825	solute carrier family 7, member 6 opposite strand
PA35925	9056	SLC7A7	chr14	23239431	23299020	59589	solute carrier family 7 (amino acid transporter light chain, y+L system), member 7
PA35926	23428	SLC7A8	chr14	23591504	23662869	71365	solute carrier family 7 (amino acid transporter light chain, L system), member 8
PA35927	11136	SLC7A9	chr19	33318417	33370683	52266	solute carrier family 7 (amino acid transporter light chain, bo,+ system), member 9
PA314	6546	SLC8A1	chr2	40336286	40749575	413289	solute carrier family 8 (sodium/calcium exchanger), member 1
PA313	6543	SLC8A2	chr19	47928274	47985307	57033	solute carrier family 8 (sodium/calcium exchanger), member 2
PA315	6547	SLC8A3	chr14	70507934	70665787	157853	solute carrier family 8 (sodium/calcium exchanger), member 3
PA134954965	80024	SLC8B1	chr12	113733571	113782934	49363	solute carrier family 8 (sodium/lithium/calcium exchanger), member B1
PA35928	6548	SLC9A1	chr1	27422300	27491621	69321	solute carrier family 9, subfamily A (NHE1, cation proton antiporter 1), member 1
PA35929	6549	SLC9A2	chr2	103226166	103330809	104643	solute carrier family 9, subfamily A (NHE2, cation proton antiporter 2), member 2
PA316	6550	SLC9A3	chr5	470298	534549	64251	solute carrier family 9, subfamily A (NHE3, cation proton antiporter 3), member 3
PA35931	9368	SLC9A3R1	chr17	72734751	72768499	33748	solute carrier family 9, subfamily A (NHE3, cation proton antiporter 3), member 3 regulator 1
PA35932	9351	SLC9A3R2	chr16	2066869	2092027	25158	solute carrier family 9, subfamily A (NHE3, cation proton antiporter 3), member 3 regulator 2
PA35933	389015	SLC9A4	chr2	103079173	103153433	74260	solute carrier family 9, subfamily A (NHE4, cation proton antiporter 4), member 4
PA35934	6553	SLC9A5	chr16	67272855	67309094	36239	solute carrier family 9, subfamily A (NHE5, cation proton antiporter 5), member 5
PA35935	10479	SLC9A6	chrX	135057583	135132428	74845	solute carrier family 9, subfamily A (NHE6, cation proton antiporter 6), member 6
PA38200	84679	SLC9A7	chrX	46455686	46628607	172921	solute carrier family 9, subfamily A (NHE7, cation proton antiporter 7), member 7
PA134924114	23315	SLC9A8	chr20	48419250	48511779	92529	solute carrier family 9, subfamily A (NHE8, cation proton antiporter 8), member 8
PA134889062	285195	SLC9A9	chr3	142981063	143577373	596310	solute carrier family 9, subfamily A (NHE9, cation proton antiporter 9), member 9
PA162397486	150159	SLC9B1	chr4	103803205	103957552	154347	solute carrier family 9, subfamily B (NHA1, cation proton antiporter 1), member 1
PA162397515	133308	SLC9B2	chr4	103943647	104008480	64833	solute carrier family 9, subfamily B (NHA2, cation proton antiporter 2), member 2
PA134914619	285335	SLC9C1	chr3	111856752	112023105	166353	solute carrier family 9, subfamily C (Na+-transporting carboxylic acid decarboxylase), member 1
PA134865165	284525	SLC9C2	chr1	173466604	173582233	115629	solute carrier family 9, member C2 (putative)
PA328	6579	SLCO1A2	chr12	21414534	21558371	143837	solute carrier organic anion transporter family, member 1A2
PA134865839	10599	SLCO1B1	chr12	21274128	21395730	121602	solute carrier organic anion transporter family, member 1B1
PA35844	28234	SLCO1B3	chr12	20953638	21073019	119381	solute carrier organic anion transporter family, member 1B3
PA37815	53919	SLCO1C1	chr12	20838289	20909320	71031	solute carrier organic anion transporter family, member 1C1
PA35840	6578	SLCO2A1	chr3	133648540	133758920	110380	solute carrier organic anion transporter family, member 2A1
PA35845	11309	SLCO2B1	chr11	74852032	74920445	68413	solute carrier organic anion transporter family, member 2B1
PA35837	28232	SLCO3A1	chr15	92386938	92718665	331727	solute carrier organic anion transporter family, member 3A1
PA35838	28231	SLCO4A1	chr20	61263795	61320137	56342	solute carrier organic anion transporter family, member 4A1
PA134892408	353189	SLCO4C1	chr5	101566690	101642253	75563	solute carrier organic anion transporter family, member 4C1
PA134948571	81796	SLCO5A1	chr8	70581110	70757299	176189	solute carrier organic anion transporter family, member 5A1
PA134949852	133482	SLCO6A1	chr5	101704492	101844720	140228	solute carrier organic anion transporter family, member 6A1
PA144596358	91607	SLFN11	chr17	33674324	33710821	36497	schlafen family member 11
PA144596359	55106	SLFN12	chr17	33735079	33770302	35223	schlafen family member 12
PA162403886	100506736	SLFN12L	chr17	33798942	33824758	25816	schlafen family member 12-like
PA144596360	146857	SLFN13	chr17	33759115	33785856	26741	schlafen family member 13
PA144596361	342618	SLFN14	chr17	33871728	33896783	25055	schlafen family member 14
PA144596357	162394	SLFN5	chr17	33560086	33597768	37682	schlafen family member 5
PA144596362	200172	SLFNL1	chr1	41478269	41499116	20847	schlafen-like 1
PA134892132	81892	SLIRP	chr14	78164414	78186941	22527	SRA stem-loop interacting RNA binding protein
PA35938	6585	SLIT1	chr10	98754795	98955683	200888	slit homolog 1 (Drosophila)
PA35939	9353	SLIT2	chr4	20244566	20625184	380618	slit homolog 2 (Drosophila)
PA35940	6586	SLIT3	chr5	168085738	168738133	652395	slit homolog 3 (Drosophila)
PA134944423	114798	SLITRK1	chr13	84448340	84466528	18188	SLIT and NTRK-like family, member 1
PA134968225	84631	SLITRK2	chrX	144889347	144910360	21013	SLIT and NTRK-like family, member 2
PA134958002	22865	SLITRK3	chr3	164899010	164924469	25459	SLIT and NTRK-like family, member 3
PA134926932	139065	SLITRK4	chrX	142707595	142733926	26331	SLIT and NTRK-like family, member 4
PA134885524	26050	SLITRK5	chr13	88313931	88334871	20940	SLIT and NTRK-like family, member 5
PA134928433	84189	SLITRK6	chr13	86363922	86383483	19561	SLIT and NTRK-like family, member 6
PA35941	9748	SLK	chr10	105716943	105791991	75048	STE20-like kinase
PA38179	7871	SLMAP	chr3	57731948	57918597	186649	sarcolemma associated protein
PA162403903	10650	SLMO1	chr18	12397895	12435237	37342	slowmo homolog 1 (Drosophila)
PA162403922	51012	SLMO2	chr20	57605200	57627901	22701	slowmo homolog 2 (Drosophila)
PA35942	6588	SLN	chr11	107575101	107592787	17686	sarcolipin
PA35944	6590	SLPI	chr20	43877880	43893205	15325	secretory leukocyte peptidase inhibitor
PA142670898	79811	SLTM	chr15	59168244	59236323	68079	SAFB-like, transcription modulator
PA128394574	10569	SLU7	chr5	159825648	159856168	30520	SLU7 splicing factor homolog (S. cerevisiae)
PA134936818	57152	SLURP1	chr8	143819362	143833829	14467	secreted LY6/PLAUR domain containing 1
PA142671737	548593	SLX1A	chr16	30195164	30211887	16723	SLX1 structure-specific endonuclease subunit homolog A (S. cerevisiae)
PA142671738	79008	SLX1B	chr16	29455822	29472545	16723	SLX1 structure-specific endonuclease subunit homolog B (S. cerevisiae)
PA134983583	84464	SLX4	chr16	3628182	3671585	43403	SLX4 structure-specific endonuclease subunit
PA25801	128710	SLX4IP	chr20	10405951	10607551	201600	SLX4 interacting protein
PA30524	4086	SMAD1	chr4	146392951	146483328	90377	SMAD family member 1
PA134959722	4087	SMAD2	chr18	45356466	45467564	111098	SMAD family member 2
PA30526	4088	SMAD3	chr15	67348036	67490533	142497	SMAD family member 3
PA30527	4089	SMAD4	chr18	48546583	48614412	67829	SMAD family member 4
PA30528	4090	SMAD5	chr5	135458536	135521422	62886	SMAD family member 5
PA30529	4091	SMAD6	chr15	66984674	67077338	92664	SMAD family member 6
PA134875286	4092	SMAD7	chr18	46443223	46487081	43858	SMAD family member 7
PA30531	4093	SMAD9	chr13	37415968	37504409	88441	SMAD family member 9
PA165513352	57228	SMAGP	chr12	51636133	51674202	38069	small cell adhesion glycoprotein
PA134893764	60682	SMAP1	chr6	71367474	71574718	207244	small ArfGAP 1
PA162403939	64744	SMAP2	chr1	40829378	40891998	62620	small ArfGAP2
PA35947	6594	SMARCA1	chrX	128577478	128667490	90012	SWI/SNF related, matrix associated, actin dependent regulator of chromatin, subfamily a, member 1
PA35948	6595	SMARCA2	chr9	2005342	2196624	191282	SWI/SNF related, matrix associated, actin dependent regulator of chromatin, subfamily a, member 2
PA35950	6597	SMARCA4	chr19	11061598	11175958	114360	SWI/SNF related, matrix associated, actin dependent regulator of chromatin, subfamily a, member 4
PA35951	8467	SMARCA5	chr4	144424616	144481642	57026	SWI/SNF related, matrix associated, actin dependent regulator of chromatin, subfamily a, member 5
PA134954731	56916	SMARCAD1	chr4	95118759	95215443	96684	SWI/SNF-related, matrix-associated actin-dependent regulator of chromatin, subfamily a, containing DEAD/H box 1
PA35952	50485	SMARCAL1	chr2	217267137	217350776	83639	SWI/SNF related, matrix associated, actin dependent regulator of chromatin, subfamily a-like 1
PA35953	6598	SMARCB1	chr22	24119150	24179705	60555	SWI/SNF related, matrix associated, actin dependent regulator of chromatin, subfamily b, member 1
PA35954	6599	SMARCC1	chr3	47624378	47833405	209027	SWI/SNF related, matrix associated, actin dependent regulator of chromatin, subfamily c, member 1
PA35955	6601	SMARCC2	chr12	56552636	56593351	40715	SWI/SNF related, matrix associated, actin dependent regulator of chromatin, subfamily c, member 2
PA35956	6602	SMARCD1	chr12	50468760	50497494	28734	SWI/SNF related, matrix associated, actin dependent regulator of chromatin, subfamily d, member 1
PA35957	6603	SMARCD2	chr17	61906441	61930699	24258	SWI/SNF related, matrix associated, actin dependent regulator of chromatin, subfamily d, member 2
PA35958	6604	SMARCD3	chr7	150933059	150984231	51172	SWI/SNF related, matrix associated, actin dependent regulator of chromatin, subfamily d, member 3
PA35959	6605	SMARCE1	chr17	38778214	38815658	37444	SWI/SNF related, matrix associated, actin dependent regulator of chromatin, subfamily e, member 1
PA35961	8243	SMC1A	chrX	53398070	53459677	61607	structural maintenance of chromosomes 1A
PA35962	27127	SMC1B	chr22	45736944	45819500	82556	structural maintenance of chromosomes 1B
PA37833	10592	SMC2	chr9	106846213	106906700	60487	structural maintenance of chromosomes 2
PA26966	9126	SMC3	chr10	112317449	112367392	49943	structural maintenance of chromosomes 3
PA37834	10051	SMC4	chr3	160107078	160155755	48677	structural maintenance of chromosomes 4
PA134993662	23137	SMC5	chr9	72863878	72972789	108911	structural maintenance of chromosomes 5
PA134892702	79677	SMC6	chr2	17842079	17945096	103017	structural maintenance of chromosomes 6
PA128395776	23347	SMCHD1	chr18	2645886	2808015	162129	structural maintenance of chromosomes flexible hinge domain containing 1
PA142672378	255798	SMCO1	chr3	196230750	196252237	21487	single-pass membrane protein with coiled-coil domains 1
PA162378014	341346	SMCO2	chr12	27609743	27658118	48375	single-pass membrane protein with coiled-coil domains 2
PA162378005	440087	SMCO3	chr12	14954584	14977116	22532	single-pass membrane protein with coiled-coil domains 3
PA144596494	56935	SMCO4	chr11	93208638	93286546	77908	single-pass membrane protein with coiled-coil domains 4
PA30710	4184	SMCP	chr1	152840798	152860523	19725	sperm mitochondria-associated cysteine-rich protein
PA38266	140775	SMCR8	chr17	18208594	18234370	25776	Smith-Magenis syndrome chromosome region, candidate 8
PA145149451	91689	SMDT1	chr22	42465695	42483288	17593	single-pass membrane protein with aspartate-rich tail 1
PA162403940	55671	SMEK1	chr14	91920955	91986898	65943	SMEK homolog 1, suppressor of mek1 (Dictyostelium)
PA162403977	57223	SMEK2	chr2	55771428	55854860	83432	SMEK homolog 2, suppressor of mek1 (Dictyostelium)
PA164725852	23049	SMG1	chr16	18813175	18947748	134573	SMG1 phosphatidylinositol 3-kinase-related kinase
PA143485617	23381	SMG5	chr1	156216015	156262676	46661	SMG5 nonsense mediated mRNA decay factor
PA25584	23293	SMG6	chr17	1960133	2217069	256936	SMG6 nonsense mediated mRNA decay factor
PA25605	9887	SMG7	chr1	183431506	183526328	94822	SMG7 nonsense mediated mRNA decay factor
PA142672219	55181	SMG8	chr17	57277371	57295611	18240	SMG8 nonsense mediated mRNA decay factor
PA162378734	56006	SMG9	chr19	44229851	44269142	39291	SMG9 nonsense mediated mRNA decay factor
PA162387008	54065	SMIM11	chr21	35737749	35764452	26703	small integral membrane protein 11
PA162378876	113444	SMIM12	chr1	35312963	35335417	22454	small integral membrane protein 12
PA162379760	201895	SMIM14	chr4	39545917	39650481	104564	small integral membrane protein 14
PA162380269	643155	SMIM15	chr5	60450536	60468302	17766	small integral membrane protein 15
PA142672359	114926	SMIM19	chr8	42386298	42411140	24842	small integral membrane protein 19
PA165663312	389203	SMIM20	chr4	25905528	25934501	28973	small integral membrane protein 20
PA162378613	284274	SMIM21	chr18	73118827	73149589	30762	small integral membrane protein 21
PA162380358	644994	SMIM23	chr5	171119776	171236616	116840	small integral membrane protein 23
PA165393200	284422	SMIM24	chr19	3471405	3490540	19135	small integral membrane protein 24
PA165660222	85027	SMIM3	chr5	150147508	150179298	31790	small integral membrane protein 3
PA165696922	440957	SMIM4	chr3	52560002	52577586	17584	small integral membrane protein 4
PA144596475	79086	SMIM7	chr19	16738562	16780968	42406	small integral membrane protein 7
PA134961667	57150	SMIM8	chr6	88022306	88055043	32737	small integral membrane protein 8
PA35966	6606	SMN1	chr5	70210768	70251839	41071	survival of motor neuron 1, telomeric
PA35967	6607	SMN2	chr5	69335350	69376422	41072	survival of motor neuron 2, centromeric
PA134990780	10285	SMNDC1	chr10	112049798	112074707	24909	survival motor neuron domain containing 1
PA35968	6608	SMO	chr7	128818713	128856386	37673	smoothened, frizzled class receptor
PA134942329	64093	SMOC1	chr14	70336105	70502083	165978	SPARC related modular calcium binding 1
PA134934590	64094	SMOC2	chr6	168831831	169071674	239843	SPARC related modular calcium binding 2
PA25701	54498	SMOX	chr20	4119426	4171394	51968	spermine oxidase
PA35969	6609	SMPD1	chr11	6401644	6419228	17584	sphingomyelin phosphodiesterase 1, acid lysosomal
PA35970	6610	SMPD2	chr6	109751849	109768125	16276	sphingomyelin phosphodiesterase 2, neutral membrane (neutral sphingomyelinase)
PA37862	55512	SMPD3	chr16	68389230	68492409	103179	sphingomyelin phosphodiesterase 3, neutral membrane (neutral sphingomyelinase II)
PA145148067	55627	SMPD4	chr2	130905965	130950323	44358	sphingomyelin phosphodiesterase 4, neutral membrane (neutral sphingomyelinase-3)
PA134932128	10924	SMPDL3A	chr6	123099601	123133865	34264	sphingomyelin phosphodiesterase, acid-like 3A
PA134889099	27293	SMPDL3B	chr1	28251456	28288663	37207	sphingomyelin phosphodiesterase, acid-like 3B
PA35971	23676	SMPX	chrX	21721090	21786278	65188	small muscle protein, X-linked
PA38824	26952	SMR3A	chr4	71216493	71235823	19330	submaxillary gland androgen regulated protein 3A
PA33805	10879	SMR3B	chr4	71238795	71258961	20166	submaxillary gland androgen regulated protein 3B
PA35972	6611	SMS	chrX	21948691	22028798	80107	spermine synthase
PA35975	6525	SMTN	chr22	31467282	31503610	36328	smoothelin
PA143485618	219537	SMTNL1	chr11	57295044	57320747	25703	smoothelin-like 1
PA145007828	342527	SMTNL2	chr17	4477276	4514614	37338	smoothelin-like 2
PA134903890	55234	SMU1	chr9	33038850	33086714	47864	smu-1 suppressor of mec-8 and unc-52 homolog (C. elegans)
PA142670895	23583	SMUG1	chr12	54571142	54592778	21636	single-strand-selective monofunctional uracil-DNA glycosylase 1
PA134987175	57154	SMURF1	chr7	98622058	98751743	129685	SMAD specific E3 ubiquitin protein ligase 1
PA134985524	64750	SMURF2	chr17	62535400	62668386	132986	SMAD specific E3 ubiquitin protein ligase 2
PA134862943	150572	SMYD1	chr2	88357299	88415906	58607	SET and MYND domain containing 1
PA134930268	56950	SMYD2	chr1	214444565	214513477	68912	SET and MYND domain containing 2
PA37972	64754	SMYD3	chr1	245909642	246680644	771002	SET and MYND domain containing 3
PA134925431	114826	SMYD4	chr17	1679829	1743175	63346	SET and MYND domain containing 4
PA34190	10322	SMYD5	chr2	73431366	73457355	25989	SMYD family member 5
PA35977	6615	SNAI1	chr20	48589513	48608423	18910	snail family zinc finger 1
PA35945	6591	SNAI2	chr8	49827236	49843999	16763	snail family zinc finger 2
PA134988226	333929	SNAI3	chr16	88741090	88763192	22102	snail family zinc finger 3
PA35979	8773	SNAP23	chr15	42773442	42828259	54817	synaptosomal-associated protein, 23kDa
PA35980	6616	SNAP25	chr20	10189477	10291068	101591	synaptosomal-associated protein, 25kDa
PA35981	9342	SNAP29	chr22	21203292	21248502	45210	synaptosomal-associated protein, 29kDa
PA164725983	116841	SNAP47	chr1	227912697	227971932	59235	synaptosomal-associated protein, 47kDa
PA37956	9892	SNAP91	chr6	84259604	84429127	169523	synaptosomal-associated protein, 91kDa
PA35982	6617	SNAPC1	chr14	62219075	62266146	47071	small nuclear RNA activating complex, polypeptide 1, 43kDa
PA35983	6618	SNAPC2	chr19	7975194	7991136	15942	small nuclear RNA activating complex, polypeptide 2, 45kDa
PA35984	6619	SNAPC3	chr9	15412694	15469747	57053	small nuclear RNA activating complex, polypeptide 3, 50kDa
PA35985	6621	SNAPC4	chr9	139267021	139304655	37634	small nuclear RNA activating complex, polypeptide 4, 190kDa
PA37967	10302	SNAPC5	chr15	66779666	66800146	20480	small nuclear RNA activating complex, polypeptide 5, 19kDa
PA162404012	23557	SNAPIN	chr1	153621130	153637328	16198	SNAP-associated protein
PA35986	6622	SNCA	chr4	90642250	90769447	127197	synuclein, alpha (non A4 component of amyloid precursor)
PA35987	9627	SNCAIP	chr5	121637455	121802794	165339	synuclein, alpha interacting protein
PA35988	6620	SNCB	chr5	176044210	176067557	23347	synuclein, beta
PA35989	6623	SNCG	chr10	88707504	88726017	18513	synuclein, gamma (breast cancer-specific protein 1)
PA162404053	27044	SND1	chr7	127282043	127735659	453616	staphylococcal nuclease and tudor domain containing 1
PA134946370	25992	SNED1	chr2	241928213	242041515	113302	sushi, nidogen and EGF-like domains 1
PA142670892	11267	SNF8	chr17	47004458	47032484	28026	SNF8, ESCRT-II complex subunit
PA34484	8420	SNHG3	chr1	28822455	28840404	17949	small nucleolar RNA host gene 3 (non-protein coding)
PA142670893	79753	SNIP1	chr1	37997050	38029945	32895	Smad nuclear interacting protein 1
PA35991	8303	SNN	chr16	11752289	11776015	23726	stannin
PA144596337	677802	SNORA14B	chr1	235288118	235301252	13134	small nucleolar RNA, H/ACA box 14B
PA38053	9751	SNPH	chr20	1236948	1292971	56023	syntaphilin
PA142670894	54861	SNRK	chr3	43318004	43395635	77631	SNF related kinase
PA164726004	23020	SNRNP200	chr2	96937074	96981307	44233	small nuclear ribonucleoprotein 200kDa (U5)
PA164726099	79622	SNRNP25	chr16	93829	110669	16840	small nuclear ribonucleoprotein 25kDa (U11/U12)
PA164726114	11017	SNRNP27	chr2	70111075	70135368	24293	small nuclear ribonucleoprotein 27kDa (U4/U6.U5)
PA164726115	11066	SNRNP35	chr12	123932191	123953941	21750	small nuclear ribonucleoprotein 35kDa (U11/U12)
PA164726132	9410	SNRNP40	chr1	31729415	31779644	50229	small nuclear ribonucleoprotein 40kDa (U5)
PA164726157	154007	SNRNP48	chr6	7580432	7615200	34768	small nuclear ribonucleoprotein 48kDa (U11/U12)
PA35992	6625	SNRNP70	chr19	49578465	49614870	36405	small nuclear ribonucleoprotein 70kDa (U1)
PA35993	6626	SNRPA	chr19	41246725	41274297	27572	small nuclear ribonucleoprotein polypeptide A
PA35994	6627	SNRPA1	chr15	101818715	101845481	26766	small nuclear ribonucleoprotein polypeptide A'
PA35995	6628	SNRPB	chr20	2439281	2461499	22218	small nuclear ribonucleoprotein polypeptides B and B1
PA35996	6629	SNRPB2	chr20	16700609	16725417	24808	small nuclear ribonucleoprotein polypeptide B
PA35998	6631	SNRPC	chr6	34714871	34744634	29763	small nuclear ribonucleoprotein polypeptide C
PA164742464	6632	SNRPD1	chr18	19182260	19213208	30948	small nuclear ribonucleoprotein D1 polypeptide 16kDa
PA36000	6633	SNRPD2	chr19	46187712	46205569	17857	small nuclear ribonucleoprotein D2 polypeptide 16.5kDa
PA36001	6634	SNRPD3	chr22	24941618	24973932	32314	small nuclear ribonucleoprotein D3 polypeptide 18kDa
PA36002	6635	SNRPE	chr1	203820740	203843280	22540	small nuclear ribonucleoprotein polypeptide E
PA36003	6636	SNRPF	chr12	96242709	96263238	20529	small nuclear ribonucleoprotein polypeptide F
PA36004	6637	SNRPG	chr2	70505510	70530869	25359	small nuclear ribonucleoprotein polypeptide G
PA36005	6638	SNRPN	chr15	25058794	25667609	608815	small nuclear ribonucleoprotein polypeptide N
PA36007	6640	SNTA1	chr20	31992763	32041698	48935	syntrophin, alpha 1
PA36008	6641	SNTB1	chr8	121544985	121835599	290614	syntrophin, beta 1 (dystrophin-associated protein A1, 59kDa, basic component 1)
PA36009	6645	SNTB2	chr16	69211050	69345955	134905	syntrophin, beta 2 (dystrophin-associated protein A1, 59kDa, basic component 2)
PA37806	54212	SNTG1	chr8	50812349	51709171	896822	syntrophin, gamma 1
PA37807	54221	SNTG2	chr2	936554	1374401	437847	syntrophin, gamma 2
PA164726205	132203	SNTN	chr3	63628344	63653893	25549	sentan, cilia apical structure protein
PA34611	10073	SNUPN	chr15	75887424	75928719	41295	snurportin 1
PA36010	8926	SNURF	chr15	25190070	25226729	36659	SNRPN upstream reading frame
PA134883977	22938	SNW1	chr14	78180942	78237542	56600	SNW domain containing 1
PA36011	6642	SNX1	chr15	64376275	64439433	63158	sorting nexin 1
PA37950	29887	SNX10	chr7	26321515	26416949	95434	sorting nexin 10
PA37951	29916	SNX11	chr17	46174911	46203109	28198	sorting nexin 11
PA37952	29934	SNX12	chrX	70204156	70303276	99120	sorting nexin 12
PA129697240	23161	SNX13	chr7	17827385	17990141	162756	sorting nexin 13
PA129840867	57231	SNX14	chr6	86212214	86313850	101636	sorting nexin 14
PA37953	29907	SNX15	chr11	64784880	64811044	26164	sorting nexin 15
PA134972049	64089	SNX16	chr8	82708816	82764539	55723	sorting nexin 16
PA37954	9784	SNX17	chr2	27583363	27603400	20037	sorting nexin 17
PA162404304	112574	SNX18	chr5	53803589	53845416	41827	sorting nexin 18
PA134904352	399979	SNX19	chr11	130742766	130796382	53616	sorting nexin 19
PA36012	6643	SNX2	chr5	122100691	122173234	72543	sorting nexin 2
PA162404311	124460	SNX20	chr16	50697211	50725264	28053	sorting nexin 20
PA25703	90203	SNX21	chr20	44452256	44474914	22658	sorting nexin family member 21
PA134897329	79856	SNX22	chr15	64433899	64452680	18781	sorting nexin 22
PA134980773	28966	SNX24	chr5	122171149	122350317	179168	sorting nexin 24
PA134988505	83891	SNX25	chr4	186120773	186288120	167347	sorting nexin 25
PA134969143	81609	SNX27	chr1	151574454	151674559	100105	sorting nexin family member 27
PA162404312	92017	SNX29	chr16	12060602	12671146	610544	sorting nexin 29
PA36013	8724	SNX3	chr6	108529712	108592478	62766	sorting nexin 3
PA142670889	401548	SNX30	chr9	115501911	115640267	138356	sorting nexin family member 30
PA162404313	169166	SNX31	chr8	101582110	101671893	89783	sorting nexin 31
PA162404314	254122	SNX32	chr11	65591305	65624578	33273	sorting nexin 32
PA162404345	257364	SNX33	chr15	75931348	75953968	22620	sorting nexin 33
PA36014	8723	SNX4	chr3	125162488	125249058	86570	sorting nexin 4
PA37945	27131	SNX5	chr20	17919244	17959490	40246	sorting nexin 5
PA37946	58533	SNX6	chr14	35027615	35109366	81751	sorting nexin 6
PA37947	51375	SNX7	chr1	99117236	99229056	111820	sorting nexin 7
PA37948	29886	SNX8	chr7	2288405	2364099	75694	sorting nexin 8
PA37949	51429	SNX9	chr6	158127078	158369109	242031	sorting nexin 9
PA36015	6646	SOAT1	chr1	179252849	179330815	77966	sterol O-acyltransferase 1
PA36016	8435	SOAT2	chr12	53487274	53521323	34049	sterol O-acyltransferase 2
PA162404346	55084	SOBP	chr6	107801317	107985513	184196	sine oculis binding protein homolog (Drosophila)
PA134863068	8651	SOCS1	chr16	11345274	11360039	14765	suppressor of cytokine signaling 1
PA128394542	8835	SOCS2	chr12	93953598	93973521	19923	suppressor of cytokine signaling 2
PA134885765	9021	SOCS3	chr17	76349858	76366160	16302	suppressor of cytokine signaling 3
PA164742477	122809	SOCS4	chr14	55483844	55519207	35363	suppressor of cytokine signaling 4
PA134884627	9655	SOCS5	chr2	46916099	46992927	76828	suppressor of cytokine signaling 5
PA134917653	9306	SOCS6	chr18	67946137	68000435	54298	suppressor of cytokine signaling 6
PA164742488	30837	SOCS7	chr17	36498007	36564846	66839	suppressor of cytokine signaling 7
PA334	6647	SOD1	chr21	33021935	33044244	22309	superoxide dismutase 1, soluble
PA36017	6648	SOD2	chr6	160097148	160124353	27205	superoxide dismutase 2, mitochondrial
PA36018	6649	SOD3	chr4	24787085	24805467	18382	superoxide dismutase 3, extracellular
PA25657	140710	SOGA1	chr20	35402845	35502087	99242	suppressor of glucose, autophagy associated 1
PA134983080	387104	SOGA3	chr6	127756551	127851938	95387	SOGA family member 3
PA134899168	402381	SOHLH1	chr9	138582253	138601374	19121	spermatogenesis and oogenesis specific basic helix-loop-helix 1
PA144596273	54937	SOHLH2	chr13	36739345	36798752	59407	spermatogenesis and oogenesis specific basic helix-loop-helix 2
PA36020	6651	SON	chr21	34905344	34952820	47476	SON DNA binding protein
PA37899	10580	SORBS1	chr10	97068530	97331171	262641	sorbin and SH3 domain containing 1
PA142670890	8470	SORBS2	chr4	186503598	186887870	384272	sorbin and SH3 domain containing 2
PA128394570	10174	SORBS3	chr8	22392228	22436008	43780	sorbin and SH3 domain containing 3
PA134861284	114815	SORCS1	chr10	108330421	108934466	604045	sortilin-related VPS10 domain containing receptor 1
PA134902026	57537	SORCS2	chr4	7184374	7747564	563190	sortilin-related VPS10 domain containing receptor 2
PA134949387	22986	SORCS3	chr10	106390859	107027993	637134	sortilin-related VPS10 domain containing receptor 3
PA36021	6652	SORD	chr15	45305302	45370287	64985	sorbitol dehydrogenase
PA36022	6653	SORL1	chr11	121312912	121507471	194559	sortilin-related receptor, L(DLR class) A repeats containing
PA36023	6272	SORT1	chr1	109849187	109950563	101376	sortilin 1
PA36024	6654	SOS1	chr2	39205690	39357686	151996	son of sevenless homolog 1 (Drosophila)
PA36025	6655	SOS2	chr14	50580846	50708596	127750	son of sevenless homolog 2 (Drosophila)
PA37809	50964	SOST	chr17	41828099	41846156	18057	sclerostin
PA134937603	25928	SOSTDC1	chr7	16498106	16515562	17456	sclerostin domain containing 1
PA142672610	134548	SOWAHA	chr5	132139033	132155489	16456	sosondowah ankyrin repeat domain family member A
PA145149864	345079	SOWAHB	chr4	77813082	77829002	15920	sosondowah ankyrin repeat domain family member B
PA134882354	65124	SOWAHC	chr2	110361911	110379564	17653	sosondowah ankyrin repeat domain family member C
PA145149865	347454	SOWAHD	chrX	118882576	118897165	14589	sosondowah ankyrin repeat domain family member D
PA36026	6656	SOX1	chr13	112711913	112729020	17107	SRY (sex determining region Y)-box 1
PA36027	6663	SOX10	chr22	38365319	38390556	25237	SRY (sex determining region Y)-box 10
PA36028	6664	SOX11	chr2	5822799	5844517	21718	SRY (sex determining region Y)-box 11
PA36035	6666	SOX12	chr20	296215	313872	17657	SRY (sex determining region Y)-box 12
PA36029	9580	SOX13	chr1	204032237	204099871	67634	SRY (sex determining region Y)-box 13
PA36030	8403	SOX14	chr3	137473134	137488176	15042	SRY (sex determining region Y)-box 14
PA36033	6665	SOX15	chr17	7488496	7504037	15541	SRY (sex determining region Y)-box 15
PA38296	64321	SOX17	chr8	55360495	55376456	15961	SRY (sex determining region Y)-box 17
PA36031	54345	SOX18	chr20	62676079	62690979	14900	SRY (sex determining region Y)-box 18
PA36032	6657	SOX2	chr3	181419712	181435224	15512	SRY (sex determining region Y)-box 2
PA36034	11166	SOX21	chr13	95358876	95374389	15513	SRY (sex determining region Y)-box 21
PA36036	6658	SOX3	chrX	139582152	139597225	15073	SRY (sex determining region Y)-box 3
PA134876614	11063	SOX30	chr5	157048804	157109138	60334	SRY (sex determining region Y)-box 30
PA36037	6659	SOX4	chr6	21583972	21601850	17878	SRY (sex determining region Y)-box 4
PA36038	6660	SOX5	chr12	23679438	24725383	1045945	SRY (sex determining region Y)-box 5
PA38137	55553	SOX6	chr11	15984995	16507935	522940	SRY (sex determining region Y)-box 6
PA38307	83595	SOX7	chr8	10578278	10598084	19806	SRY (sex determining region Y)-box 7
PA36040	30812	SOX8	chr16	1021808	1039979	18171	SRY (sex determining region Y)-box 8
PA36041	6662	SOX9	chr17	70107161	70125561	18400	SRY (sex determining region Y)-box 9
PA36042	6667	SP1	chr12	53763979	53813230	49251	Sp1 transcription factor
PA36043	6672	SP100	chr2	231270871	231413317	142446	SP100 nuclear antigen
PA35104	3431	SP110	chr2	231030634	231100444	69810	SP110 nuclear body protein
PA38205	11262	SP140	chr2	231080445	231180930	100485	SP140 nuclear body protein
PA164726206	93349	SP140L	chr2	231181894	231271445	89551	SP140 nuclear body protein-like
PA36044	6668	SP2	chr17	45963516	46009323	45807	Sp2 transcription factor
PA36045	6670	SP3	chr2	174768187	174840430	72243	Sp3 transcription factor
PA36046	6671	SP4	chr7	21457689	21557440	99751	Sp4 transcription factor
PA134875843	389058	SP5	chr2	171561857	171577498	15641	Sp5 transcription factor
PA37892	80320	SP6	chr17	45919280	45943240	23960	Sp6 transcription factor
PA134917046	121340	SP7	chr12	53717359	53740167	22808	Sp7 transcription factor
PA134893390	221833	SP8	chr7	20818894	20836508	17614	Sp8 transcription factor
PA164726207	100131390	SP9	chr2	175189769	175208859	19090	Sp9 transcription factor
PA36047	53340	SPA17	chr11	124533740	124567690	33950	sperm autoantigenic protein 17
PA37943	81833	SPACA1	chr6	88747507	88779550	32043	sperm acrosome associated 1
PA38101	124912	SPACA3	chr17	31308882	31327895	19013	sperm acrosome associated 3
PA38141	171169	SPACA4	chr19	49100000	49113971	13971	sperm acrosome associated 4
PA134907501	389852	SPACA5	chrX	47853734	47872130	18396	sperm acrosome associated 5
PA162404365	729201	SPACA5B	chrX	47980039	47994995	14956	sperm acrosome associated 5B
PA147358486	122258	SPACA7	chr13	113020649	113092009	71360	sperm acrosome associated 7
PA36049	6674	SPAG1	chr8	101160263	101257132	96869	sperm associated antigen 1
PA162404366	653423	SPAG11A	chr8	7695209	7724319	29110	sperm associated antigen 11A
PA37894	10407	SPAG11B	chr8	7302276	7331192	28916	sperm associated antigen 11B
PA134887898	79582	SPAG16	chr2	214139103	215278225	1139122	sperm associated antigen 16
PA142670888	200162	SPAG17	chr1	118493288	118737848	244560	sperm associated antigen 17
PA36050	6676	SPAG4	chr20	34193776	34211967	18191	sperm associated antigen 4
PA134868542	10615	SPAG5	chr17	26901583	26936056	34473	sperm associated antigen 5
PA36051	9576	SPAG6	chr10	22624345	22709539	85194	sperm associated antigen 6
PA36052	9552	SPAG7	chr17	4859521	4881132	21611	sperm associated antigen 7
PA37843	26206	SPAG8	chr9	35804782	35822269	17487	sperm associated antigen 8
PA37890	9043	SPAG9	chr17	49036535	49208226	171691	sperm associated antigen 9
PA36053	6677	SPAM1	chr7	123555286	123614464	59178	sperm adhesion molecule 1 (PH-20 hyaluronidase, zona pellucida binding)
PA36054	30014	SPANXA1	chrX	140668806	140682836	14030	sperm protein associated with the nucleus, X-linked, family member A1
PA37870	728712	SPANXA2	chrX	140667835	140681899	14064	SPANX family, member A2
PA37871	728695	SPANXB1	chrX	140086761	140100876	14115	SPANX family, member B1
PA37872	100133171	SPANXB2	chrX	140074756	140088871	14115	SPANX family, member B2
PA37873	64663	SPANXC	chrX	140332596	140346646	14050	SPANX family, member C
PA37874	64648	SPANXD	chrX	140782568	140796598	14030	SPANX family, member D
PA38327	171489	SPANXE	chrX	140610235	140624322	14087	SPANX family, member E
PA38328	171490	SPANXF1	chrX	-1	-1	0	SPANX family, member F1
PA162404376	494118	SPANXN1	chrX	144319107	144340728	21621	SPANX family, member N1
PA162404384	494119	SPANXN2	chrX	142792055	142814516	22461	SPANX family, member N2
PA162404385	139067	SPANXN3	chrX	142593564	142615307	21743	SPANX family, member N3
PA162404394	441525	SPANXN4	chrX	142103704	142125066	21362	SPANX family, member N4
PA162404403	494197	SPANXN5	chrX	52822186	52836388	14202	SPANX family, member N5
PA36055	6678	SPARC	chr5	151037657	151076615	38958	secreted protein, acidic, cysteine-rich (osteonectin)
PA36056	8404	SPARCL1	chr4	88391483	88460798	69315	SPARC-like 1 (hevin)
PA36063	6683	SPAST	chr2	32278660	32385706	107046	spastin
PA37910	100505741	SPATA1	chr1	84961975	85034876	72901	spermatogenesis associated 1
PA134888733	353324	SPATA12	chr3	57084469	57112460	27991	spermatogenesis associated 12
PA134912609	221178	SPATA13	chr13	24543765	24884212	340447	spermatogenesis associated 13
PA134942358	83893	SPATA16	chr3	172604147	172869058	264911	spermatogenesis associated 16
PA144596270	128153	SPATA17	chr1	217794684	218043492	248808	spermatogenesis associated 17
PA142670883	132671	SPATA18	chr4	52907578	52966461	58883	spermatogenesis associated 18
PA142670884	219938	SPATA19	chr11	133707517	133725433	17916	spermatogenesis associated 19
PA37909	9825	SPATA2	chr20	48516928	48542080	25152	spermatogenesis associated 2
PA142670885	64847	SPATA20	chr17	48614450	48636213	21763	spermatogenesis associated 20
PA142670886	374955	SPATA21	chr1	16719101	16773919	54818	spermatogenesis associated 21
PA142670887	84690	SPATA22	chr17	3340305	3427146	86841	spermatogenesis associated 22
PA165660551	202051	SPATA24	chr5	138728514	138749820	21306	spermatogenesis associated 24
PA25707	128497	SPATA25	chr20	44512125	44527245	15120	spermatogenesis associated 25
PA162404411	124044	SPATA2L	chr16	89759765	89778131	18366	spermatogenesis associated 2-like
PA38256	130560	SPATA3	chr2	231850839	231887572	36733	spermatogenesis associated 3
PA162387841	647060	SPATA31A1	chr9	39345699	39364956	19257	SPATA31 subfamily A, member 1
PA162387854	642265	SPATA31A2	chr9	39874975	39894210	19235	SPATA31 subfamily A, member 2
PA162387867	727830	SPATA31A3	chr9	40690291	40709537	19246	SPATA31 subfamily A, member 3
PA162387880	642629	SPATA31A4	chr9	41318107	41337397	19290	SPATA31 subfamily A, member 4
PA162387890	727905	SPATA31A5	chr9	41490679	41509925	19246	SPATA31 subfamily A, member 5
PA164719932	389730	SPATA31A6	chr9	43621502	43640730	19228	SPATA31 subfamily A, member 6
PA162387900	26165	SPATA31A7	chr9	65500366	65519610	19244	SPATA31 subfamily A, member 7
PA134886884	286234	SPATA31E1	chr9	90487772	90506814	19042	SPATA31 subfamily E, member 1
PA142672229	124783	SPATA32	chr17	43328760	43349479	20719	spermatogenesis associated 32
PA142672262	124045	SPATA33	chr16	89714152	89739866	25714	spermatogenesis associated 33
PA38232	132851	SPATA4	chr4	177102725	177126822	24097	spermatogenesis associated 4
PA164717042	149643	SPATA45	chr1	213000483	213030991	30508	spermatogenesis associated 45
PA38294	166378	SPATA5	chr4	123834225	124243605	409380	spermatogenesis associated 5
PA134923477	79029	SPATA5L1	chr15	45684514	45716617	32103	spermatogenesis associated 5-like 1
PA38312	54558	SPATA6	chr1	48758044	48947876	189832	spermatogenesis associated 6
PA134880636	55064	SPATA6L	chr9	4550386	4676674	126288	spermatogenesis associated 6-like
PA134907300	55812	SPATA7	chr14	88841982	88907804	65822	spermatogenesis associated 7
PA134977227	145946	SPATA8	chr15	97316676	97331845	15169	spermatogenesis associated 8
PA134900368	83890	SPATA9	chr5	94984885	95028885	44000	spermatogenesis associated 9
PA134907641	375686	SPATC1	chr8	145076582	145105015	28433	spermatogenesis and centriole associated 1
PA25851	84221	SPATC1L	chr21	47578062	47615167	37105	spermatogenesis and centriole associated 1-like
PA134922278	221409	SPATS1	chr6	44300383	44347904	47521	spermatogenesis associated, serine-rich 1
PA134871579	65244	SPATS2	chr12	49750688	49924208	173520	spermatogenesis associated, serine-rich 2
PA165697465	26010	SPATS2L	chr2	201160604	201349986	189382	spermatogenesis associated, serine-rich 2-like
PA162404412	147841	SPC24	chr19	11254444	11276563	22119	SPC24, NDC80 kinetochore complex component
PA162404413	57405	SPC25	chr2	169724401	169757277	32876	SPC25, NDC80 kinetochore complex component
PA134972486	28972	SPCS1	chr3	52729792	52745198	15406	signal peptidase complex subunit 1 homolog (S. cerevisiae)
PA128394559	9789	SPCS2	chr11	74650292	74693076	42784	signal peptidase complex subunit 2 homolog (S. cerevisiae)
PA134910080	60559	SPCS3	chr4	177231090	177256396	25306	signal peptidase complex subunit 3 homolog (S. cerevisiae)
PA134993886	25803	SPDEF	chr6	34502579	34534110	31531	SAM pointed domain containing ETS transcription factor
PA144596466	54908	SPDL1	chr5	169000638	169034782	34144	spindle apparatus coiled-coil protein 1
PA134954857	245711	SPDYA	chr2	29023462	29076476	53014	speedy/RINGO cell cycle regulator family member A
PA144596271	387778	SPDYC	chr11	64927707	64943688	15981	speedy/RINGO cell cycle regulator family member C
PA38135	285955	SPDYE1	chr7	44028552	44052723	24171	speedy/RINGO cell cycle regulator family member E1
PA164726233	441273	SPDYE2	chr7	102181679	102205757	24078	speedy/RINGO cell cycle regulator family member E2
PA164726234	441272	SPDYE3	chr7	99895325	99922819	27494	speedy/RINGO cell cycle regulator family member E3
PA164726235	388333	SPDYE4	chr17	8647849	8671977	24128	speedy/RINGO cell cycle regulator family member E4
PA164726251	442590	SPDYE5	chr7	74685028	75136628	451600	speedy/RINGO cell cycle regulator family member E5
PA164726272	729597	SPDYE6	chr7	101983192	102007468	24276	speedy/RINGO cell cycle regulator family member E6
PA164718712	92521	SPECC1	chr17	19902649	20221072	318423	sperm antigen with calponin homology and coiled-coil domains 1
PA164718673	23384	SPECC1L	chr22	24656785	24816708	159923	sperm antigen with calponin homology and coiled-coil domains 1-like
PA162404432	25876	SPEF1	chr20	3755151	3772113	16962	sperm flagellar 1
PA162404451	79925	SPEF2	chr5	35607900	35817713	209813	sperm flagellar 2
PA142672598	10290	SPEG	chr2	220289552	220361354	71802	SPEG complex locus
PA162404476	374768	SPEM1	chr17	7313652	7327956	14304	spermatid maturation 1
PA134895302	23013	SPEN	chr1	16164359	16269951	105592	spen family transcriptional repressor
PA144596272	220082	SPERT	chr13	46266446	46291694	25248	spermatid associated
PA37980	246777	SPESP1	chr15	69212839	69242150	29311	sperm equatorial segment protein 1
PA36058	80208	SPG11	chr15	44851894	44965876	113982	spastic paraplegia 11 (autosomal recessive)
PA134871645	23111	SPG20	chr13	36872775	36954317	81542	spastic paraplegia 20 (Troyer syndrome)
PA134921126	51324	SPG21	chr15	65252363	65292251	39888	spastic paraplegia 21 (autosomal recessive, Mast syndrome)
PA36067	6687	SPG7	chr16	89564802	89627174	62372	spastic paraplegia 7 (pure and complicated autosomal recessive)
PA145021510	10638	SPHAR	chr1	229430129	229444251	14122	S-phase response (cyclin related)
PA36070	8877	SPHK1	chr17	74362742	74386941	24199	sphingosine kinase 1
PA38719	56848	SPHK2	chr19	49112548	49136974	24426	sphingosine kinase 2
PA162404477	80309	SPHKAP	chr2	228841670	229056836	215166	SPHK1 interactor, AKAP domain containing
PA36071	6688	SPI1	chr11	47373409	47410127	36718	Spi-1 proto-oncogene
PA36072	6689	SPIB	chr19	50912195	50937310	25115	Spi-B transcription factor (Spi-1/PU.1 related)
PA134897775	121599	SPIC	chr12	101859133	101883954	24821	Spi-C transcription factor (Spi-1/PU.1 related)
PA142672168	152185	SPICE1	chr3	113158565	113244034	85469	spindle and centriole associated protein 1
PA142671636	23514	SPIDR	chr8	48163489	48651563	488074	scaffolding protein involved in DNA repair
PA162404504	10927	SPIN1	chr9	90992584	91096623	104039	spindlin 1
PA162404521	54466	SPIN2A	chrX	57159036	57174093	15057	spindlin family, member 2A
PA162404530	474343	SPIN2B	chrX	57143115	57157989	14874	spindlin family, member 2B
PA134909757	169981	SPIN3	chrX	56999803	57031988	32185	spindlin family, member 3
PA162404539	139886	SPIN4	chrX	62564107	62581218	17111	spindlin family, member 4
PA36074	6690	SPINK1	chr5	147201143	147228794	27651	serine peptidase inhibitor, Kazal type 1
PA165660568	153218	SPINK13	chr5	147638423	147668773	30350	serine peptidase inhibitor, Kazal type 13 (putative)
PA165660569	408187	SPINK14	chr5	147538109	147558182	20073	serine peptidase inhibitor, Kazal type 14 (putative)
PA36075	6691	SPINK2	chr4	57673026	57698035	25009	serine peptidase inhibitor, Kazal type 2 (acrosin-trypsin inhibitor)
PA38180	27290	SPINK4	chr9	33230196	33251565	21369	serine peptidase inhibitor, Kazal type 4
PA37962	11005	SPINK5	chr5	147433535	147519925	86390	serine peptidase inhibitor, Kazal type 5
PA134915474	404203	SPINK6	chr5	147572357	147597700	25343	serine peptidase inhibitor, Kazal type 6
PA143485620	84651	SPINK7	chr5	147681990	147698482	16492	serine peptidase inhibitor, Kazal type 7 (putative)
PA162404546	646424	SPINK8	chr3	48345336	48379831	34495	serine peptidase inhibitor, Kazal type 8 (putative)
PA162404560	643394	SPINK9	chr5	147705122	147722412	17290	serine peptidase inhibitor, Kazal type 9
PA36076	6692	SPINT1	chr15	41126246	41152853	26607	serine peptidase inhibitor, Kunitz type 1
PA36077	10653	SPINT2	chr19	38745098	38786254	41156	serine peptidase inhibitor, Kunitz type, 2
PA36078	10816	SPINT3	chr20	44138101	44154264	16163	serine peptidase inhibitor, Kunitz type, 3
PA25679	391253	SPINT4	chr20	44340988	44357335	16347	serine peptidase inhibitor, Kunitz type 4
PA134895885	56907	SPIRE1	chr18	12443511	12671456	227945	spire-type actin nucleation factor 1
PA134926582	84501	SPIRE2	chr16	89884883	89940727	55844	spire-type actin nucleation factor 2
PA36079	6693	SPN	chr16	29664271	29684828	20557	sialophorin
PA162404561	83985	SPNS1	chr16	28976028	28998869	22841	spinster homolog 1 (Drosophila)
PA162404590	124976	SPNS2	chr17	4392129	4446228	54099	spinster homolog 2 (Drosophila)
PA162404621	201305	SPNS3	chr17	4327219	4394499	67280	spinster homolog 3 (Drosophila)
PA36080	23626	SPO11	chr20	55894831	55922049	27218	SPO11 meiotic protein covalently bound to DSB
PA134930231	90853	SPOCD1	chr1	32253023	32291630	38607	SPOC domain containing 1
PA36081	6695	SPOCK1	chr5	136307987	136845018	537031	sparc/osteonectin, cwcv and kazal-like domains proteoglycan (testican) 1
PA128394560	9806	SPOCK2	chr10	73815792	73858790	42998	sparc/osteonectin, cwcv and kazal-like domains proteoglycan (testican) 2
PA134977377	50859	SPOCK3	chr4	167651535	168165741	514206	sparc/osteonectin, cwcv and kazal-like domains proteoglycan (testican) 3
PA36082	10418	SPON1	chr11	13974184	14292679	318495	spondin 1, extracellular matrix protein
PA36083	10417	SPON2	chr4	1157720	1212750	55030	spondin 2, extracellular matrix protein
PA36084	8405	SPOP	chr17	47673246	47765525	92279	speckle-type POZ protein
PA162404650	339745	SPOPL	chr2	139249350	139333805	84455	speckle-type POZ protein-like
PA36085	6696	SPP1	chr4	88886802	88907563	20761	secreted phosphoprotein 1
PA36086	6694	SPP2	chr2	234949346	234988776	39430	secreted phosphoprotein 2, 24kDa
PA36087	6697	SPR	chr2	73104512	73122289	17777	sepiapterin reductase (7,8-dihydrobiopterin:NADP+ oxidoreductase)
PA134897382	161742	SPRED1	chr15	38534925	38652450	117525	sprouty-related, EVH1 domain containing 1
PA134956365	200734	SPRED2	chr2	65531580	65669733	138153	sprouty-related, EVH1 domain containing 2
PA134871045	399473	SPRED3	chr19	38870840	38893524	22684	sprouty-related, EVH1 domain containing 3
PA142670876	503542	SPRN	chr10	135231170	135248623	17453	shadow of prion protein homolog (zebrafish)
PA36088	6698	SPRR1A	chr1	152946564	152961290	14726	small proline-rich protein 1A
PA36089	6699	SPRR1B	chr1	152993679	153008376	14697	small proline-rich protein 1B
PA36090	6700	SPRR2A	chr1	153025596	153039988	14392	small proline-rich protein 2A
PA36091	6701	SPRR2B	chr1	153039717	153054084	14367	small proline-rich protein 2B
PA36093	6703	SPRR2D	chr1	153009201	153023594	14393	small proline-rich protein 2D
PA36094	6704	SPRR2E	chr1	153062611	153077001	14390	small proline-rich protein 2E
PA36095	6705	SPRR2F	chr1	153081612	153095989	14377	small proline-rich protein 2F
PA36096	6706	SPRR2G	chr1	153119058	153133427	14369	small proline-rich protein 2G
PA36097	6707	SPRR3	chr1	152964223	152979332	15109	small proline-rich protein 3
PA134866393	163778	SPRR4	chr1	152933128	152948069	14941	small proline-rich protein 4
PA142672442	83932	SPRTN	chr1	231463682	231509297	45615	SprT-like N-terminal domain
PA36098	10252	SPRY1	chr4	124307946	124327915	19969	sprouty homolog 1, antagonist of FGF signaling (Drosophila)
PA36099	10253	SPRY2	chr13	80907111	80925086	17975	sprouty homolog 2 (Drosophila)
PA36100	10251	SPRY3	chrY	59090457	59118123	27666	sprouty homolog 3 (Drosophila)
PA37975	81848	SPRY4	chr5	141686992	141714620	27628	sprouty homolog 4 (Drosophila)
PA143485621	84926	SPRYD3	chr12	53455100	53483204	28104	SPRY domain containing 3
PA143485622	283377	SPRYD4	chr12	56852301	56867769	15468	SPRY domain containing 4
PA25511	57213	SPRYD7	chr13	50483842	50520626	36784	SPRY domain containing 7
PA142670871	80176	SPSB1	chr1	9325202	9432591	107389	splA/ryanodine receptor domain and SOCS box containing 1
PA142670872	84727	SPSB2	chr12	6977099	6992521	15422	splA/ryanodine receptor domain and SOCS box containing 2
PA142670873	90864	SPSB3	chr16	1823713	1842582	18869	splA/ryanodine receptor domain and SOCS box containing 3
PA142670874	92369	SPSB4	chr3	140760743	140870453	109710	splA/ryanodine receptor domain and SOCS box containing 4
PA36101	6708	SPTA1	chr1	158577496	158666506	89010	spectrin, alpha, erythrocytic 1
PA36102	6709	SPTAN1	chr9	131304837	131398944	94107	spectrin, alpha, non-erythrocytic 1
PA36103	6710	SPTB	chr14	65210001	65356604	146603	spectrin, beta, erythrocytic
PA36104	6711	SPTBN1	chr2	54673454	54901583	228129	spectrin, beta, non-erythrocytic 1
PA36105	6712	SPTBN2	chr11	66446967	66506716	59749	spectrin, beta, non-erythrocytic 2
PA37918	57731	SPTBN4	chr19	40963050	41085365	122315	spectrin, beta, non-erythrocytic 4
PA38020	51332	SPTBN5	chr15	42137344	42196275	58931	spectrin, beta, non-erythrocytic 5
PA36106	10558	SPTLC1	chr9	94790416	94887756	97340	serine palmitoyltransferase, long chain base subunit 1
PA36107	9517	SPTLC2	chr14	77969340	78093110	123770	serine palmitoyltransferase, long chain base subunit 2
PA162404677	55304	SPTLC3	chr20	12979627	13150411	170784	serine palmitoyltransferase, long chain base subunit 3
PA128394765	171546	SPTSSA	chr14	34899144	34941468	42324	serine palmitoyltransferase, small subunit A
PA143485333	165679	SPTSSB	chr3	161059580	161100662	41082	serine palmitoyltransferase, small subunit B
PA142670875	144108	SPTY2D1	chr11	18624948	18666020	41072	SPT2, Suppressor of Ty, domain containing 1 (S. cerevisiae)
PA143485369	80763	SPX	chr12	21669256	21687210	17954	spexin hormone
PA142670869	84654	SPZ1	chr5	79605790	79620661	14871	spermatogenic leucine zipper 1
PA36108	6713	SQLE	chr8	126000720	126037525	36805	squalene epoxidase
PA134894920	58472	SQRDL	chr15	45913346	45986492	73146	sulfide quinone reductase-like (yeast)
PA36109	8878	SQSTM1	chr5	179223388	179268078	44690	sequestosome 1
PA36110	10011	SRA1	chr5	139926652	139947678	21026	steroid receptor RNA activator 1
PA144596269	55133	SRBD1	chr2	45612819	45848434	235615	S1 RNA binding domain 1
PA36111	6714	SRC	chr20	35963088	36036835	73747	SRC proto-oncogene, non-receptor tyrosine kinase
PA162404706	10847	SRCAP	chr16	30699571	30754450	54879	Snf2-related CREBBP activator protein
PA165432823	80725	SRCIN1	chr17	36683259	36772183	88924	SRC kinase signaling inhibitor 1
PA36112	6715	SRD5A1	chr5	6623500	6672675	49175	steroid-5-alpha-reductase, alpha polypeptide 1 (3-oxo-5 alpha-steroid delta 4-dehydrogenase alpha 1)
PA36113	6716	SRD5A2	chr2	31746656	31816040	69384	steroid-5-alpha-reductase, alpha polypeptide 2 (3-oxo-5 alpha-steroid delta 4-dehydrogenase alpha 2)
PA162404779	79644	SRD5A3	chr4	56202388	56242267	39879	steroid 5 alpha-reductase 3
PA335	6720	SREBF1	chr17	17711663	17750331	38668	sterol regulatory element binding transcription factor 1
PA336	6721	SREBF2	chr22	42219083	42306312	87229	sterol regulatory element binding transcription factor 2
PA38255	140890	SREK1	chr5	65430046	65482444	52398	splicing regulatory glutamine/lysine-rich protein 1
PA162402954	285672	SREK1IP1	chr5	64010975	64074496	63521	SREK1-interacting protein 1
PA36116	6722	SRF	chr6	43128920	43152244	23324	serum response factor (c-fos serum response element-binding transcription factor)
PA142670870	153443	SRFBP1	chr5	121287656	121367295	79639	serum response factor binding protein 1
PA134887956	57522	SRGAP1	chr12	64228276	64544643	316367	SLIT-ROBO Rho GTPase activating protein 1
PA164742513	23380	SRGAP2	chr1	206506197	206640783	134586	SLIT-ROBO Rho GTPase activating protein 2
PA134935463	9901	SRGAP3	chr3	9019275	9301369	282094	SLIT-ROBO Rho GTPase activating protein 3
PA33733	5552	SRGN	chr10	70837828	70867567	29739	serglycin
PA36117	6717	SRI	chr7	87831430	87866308	34878	sorcin
PA36119	6345	SRL	chr16	4236375	4302081	65706	sarcalumenin
PA36120	6723	SRM	chr1	11111649	11130091	18442	spermidine synthase
PA36122	6725	SRMS	chr20	62169163	62188857	19694	src-related kinase lacking C-terminal regulatory tyrosine and N-terminal myristylation sites
PA36123	6727	SRP14	chr15	40324891	40341389	16498	signal recognition particle 14kDa (homologous Alu RNA binding protein)
PA36124	6728	SRP19	chr5	112186885	112231776	44891	signal recognition particle 19kDa
PA36125	6729	SRP54	chr14	35441901	35501773	59872	signal recognition particle 54kDa
PA36126	6730	SRP68	chr17	74031856	74078607	46751	signal recognition particle 68kDa
PA36127	6731	SRP72	chr4	57323370	57372847	49477	signal recognition particle 72kDa
PA36128	6726	SRP9	chr1	225955515	225981168	25653	signal recognition particle 9kDa
PA134920046	653226	SRP9P1	chr10	93562800	93577289	14489	signal recognition particle 9 pseudogene 1
PA36129	6732	SRPK1	chr6	35797811	35898957	101146	SRSF protein kinase 1
PA36130	6733	SRPK2	chr7	104751048	105049614	298566	SRSF protein kinase 2
PA162404805	26576	SRPK3	chrX	153036456	153054187	17731	SRSF protein kinase 3
PA36131	6734	SRPR	chr11	126129814	126148877	19063	signal recognition particle receptor (docking protein)
PA128394701	58477	SRPRB	chr3	133492877	133543336	50459	signal recognition particle receptor, B subunit
PA36133	8406	SRPX	chrX	38005588	38090177	84589	sushi-repeat containing protein, X-linked
PA134983994	27286	SRPX2	chrX	99889163	99929296	40133	sushi-repeat containing protein, X-linked 2
PA37877	63826	SRR	chr17	2197244	2231553	34309	serine racemase
PA162404806	402055	SRRD	chr22	26869850	26890904	21054	SRR1 domain containing
PA38177	10250	SRRM1	chr1	24959594	25002772	43178	serine/arginine repetitive matrix 1
PA38178	23524	SRRM2	chr16	2792330	2824413	32083	serine/arginine repetitive matrix 2
PA165618294	222183	SRRM3	chr7	75821211	75919609	98398	serine/arginine repetitive matrix 3
PA165513415	84530	SRRM4	chr12	119409300	119603856	194556	serine/arginine repetitive matrix 4
PA165394321	100170229	SRRM5	chr19	44106253	44121650	15397	serine/arginine repetitive matrix 5
PA164726295	51593	SRRT	chr7	100462701	100489285	26584	serrate, RNA effector molecule
PA35696	6426	SRSF1	chr17	56075280	56094707	19427	serine/arginine-rich splicing factor 1
PA28427	10772	SRSF10	chr1	24289935	24316953	27018	serine/arginine-rich splicing factor 10
PA35698	9295	SRSF11	chr1	70661365	70720703	59338	serine/arginine-rich splicing factor 11
PA165618223	135295	SRSF12	chr6	89802678	89837800	35122	serine/arginine-rich splicing factor 12
PA35699	6427	SRSF2	chr17	74727197	74743493	16296	serine/arginine-rich splicing factor 2
PA35701	6428	SRSF3	chr6	36552090	36575244	23154	serine/arginine-rich splicing factor 3
PA35702	6429	SRSF4	chr1	29471250	29518637	47387	serine/arginine-rich splicing factor 4
PA35703	6430	SRSF5	chr14	70223812	70241722	17910	serine/arginine-rich splicing factor 5
PA35704	6431	SRSF6	chr20	42076504	42095245	18741	serine/arginine-rich splicing factor 6
PA35705	6432	SRSF7	chr2	38967741	38988636	20895	serine/arginine-rich splicing factor 7
PA165543687	10929	SRSF8	chr11	94790041	94807387	17346	serine/arginine-rich splicing factor 8
PA35707	8683	SRSF9	chr12	120896471	120917558	21087	serine/arginine-rich splicing factor 9
PA25681	140809	SRXN1	chr20	624259	644014	19755	sulfiredoxin 1
PA36135	6736	SRY	chrY	2651896	2665782	13886	sex determining region Y
PA36164	6760	SS18	chr18	23593217	23681176	87959	synovial sarcoma translocation, chromosome 18
PA37989	26039	SS18L1	chr20	60708816	60760566	51750	synovial sarcoma translocation gene on chromosome 18-like 1
PA37990	51188	SS18L2	chr3	42613332	42639490	26158	synovial sarcoma translocation gene on chromosome 18-like 2
PA36140	6741	SSB	chr2	170645322	170671574	26252	Sjogren syndrome antigen B (autoantigen La)
PA36141	6742	SSBP1	chr7	141428121	141453288	25167	single-stranded DNA binding protein 1, mitochondrial
PA38046	23635	SSBP2	chr5	80710179	81057072	346893	single-stranded DNA binding protein 2
PA38017	23648	SSBP3	chr1	54688104	54882068	193964	single stranded DNA binding protein 3
PA38018	170463	SSBP4	chr19	18519679	18548372	28693	single stranded DNA binding protein 4
PA37883	136853	SSC4D	chr7	76015646	76049012	33366	scavenger receptor cysteine rich family, 4 domains
PA36143	6744	SSFA2	chr2	182746472	182798465	51993	sperm specific antigen 2
PA134941788	54434	SSH1	chr12	109173466	109261359	87893	slingshot protein phosphatase 1
PA134861867	85464	SSH2	chr17	27949956	28267231	317275	slingshot protein phosphatase 2
PA134929326	54961	SSH3	chr11	67060919	67083078	22159	slingshot protein phosphatase 3
PA162380490	136263	SSMEM1	chr7	129829317	129859684	30367	serine-rich single-pass membrane protein 1
PA36145	8636	SSNA1	chr9	140073029	140087822	14793	Sjogren syndrome nuclear autoantigen 1
PA36146	8082	SSPN	chr12	26338032	26390710	52678	sarcospan
PA142670865	23145	SSPO	chr7	149463131	149534054	70923	SCO-spondin
PA36147	6745	SSR1	chr6	7278283	7323541	45258	signal sequence receptor, alpha
PA36148	6746	SSR2	chr1	155975839	156000758	24919	signal sequence receptor, beta (translocon-associated protein beta)
PA36149	6747	SSR3	chr3	156254929	156282973	28044	signal sequence receptor, gamma (translocon-associated protein gamma)
PA36150	6748	SSR4	chrX	153049630	153066967	17337	signal sequence receptor, delta
PA36151	6749	SSRP1	chr11	57090459	57113351	22892	structure specific recognition protein 1
PA36152	10534	SSSCA1	chr11	65326651	65343075	16424	Sjogren syndrome/scleroderma autoantigen 1
PA36153	6750	SST	chr3	187383694	187398201	14507	somatostatin
PA36154	6751	SSTR1	chr14	38667204	38685268	18064	somatostatin receptor 1
PA36155	6752	SSTR2	chr17	71151160	71171094	19934	somatostatin receptor 2
PA36156	6753	SSTR3	chr22	37597277	37626472	29195	somatostatin receptor 3
PA36157	6754	SSTR4	chr20	23006057	23020314	14257	somatostatin receptor 4
PA36158	6755	SSTR5	chr16	1112756	1134454	21698	somatostatin receptor 5
PA142670866	29101	SSU72	chr1	1474053	1520262	46209	SSU72 RNA polymerase II CTD phosphatase homolog (S. cerevisiae)
PA142672393	51066	SSUH2	chr3	8658086	8796721	138635	ssu-2 homolog (C. elegans)
PA36159	6756	SSX1	chrX	48104752	48129879	25127	synovial sarcoma, X breakpoint 1
PA36160	6757	SSX2	chrX	52722946	52746277	23331	synovial sarcoma, X breakpoint 2
PA162404839	727837	SSX2B	chrX	52770281	52793617	23336	synovial sarcoma, X breakpoint 2B
PA38155	117178	SSX2IP	chr1	85106390	85166440	60050	synovial sarcoma, X breakpoint 2 interacting protein
PA36161	10214	SSX3	chrX	48202863	48226203	23340	synovial sarcoma, X breakpoint 3
PA36162	6759	SSX4	chrX	48232968	48255785	22817	synovial sarcoma, X breakpoint 4
PA142670867	548313	SSX4B	chrX	48258524	48281355	22831	synovial sarcoma, X breakpoint 4B
PA36163	6758	SSX5	chrX	48042656	48066199	23543	synovial sarcoma, X breakpoint 5
PA134879420	280658	SSX7	chrX	52670111	52693950	23839	synovial sarcoma, X breakpoint 7
PA36167	6767	ST13	chr22	41217539	41263012	45473	suppression of tumorigenicity 13 (colon carcinoma) (Hsp70 interacting protein)
PA38550	145165	ST13P4	chr13	50736154	50750752	14598	suppression of tumorigenicity 13 (colon carcinoma) (Hsp70 interacting protein) pseudogene 4
PA38574	144106	ST13P5	chr11	18273432	18288048	14616	suppression of tumorigenicity 13 (colon carcinoma) (Hsp70 interacting protein) pseudogene 5
PA38576	155019	ST13P7	chr7	132849760	132865356	15596	suppression of tumorigenicity 13 (colon carcinoma) (Hsp70 interacting protein) pseudogene 7
PA36168	6768	ST14	chr11	130019682	130083257	63575	suppression of tumorigenicity 14 (colon carcinoma)
PA38642	9705	ST18	chr8	53020392	53332439	312047	suppression of tumorigenicity 18, zinc finger
PA162404859	400410	ST20	chr15	80188182	80226096	37914	suppressor of tumorigenicity 20
PA35764	6482	ST3GAL1	chr8	134464091	134594697	130606	ST3 beta-galactoside alpha-2,3-sialyltransferase 1
PA35765	6483	ST3GAL2	chr16	70410338	70482991	72653	ST3 beta-galactoside alpha-2,3-sialyltransferase 2
PA35768	6487	ST3GAL3	chr1	44163204	44399837	236633	ST3 beta-galactoside alpha-2,3-sialyltransferase 3
PA35766	6484	ST3GAL4	chr11	126215540	126287536	71996	ST3 beta-galactoside alpha-2,3-sialyltransferase 4
PA35773	8869	ST3GAL5	chr2	86063271	86126157	62886	ST3 beta-galactoside alpha-2,3-sialyltransferase 5
PA134958548	10402	ST3GAL6	chr3	98441080	98517689	76609	ST3 beta-galactoside alpha-2,3-sialyltransferase 6
PA36172	6764	ST5	chr11	8711899	8942498	230599	suppression of tumorigenicity 5
PA35762	6480	ST6GAL1	chr3	186638315	186799341	161026	ST6 beta-galactosamide alpha-2,6-sialyltranferase 1
PA35763	84620	ST6GAL2	chr2	107415056	107513563	98507	ST6 beta-galactosamide alpha-2,6-sialyltranferase 2
PA134935906	55808	ST6GALNAC1	chr17	74617838	74649894	32056	ST6 (alpha-N-acetyl-neuraminyl-2,3-beta-galactosyl-1,3)-N-acetylgalactosaminide alpha-2,6-sialyltransferase 1
PA35769	10610	ST6GALNAC2	chr17	74558461	74592145	33684	ST6 (alpha-N-acetyl-neuraminyl-2,3-beta-galactosyl-1,3)-N-acetylgalactosaminide alpha-2,6-sialyltransferase 2
PA134984080	256435	ST6GALNAC3	chr1	76530389	77103311	572922	ST6 (alpha-N-acetyl-neuraminyl-2,3-beta-galactosyl-1,3)-N-acetylgalactosaminide alpha-2,6-sialyltransferase 3
PA38250	27090	ST6GALNAC4	chr9	130667165	130689326	22161	ST6 (alpha-N-acetyl-neuraminyl-2,3-beta-galactosyl-1,3)-N-acetylgalactosaminide alpha-2,6-sialyltransferase 4
PA134924485	81849	ST6GALNAC5	chr1	77323126	77536223	213097	ST6 (alpha-N-acetyl-neuraminyl-2,3-beta-galactosyl-1,3)-N-acetylgalactosaminide alpha-2,6-sialyltransferase 5
PA134891331	30815	ST6GALNAC6	chr9	130644600	130679010	34410	ST6 (alpha-N-acetyl-neuraminyl-2,3-beta-galactosyl-1,3)-N-acetylgalactosaminide alpha-2,6-sialyltransferase 6
PA36173	7982	ST7	chr7	116583381	116873077	289696	suppression of tumorigenicity 7
PA38331	54879	ST7L	chr1	113063140	113172040	108900	suppression of tumorigenicity 7 like
PA35770	6489	ST8SIA1	chr12	22343325	22497648	154323	ST8 alpha-N-acetyl-neuraminide alpha-2,8-sialyltransferase 1
PA35771	8128	ST8SIA2	chr15	92927140	93014958	87818	ST8 alpha-N-acetyl-neuraminide alpha-2,8-sialyltransferase 2
PA37864	51046	ST8SIA3	chr18	55009721	55039162	29441	ST8 alpha-N-acetyl-neuraminide alpha-2,8-sialyltransferase 3
PA35772	7903	ST8SIA4	chr5	100139639	100248989	109350	ST8 alpha-N-acetyl-neuraminide alpha-2,8-sialyltransferase 4
PA38249	29906	ST8SIA5	chr18	44256081	44347039	90958	ST8 alpha-N-acetyl-neuraminide alpha-2,8-sialyltransferase 5
PA134909138	338596	ST8SIA6	chr10	17358282	17506408	148126	ST8 alpha-N-acetyl-neuraminide alpha-2,8-sialyltransferase 6
PA38610	23166	STAB1	chr3	52519354	52561512	42158	stabilin 1
PA38611	55576	STAB2	chr12	103971069	104163502	192433	stabilin 2
PA36175	6769	STAC	chr3	36411842	36592499	180657	SH3 and cysteine rich domain
PA134939947	342667	STAC2	chr17	37363789	37392040	28251	SH3 and cysteine rich domain 2
PA134877600	246329	STAC3	chr12	57634241	57654971	20730	SH3 and cysteine rich domain 3
PA36176	10274	STAG1	chr3	136052077	136481245	429168	stromal antigen 1
PA36177	10735	STAG2	chrX	123084475	123239506	155031	stromal antigen 2
PA36178	10734	STAG3	chr7	99765186	99815010	49824	stromal antigen 3
PA162404870	54441	STAG3L1	chr7	74978447	75000085	21638	stromal antigen 3-like 1
PA162404891	442582	STAG3L2	chr7	74295092	74316731	21639	stromal antigen 3-like 2
PA162404912	442578	STAG3L3	chr7	72464818	72486466	21648	stromal antigen 3-like 3
PA162404933	64940	STAG3L4	chr7	66757625	66789513	31888	stromal antigen 3-like 4
PA36179	8027	STAM	chr10	17676124	17761823	85699	signal transducing adaptor molecule (SH3 domain and ITAM motif) 1
PA36180	10254	STAM2	chr2	152970315	153042506	72191	signal transducing adaptor molecule (SH3 domain and ITAM motif) 2
PA134955569	10617	STAMBP	chr2	74046043	74103783	57740	STAM binding protein
PA142670864	57559	STAMBPL1	chr10	90629597	90738343	108746	STAM binding protein-like 1
PA162404948	26228	STAP1	chr4	68414415	68476059	61644	signal transducing adaptor family member 1
PA162404971	55620	STAP2	chr19	4321040	4352783	31743	signal transducing adaptor family member 2
PA36181	6770	STAR	chr8	37997218	38018783	21565	steroidogenic acute regulatory protein
PA35596	10809	STARD10	chr11	72462774	72514750	51976	StAR-related lipid transfer (START) domain containing 10
PA38806	90627	STARD13	chr13	33674272	34260932	586660	StAR-related lipid transfer (START) domain containing 13
PA134981867	10948	STARD3	chr17	37783333	37823454	40121	StAR-related lipid transfer (START) domain containing 3
PA134990065	83930	STARD3NL	chr7	38207808	38273272	65464	STARD3 N-terminal like
PA38284	134429	STARD4	chr5	110828731	110858234	29503	StAR-related lipid transfer (START) domain containing 4
PA38286	80765	STARD5	chr15	81602007	81626524	24517	StAR-related lipid transfer (START) domain containing 5
PA38287	147323	STARD6	chr18	51848062	51890943	42881	StAR-related lipid transfer (START) domain containing 6
PA38285	56910	STARD7	chr2	96847597	96884573	36976	StAR-related lipid transfer (START) domain containing 7
PA38804	9754	STARD8	chrX	67857511	67948684	91173	StAR-related lipid transfer (START) domain containing 8
PA38805	57519	STARD9	chr15	42857857	43016196	158339	StAR-related lipid transfer (START) domain containing 9
PA36183	6772	STAT1	chr2	191830762	191888976	58214	signal transducer and activator of transcription 1, 91kDa
PA36184	6773	STAT2	chr12	56732381	56764058	31677	signal transducer and activator of transcription 2, 113kDa
PA337	6774	STAT3	chr17	40462342	40550586	88244	signal transducer and activator of transcription 3 (acute-phase response factor)
PA36185	6775	STAT4	chr2	191891302	192047404	156102	signal transducer and activator of transcription 4
PA338	6776	STAT5A	chr17	40429565	40466961	37396	signal transducer and activator of transcription 5A
PA36186	6777	STAT5B	chr17	40348195	40438478	90283	signal transducer and activator of transcription 5B
PA339	6778	STAT6	chr12	57486187	57515196	29009	signal transducer and activator of transcription 6, interleukin-4 induced
PA36187	6779	STATH	chr4	70851648	70871173	19525	statherin
PA36188	6780	STAU1	chr20	47726876	47814907	88031	staufen double-stranded RNA binding protein 1
PA36189	27067	STAU2	chr8	74329604	74669943	340339	staufen double-stranded RNA binding protein 2
PA162405002	8987	STBD1	chr4	77217179	77235283	18104	starch binding domain 1
PA36190	6781	STC1	chr8	23696434	23722320	25886	stanniocalcin 1
PA36191	8614	STC2	chr5	172738726	172766506	27780	stanniocalcin 2
PA36193	26872	STEAP1	chr7	89773689	89797141	23452	six transmembrane epithelial antigen of the prostate 1
PA38473	261729	STEAP2	chr7	89831000	89869992	38992	STEAP family member 2, metalloreductase
PA142670863	55240	STEAP3	chr2	119971384	120026228	54844	STEAP family member 3, metalloreductase
PA134874572	79689	STEAP4	chr7	87902744	87946228	43484	STEAP family member 4
PA162405011	246744	STH	chr17	44066616	44080060	13444	saitohin
PA35780	6491	STIL	chr1	47712811	47789819	77008	SCL/TAL1 interrupting locus
PA36195	6786	STIM1	chr11	3866933	4117440	250507	stromal interaction molecule 1
PA134926985	57620	STIM2	chr4	26849329	27030003	180674	stromal interaction molecule 2
PA36196	10963	STIP1	chr11	63942206	63975020	32814	stress-induced phosphoprotein 1
PA36197	6793	STK10	chr5	171466074	171625346	159272	serine/threonine kinase 10
PA36198	6794	STK11	chr19	1195798	1231434	35636	serine/threonine kinase 11
PA38822	114790	STK11IP	chr2	220452593	220484173	31580	serine/threonine kinase 11 interacting protein
PA36202	8576	STK16	chr2	220100192	220118059	17867	serine/threonine kinase 16
PA36203	9263	STK17A	chr7	43612692	43669978	57286	serine/threonine kinase 17a
PA36204	9262	STK17B	chr2	196995307	197046336	51029	serine/threonine kinase 17b
PA36206	8859	STK19	chr6	31928952	31952223	23271	serine/threonine kinase 19
PA36210	8428	STK24	chr13	99099455	99239396	139941	serine/threonine kinase 24
PA36211	10494	STK25	chr2	242431122	242459145	28023	serine/threonine kinase 25
PA36213	6788	STK3	chr8	99463859	99964799	500940	serine/threonine kinase 3
PA36214	56164	STK31	chr7	23739786	23875132	135346	serine/threonine kinase 31
PA134932545	202374	STK32A	chr5	146604526	146770418	165892	serine/threonine kinase 32A
PA128394683	55351	STK32B	chr4	5043527	5505728	462201	serine/threonine kinase 32B
PA134888050	282974	STK32C	chr10	133993038	134155377	162339	serine/threonine kinase 32C
PA37900	65975	STK33	chr11	8410417	8625836	215419	serine/threonine kinase 33
PA38097	140901	STK35	chr20	2072528	2132201	59673	serine/threonine kinase 35
PA38212	27148	STK36	chr2	219526749	219570440	43691	serine/threonine kinase 36
PA38251	11329	STK38	chr6	36458666	36525256	66590	serine/threonine kinase 38
PA38252	23012	STK38L	chr12	27387078	27481892	94814	serine/threonine kinase 38 like
PA38243	27347	STK39	chr2	168807530	169114105	306575	serine threonine kinase 39
PA36215	6789	STK4	chr20	43585120	43711600	126480	serine/threonine kinase 4
PA142670860	83931	STK40	chr1	36802225	36861525	59300	serine/threonine kinase 40
PA134891744	169436	STKLD1	chr9	136233284	136274220	40936	serine/threonine kinase-like domain containing 1
PA35491	3925	STMN1	chr1	26207670	26243368	35698	stathmin 1
PA35540	11075	STMN2	chr8	80513049	80581410	68361	stathmin 2
PA38049	50861	STMN3	chr20	62268058	62294963	26905	stathmin-like 3
PA38089	81551	STMN4	chr8	27090814	27126382	35568	stathmin-like 4
PA27816	2040	STOM	chr9	124098266	124142582	44316	stomatin
PA37898	9399	STOML1	chr15	74272559	74296963	24404	stomatin (EPB72)-like 1
PA37897	30968	STOML2	chr9	35096888	35113184	16296	stomatin (EPB72)-like 2
PA134939552	161003	STOML3	chr13	39537062	39574996	37934	stomatin (EPB72)-like 3
PA143485623	11037	STON1	chr2	48747308	48828654	81346	stonin 1
PA162405016	286749	STON1-GTF2A1L	chr2	48747064	49006656	259592	STON1-GTF2A1L readthrough
PA143485624	85439	STON2	chr14	81723994	81912789	188795	stonin 2
PA134883643	219736	STOX1	chr10	70577294	70658209	80915	storkhead box 1
PA142670861	56977	STOX2	chr4	184816509	184947679	131170	storkhead box 2
PA143485320	90529	STPG1	chr1	24680489	24751587	71098	sperm-tail PG-rich repeat containing 1
PA162379799	285555	STPG2	chr4	98477025	99074391	597366	sperm-tail PG-rich repeat containing 2
PA36223	201254	STRA13	chr17	79973579	79990786	17207	stimulated by retinoic acid 13
PA134956551	64220	STRA6	chr15	74468802	74512046	43244	stimulated by retinoic acid 6
PA162405043	346673	STRA8	chr7	134906731	134946244	39513	stimulated by retinoic acid 8
PA164726342	92335	STRADA	chr17	61777192	61829330	52138	STE20-related kinase adaptor alpha
PA24743	55437	STRADB	chr2	202306392	202362501	56109	STE20-related kinase adaptor beta
PA134867032	11171	STRAP	chr12	16025288	16059412	34124	serine/threonine kinase receptor associated protein
PA38145	55342	STRBP	chr9	125875338	126040855	165517	spermatid perinuclear RNA binding protein
PA38082	161497	STRC	chr15	43888685	44012286	123601	stereocilin
PA134939426	85369	STRIP1	chr1	110564199	110600263	36064	striatin interacting protein 1
PA134923427	57464	STRIP2	chr7	129064274	129131240	66966	striatin interacting protein 2
PA36224	6801	STRN	chr2	37061841	37203673	141832	striatin, calmodulin binding protein
PA38394	29966	STRN3	chr14	31359985	31505607	145622	striatin, calmodulin binding protein 3
PA134863218	29888	STRN4	chr19	47219768	47260251	40483	striatin, calmodulin binding protein 4
PA36225	412	STS	chrX	7055298	7275682	220384	steroid sulfatase (microsomal), isozyme S
PA29969	3703	STT3A	chr11	125452690	125495654	42964	STT3A, subunit of the oligosaccharyltransferase complex (catalytic)
PA143485625	201595	STT3B	chr3	31564130	31680556	116426	STT3B, subunit of the oligosaccharyltransferase complex (catalytic)
PA36227	10273	STUB1	chr16	720115	735768	15653	STIP1 homology and U-box containing protein 1, E3 ubiquitin protein ligase
PA36228	8677	STX10	chr19	13251872	13271188	19316	syntaxin 10
PA36229	8676	STX11	chr6	144451770	144516076	64306	syntaxin 11
PA36230	23673	STX12	chr1	28089694	28153963	64269	syntaxin 12
PA36231	8675	STX16	chr20	57216309	57257582	41273	syntaxin 16
PA36232	55014	STX17	chr9	102658915	102739818	80903	syntaxin 17
PA38061	53407	STX18	chr4	4417695	4553775	136080	syntaxin 18
PA142670857	415117	STX19	chr3	93730078	93757460	27382	syntaxin 19
PA36233	6804	STX1A	chr7	73110535	73144032	33497	syntaxin 1A (brain)
PA38345	112755	STX1B	chr16	30997577	31031829	34252	syntaxin 1B
PA27831	2054	STX2	chr12	131271145	131333819	62674	syntaxin 2
PA36235	6809	STX3	chr11	59512479	59576355	63876	syntaxin 3
PA36236	6810	STX4	chr16	31034416	31054489	20073	syntaxin 4
PA36237	6811	STX5	chr11	62571332	62609563	38231	syntaxin 5
PA36238	10228	STX6	chr1	180939164	181002074	62910	syntaxin 6
PA36239	8417	STX7	chr6	132775663	132844337	68674	syntaxin 7
PA36240	9482	STX8	chr17	9150788	9489275	338487	syntaxin 8
PA36241	6812	STXBP1	chr9	130364486	130457995	93509	syntaxin binding protein 1
PA36242	6813	STXBP2	chr19	7691987	7715760	23773	syntaxin binding protein 2
PA36243	6814	STXBP3	chr1	109279285	109355148	75863	syntaxin binding protein 3
PA134962267	252983	STXBP4	chr17	53036119	53244646	208527	syntaxin binding protein 4
PA134954258	134957	STXBP5	chr6	147515494	147714612	199118	syntaxin binding protein 5 (tomosyn)
PA134976391	9515	STXBP5L	chr3	120617050	121146608	529558	syntaxin binding protein 5-like
PA134985567	29091	STXBP6	chr14	25275860	25529095	253235	syntaxin binding protein 6 (amisyn)
PA134976821	55359	STYK1	chr12	10768538	10836917	68379	serine/threonine/tyrosine kinase 1
PA36244	6815	STYX	chr14	53186883	53244707	57824	serine/threonine/tyrosine interacting protein
PA134942462	51657	STYXL1	chr7	75622610	75687321	64711	serine/threonine/tyrosine interacting-like 1
PA142670858	10923	SUB1	chr5	32575605	32607185	31580	SUB1 homolog (S. cerevisiae)
PA36245	8803	SUCLA2	chr13	48513791	48622125	108334	succinate-CoA ligase, ADP-forming, beta subunit
PA36246	8802	SUCLG1	chr2	84647647	84696586	48939	succinate-CoA ligase, alpha subunit
PA36247	8801	SUCLG2	chr3	67407884	67715038	307154	succinate-CoA ligase, GDP-forming, beta subunit
PA28934	56670	SUCNR1	chr3	151581431	151602876	21445	succinate receptor 1
PA25621	51430	SUCO	chr1	172491494	172583973	92479	SUN domain containing ossification factor
PA143485626	64426	SUDS3	chr12	118804358	118858840	54482	suppressor of defective silencing 3 homolog (S. cerevisiae)
PA38146	51684	SUFU	chr10	104253719	104396214	142495	suppressor of fused homolog (Drosophila)
PA25942	79783	SUGCT	chr7	40164575	40903366	738791	succinyl-CoA:glutarate-CoA transferase
PA165394338	57794	SUGP1	chr19	19384320	19441321	57001	SURP and G patch domain containing 1
PA165394371	10147	SUGP2	chr19	19098697	19154861	56164	SURP and G patch domain containing 2
PA134880121	10910	SUGT1	chr13	53216830	53265433	48603	SGT1, suppressor of G2 allele of SKP1 (S. cerevisiae)
PA134861022	23213	SULF1	chr8	70368859	70576147	207288	sulfatase 1
PA134902131	55959	SULF2	chr20	46283150	46425360	142210	sulfatase 2
PA343	6817	SULT1A1	chr16	28613908	28644907	30999	sulfotransferase family, cytosolic, 1A, phenol-preferring, member 1
PA341	6799	SULT1A2	chr16	28600264	28621058	20794	sulfotransferase family, cytosolic, 1A, phenol-preferring, member 2
PA344	6818	SULT1A3	chr16	30200549	30218650	18101	sulfotransferase family, cytosolic, 1A, phenol-preferring, member 3
PA142670856	445329	SULT1A4	chr16	29461207	29479301	18094	sulfotransferase family, cytosolic, 1A, phenol-preferring, member 4
PA415	27284	SULT1B1	chr4	70588838	70636430	47592	sulfotransferase family, cytosolic, 1B, member 1
PA164742557	6819	SULT1C2	chr2	108895095	108929371	34276	sulfotransferase family, cytosolic, 1C, member 2
PA162405069	442038	SULT1C3	chr2	108853651	108884807	31156	sulfotransferase family, cytosolic, 1C, member 3
PA162405070	27233	SULT1C4	chr2	108984413	109007296	22883	sulfotransferase family, cytosolic, 1C, member 4
PA340	6783	SULT1E1	chr4	70703930	70735870	31940	sulfotransferase family 1E, estrogen-preferring, member 1
PA346	6822	SULT2A1	chr19	48370723	48399654	28931	sulfotransferase family, cytosolic, 2A, dehydroepiandrosterone (DHEA)-preferring, member 1
PA36249	6820	SULT2B1	chr19	49045429	49105684	60255	sulfotransferase family, cytosolic, 2B, member 1
PA412	25830	SULT4A1	chr22	44217387	44268378	50991	sulfotransferase family 4A, member 1
PA128505849	391365	SULT6B1	chr2	37391963	37433230	41267	sulfotransferase family, cytosolic, 6B, member 1
PA134977552	285362	SUMF1	chr3	4399829	4518966	119137	sulfatase modifying factor 1
PA134921869	25870	SUMF2	chr7	56121700	56151365	29665	sulfatase modifying factor 2
PA37149	7341	SUMO1	chr2	203067903	203113322	45419	small ubiquitin-like modifier 1
PA134914683	6613	SUMO2	chr17	73160825	73189098	28273	small ubiquitin-like modifier 2
PA35973	6612	SUMO3	chr21	46222532	46248044	25512	small ubiquitin-like modifier 3
PA134979206	387082	SUMO4	chr6	149711284	149725182	13898	small ubiquitin-like modifier 4
PA165618311	23353	SUN1	chr7	845194	917557	72363	Sad1 and UNC84 domain containing 1
PA165378369	25777	SUN2	chr22	39127719	39172338	44619	Sad1 and UNC84 domain containing 2
PA165618375	256979	SUN3	chr7	48023745	48078724	54979	Sad1 and UNC84 domain containing 3
PA38095	140732	SUN5	chr20	31568579	31602239	33660	Sad1 and UNC84 domain containing 5
PA36250	6821	SUOX	chr12	56381043	56402309	21266	sulfite oxidase
PA36251	11198	SUPT16H	chr14	21816631	21862425	45794	suppressor of Ty 16 homolog (S. cerevisiae)
PA134985241	55578	SUPT20H	chr13	37580449	37643850	63401	suppressor of Ty 20 homolog (S. cerevisiae)
PA36252	8464	SUPT3H	chr6	44791467	45355788	564321	suppressor of Ty 3 homolog (S. cerevisiae)
PA36253	6827	SUPT4H1	chr17	56419536	56439599	20063	suppressor of Ty 4 homolog 1 (S. cerevisiae)
PA36255	6829	SUPT5H	chr19	39926186	39970310	44124	suppressor of Ty 5 homolog (S. cerevisiae)
PA36256	6830	SUPT6H	chr17	26979221	27032255	53034	suppressor of Ty 6 homolog (S. cerevisiae)
PA142670854	9913	SUPT7L	chr2	27870679	27896707	26028	suppressor of Ty 7 (S. cerevisiae)-like
PA36257	6832	SUPV3L1	chr10	70929993	70971854	41861	suppressor of var1, 3-like 1 (S. cerevisiae)
PA36259	6834	SURF1	chr9	136215660	136233361	17701	surfeit 1
PA36260	6835	SURF2	chr9	136213421	136231041	17620	surfeit 2
PA36261	6836	SURF4	chr9	136225325	136254820	29495	surfeit 4
PA36263	6838	SURF6	chr9	136194543	136213047	18504	surfeit 6
PA134935587	64420	SUSD1	chr9	114800061	114947577	147516	sushi domain containing 1
PA134942464	56241	SUSD2	chr22	24567444	24588074	20630	sushi domain containing 2
PA128394766	203328	SUSD3	chr9	95810989	95850420	39431	sushi domain containing 3
PA142670855	55061	SUSD4	chr1	223391161	223547564	156403	sushi domain containing 4
PA143485627	26032	SUSD5	chr3	33188537	33270707	82170	sushi domain containing 5
PA36264	6839	SUV39H1	chrX	48543945	48570407	26462	suppressor of variegation 3-9 homolog 1 (Drosophila)
PA134868807	79723	SUV39H2	chr10	14910782	14949314	38532	suppressor of variegation 3-9 homolog 2 (Drosophila)
PA134958369	51111	SUV420H1	chr11	67919330	67991250	71920	suppressor of variegation 4-20 homolog 1 (Drosophila)
PA134934307	84787	SUV420H2	chr19	55841221	55862489	21268	suppressor of variegation 4-20 homolog 2 (Drosophila)
PA134936035	23512	SUZ12	chr17	30254044	30331057	77013	SUZ12 polycomb repressive complex 2 subunit
PA128394564	9900	SV2A	chr1	149871870	149899434	27564	synaptic vesicle glycoprotein 2A
PA134930999	9899	SV2B	chr15	91632996	91847539	214543	synaptic vesicle glycoprotein 2B
PA134888452	22987	SV2C	chr5	75368997	75652764	283767	synaptic vesicle glycoprotein 2C
PA25971	79987	SVEP1	chr9	113124528	113352160	227632	sushi, von Willebrand factor type A, EGF and pentraxin domain containing 1
PA36265	6840	SVIL	chr10	29743274	30035864	292590	supervillin
PA164726394	258010	SVIP	chr11	22840598	22861382	20784	small VCP/p97-interacting protein
PA142670848	55530	SVOP	chr12	109301658	109382453	80795	SV2 related protein homolog (rat)
PA162405089	136306	SVOPL	chr7	138276030	138395969	119939	SVOP-like
PA165543694	23075	SWAP70	chr11	9675624	9777508	101884	SWAP switching B-cell complex 70kDa subunit
PA134903574	375757	SWI5	chr9	131027663	131054268	26605	SWI5 recombination repair homolog (yeast)
PA144596472	126074	SWSAP1	chr19	11475383	11490627	15244	SWIM-type zinc finger 7 associated protein 1
PA25613	54823	SWT1	chr1	185116155	185263913	147758	SWT1 RNA endoribonuclease homolog (S. cerevisiae)
PA38107	94056	SYAP1	chrX	16727707	16783807	56100	synapse associated protein 1
PA165586000	55638	SYBU	chr8	110583405	110714020	130615	syntabulin (syntaxin-interacting)
PA134876767	93426	SYCE1	chr10	135364404	135391795	27391	synaptonemal complex central element protein 1
PA165450704	100130958	SYCE1L	chr16	77223349	77249976	26627	synaptonemal complex central element protein 1-like
PA142670849	256126	SYCE2	chr19	13006894	13040116	33222	synaptonemal complex central element protein 2
PA164717081	644186	SYCE3	chr22	50986541	51011328	24787	synaptonemal complex central element protein 3
PA142670850	342898	SYCN	chr19	39690562	39704906	14344	syncollin
PA36269	6847	SYCP1	chr1	115387455	115540991	153536	synaptonemal complex protein 1
PA36272	10388	SYCP2	chr20	58435612	58518704	83092	synaptonemal complex protein 2
PA162405118	221711	SYCP2L	chr6	10877064	10977542	100478	synaptonemal complex protein 2-like
PA38298	50511	SYCP3	chr12	102119426	102143474	24048	synaptonemal complex protein 3
PA142670851	85360	SYDE1	chr19	15208214	15228790	20576	synapse defective 1, Rho GTPase, homolog 1 (C. elegans)
PA142670852	84144	SYDE2	chr1	85620356	85677292	56936	synapse defective 1, Rho GTPase, homolog 2 (C. elegans)
PA142670853	25949	SYF2	chr1	25545767	25569013	23246	SYF2 pre-mRNA-splicing factor
PA36273	6850	SYK	chr9	93554012	93663842	109830	spleen tyrosine kinase
PA134896920	8189	SYMPK	chr19	46315700	46376548	60848	symplekin
PA36276	6853	SYN1	chrX	47428300	47489256	60956	synapsin I
PA36277	6854	SYN2	chr3	12172150	12236532	64382	synapsin II
PA36278	8224	SYN3	chr22	32905539	33464377	558838	synapsin III
PA164726395	81493	SYNC	chr1	33142507	33178361	35854	syncoilin, intermediate filament protein
PA134985065	10492	SYNCRIP	chr6	86314502	86363568	49066	synaptotagmin binding, cytoplasmic RNA interacting protein
PA25752	79953	SYNDIG1	chr20	24439835	24650253	210418	synapse differentiation inducing 1
PA144596263	646658	SYNDIG1L	chr14	74869596	74902805	33209	synapse differentiation inducing 1-like
PA134975331	23345	SYNE1	chr6	152439819	152968534	528715	spectrin repeat containing, nuclear envelope 1
PA128394613	23224	SYNE2	chr14	64309683	64696167	386484	spectrin repeat containing, nuclear envelope 2
PA134931380	161176	SYNE3	chr14	95880831	95993000	112169	spectrin repeat containing, nuclear envelope family member 3
PA145149542	163183	SYNE4	chr19	36491002	36509958	18956	spectrin repeat containing, nuclear envelope family member 4
PA36279	8831	SYNGAP1	chr6	33377847	33424466	46619	synaptic Ras GTPase activating protein 1
PA36280	9145	SYNGR1	chr22	39735954	39784593	48639	synaptogyrin 1
PA36281	9144	SYNGR2	chr17	76154632	76172009	17377	synaptogyrin 2
PA36283	9143	SYNGR3	chr16	2029946	2047276	17330	synaptogyrin 3
PA36284	23546	SYNGR4	chr19	48857559	48882634	25075	synaptogyrin 4
PA36285	8867	SYNJ1	chr21	33994269	34110351	116082	synaptojanin 1
PA36286	8871	SYNJ2	chr6	158392888	158523208	130320	synaptojanin 2
PA38768	55333	SYNJ2BP	chr14	70830213	70893807	63594	synaptojanin 2 binding protein
PA164726408	23336	SYNM	chr15	99635286	99678800	43514	synemin, intermediate filament protein
PA134863299	11346	SYNPO	chr5	149970642	150041792	71150	synaptopodin
PA38244	171024	SYNPO2	chr4	119799996	119985402	185406	synaptopodin 2
PA134889033	79933	SYNPO2L	chr10	75401639	75425832	24193	synaptopodin 2-like
PA38154	132204	SYNPR	chr3	63253914	63605597	351683	synaptoporin
PA24847	11276	SYNRG	chr17	35871900	35979544	107644	synergin, gamma
PA36288	6855	SYP	chrX	49041263	49066661	25398	synaptophysin
PA36289	6856	SYPL1	chr7	105727814	105763093	35279	synaptophysin-like 1
PA142670846	284612	SYPL2	chr1	109999100	110027764	28664	synaptophysin-like 2
PA162405119	90196	SYS1	chr20	43978660	44008442	29782	Sys1 golgi trafficking protein
PA162405132	767557	SYS1-DBNDD2	chr20	43981809	44042250	60441	SYS1-DBNDD2 readthrough (non-protein coding)
PA36290	6857	SYT1	chr12	79247773	79848788	601015	synaptotagmin I
PA134866255	341359	SYT10	chr12	33525348	33602754	77406	synaptotagmin X
PA134898675	23208	SYT11	chr1	155819260	155857990	38730	synaptotagmin XI
PA38321	91683	SYT12	chr11	66780190	66821334	41144	synaptotagmin XII
PA37942	57586	SYT13	chr11	45258853	45317884	59031	synaptotagmin XIII
PA134887689	255928	SYT14	chr1	210101519	210340636	239117	synaptotagmin XIV
PA134921618	83849	SYT15	chr10	46952444	46981400	28956	synaptotagmin XV
PA134964250	83851	SYT16	chr14	62321567	62576915	255348	synaptotagmin XVI
PA142670841	51760	SYT17	chr16	19169541	19282656	113115	synaptotagmin XVII
PA36291	127833	SYT2	chr1	202556724	202689551	132827	synaptotagmin II
PA36292	84258	SYT3	chr19	51122234	51153092	30858	synaptotagmin III
PA36293	6860	SYT4	chr18	40844857	40867615	22758	synaptotagmin IV
PA36294	6861	SYT5	chr19	55679571	55701809	22238	synaptotagmin V
PA38614	148281	SYT6	chr1	114628914	114706472	77558	synaptotagmin VI
PA36295	9066	SYT7	chr11	61278188	61358523	80335	synaptotagmin VII
PA134993261	90019	SYT8	chr11	1845674	1861751	16077	synaptotagmin VIII
PA134984583	143425	SYT9	chr11	7263181	7493276	230095	synaptotagmin IX
PA134921815	84958	SYTL1	chr1	27658483	27683423	24940	synaptotagmin-like 1
PA37985	54843	SYTL2	chr11	85402264	85532197	129933	synaptotagmin-like 2
PA37986	94120	SYTL3	chr6	159055931	159188908	132977	synaptotagmin-like 3
PA37987	94121	SYTL4	chrX	99926488	99997135	70647	synaptotagmin-like 4
PA37988	94122	SYTL5	chrX	37855835	37991073	135238	synaptotagmin-like 5
PA128394735	84447	SYVN1	chr11	64891751	64912285	20534	synovial apoptosis inhibitor 1, synoviolin
PA142672461	26099	SZRD1	chr1	16683525	16727643	44118	SUZ RNA binding domain containing 1
PA142671628	23334	SZT2	chr1	43845556	43922918	77362	seizure threshold 2 homolog (mouse)
PA36296	6862	T	chr6	166568144	166592157	24013	T, brachyury homolog (mouse)
PA134921784	134864	TAAR1	chr6	132963123	132977142	14019	trace amine associated receptor 1
PA28903	9287	TAAR2	chr6	132935289	132955414	20125	trace amine associated receptor 2
PA142670843	9038	TAAR5	chr6	132906731	132920877	14146	trace amine associated receptor 5
PA134881141	319100	TAAR6	chr6	132881461	132895498	14037	trace amine associated receptor 6
PA28850	83551	TAAR8	chr6	132863832	132877860	14028	trace amine associated receptor 8
PA134931528	134860	TAAR9	chr6	132849427	132863475	14048	trace amine associated receptor 9 (gene/pseudogene)
PA30604	10454	TAB1	chr22	39785759	39836132	50373	TGF-beta activated kinase 1/MAP3K7 binding protein 1
PA30605	23118	TAB2	chr6	149629436	149735747	106311	TGF-beta activated kinase 1/MAP3K7 binding protein 2
PA165757406	257397	TAB3	chrX	30842559	30917511	74952	TGF-beta activated kinase 1/MAP3K7 binding protein 3
PA36297	6863	TAC1	chr7	97351271	97372784	21513	tachykinin, precursor 1
PA36298	6866	TAC3	chr12	57400781	57420344	19563	tachykinin 3
PA134944925	255061	TAC4	chr17	47912671	47935379	22708	tachykinin 4 (hemokinin)
PA36299	6867	TACC1	chr8	38575704	38713546	137842	transforming, acidic coiled-coil containing protein 1
PA36300	10579	TACC2	chr10	123738689	124017057	278368	transforming, acidic coiled-coil containing protein 2
PA36301	10460	TACC3	chr4	1713217	1749905	36688	transforming, acidic coiled-coil containing protein 3
PA165433031	51204	TACO1	chr17	61668231	61688725	20494	translational activator of mitochondrially encoded cytochrome c oxidase I
PA36302	6869	TACR1	chr2	75270590	75436645	166055	tachykinin receptor 1
PA36303	6865	TACR2	chr10	71160958	71186674	25716	tachykinin receptor 2
PA36304	6870	TACR3	chr4	104507625	104650973	143348	tachykinin receptor 3
PA36305	4070	TACSTD2	chr1	59038095	59053166	15071	tumor-associated calcium signal transducer 2
PA165752724	117143	TADA1	chr1	166822747	166855654	32907	transcriptional adaptor 1
PA36306	6871	TADA2A	chr17	35756977	35842830	85853	transcriptional adaptor 2A
PA165664556	93624	TADA2B	chr4	7035156	7062679	27523	transcriptional adaptor 2B
PA165698494	10474	TADA3	chr3	9818648	9844695	26047	transcriptional adaptor 3
PA36310	6872	TAF1	chrX	70576094	70688855	112761	TAF1 RNA polymerase II, TATA box binding protein (TBP)-associated factor, 250kDa
PA36318	6881	TAF10	chr11	6629048	6643475	14427	TAF10 RNA polymerase II, TATA box binding protein (TBP)-associated factor, 30kDa
PA36319	6882	TAF11	chr6	34842555	34865908	23353	TAF11 RNA polymerase II, TATA box binding protein (TBP)-associated factor, 28kDa
PA36320	6883	TAF12	chr1	28926608	28985416	58808	TAF12 RNA polymerase II, TATA box binding protein (TBP)-associated factor, 20kDa
PA36321	6884	TAF13	chr1	109603998	109628624	24626	TAF13 RNA polymerase II, TATA box binding protein (TBP)-associated factor, 18kDa
PA36322	8148	TAF15	chr17	34126459	34177246	50787	TAF15 RNA polymerase II, TATA box binding protein (TBP)-associated factor, 68kDa
PA36307	9015	TAF1A	chr1	222727990	222773438	45448	TATA box binding protein (TBP)-associated factor, RNA polymerase I, A, 48kDa
PA36308	9014	TAF1B	chr2	9973571	10077545	103974	TATA box binding protein (TBP)-associated factor, RNA polymerase I, B, 63kDa
PA36309	9013	TAF1C	chr16	84208453	84230676	22223	TATA box binding protein (TBP)-associated factor, RNA polymerase I, C, 110kDa
PA164726421	79101	TAF1D	chr11	93460368	93484703	24335	TATA box binding protein (TBP)-associated factor, RNA polymerase I, D, 41kDa
PA134947802	138474	TAF1L	chr9	32626452	32645667	19215	TAF1 RNA polymerase II, TATA box binding protein (TBP)-associated factor, 210kDa-like
PA36311	6873	TAF2	chr8	120740014	120855074	115060	TAF2 RNA polymerase II, TATA box binding protein (TBP)-associated factor, 150kDa
PA38222	83860	TAF3	chr10	7850467	8060016	209549	TAF3 RNA polymerase II, TATA box binding protein (TBP)-associated factor, 140kDa
PA36312	6874	TAF4	chr20	60546854	60650866	104012	TAF4 RNA polymerase II, TATA box binding protein (TBP)-associated factor, 135kDa
PA36313	6875	TAF4B	chr18	23796409	23974649	178240	TAF4b RNA polymerase II, TATA box binding protein (TBP)-associated factor, 105kDa
PA36314	6877	TAF5	chr10	105117724	105151822	34098	TAF5 RNA polymerase II, TATA box binding protein (TBP)-associated factor, 100kDa
PA38223	27097	TAF5L	chr1	229725858	229771794	45936	TAF5-like RNA polymerase II, p300/CBP-associated factor (PCAF)-associated factor, 65kDa
PA36315	6878	TAF6	chr7	99701693	99727481	25788	TAF6 RNA polymerase II, TATA box binding protein (TBP)-associated factor, 80kDa
PA38224	10629	TAF6L	chr11	62528775	62557814	29039	TAF6-like RNA polymerase II, p300/CBP-associated factor (PCAF)-associated factor, 65kDa
PA36316	6879	TAF7	chr5	140695057	140710351	15294	TAF7 RNA polymerase II, TATA box binding protein (TBP)-associated factor, 55kDa
PA36323	54457	TAF7L	chrX	100520241	100558059	37818	TAF7-like RNA polymerase II, TATA box binding protein (TBP)-associated factor, 50kDa
PA162405144	129685	TAF8	chr6	42008251	42058093	49842	TAF8 RNA polymerase II, TATA box binding protein (TBP)-associated factor, 43kDa
PA36317	6880	TAF9	chr5	68644551	68675840	31289	TAF9 RNA polymerase II, TATA box binding protein (TBP)-associated factor, 32kDa
PA38225	51616	TAF9B	chrX	77382245	77406490	24245	TAF9B RNA polymerase II, TATA box binding protein (TBP)-associated factor, 31kDa
PA38016	117289	TAGAP	chr6	159452500	159476184	23684	T-cell activation RhoGTPase activating protein
PA36324	6876	TAGLN	chr11	117060040	117078508	18468	transgelin
PA36325	8407	TAGLN2	chr1	159884897	159905332	20435	transgelin 2
PA134896732	29114	TAGLN3	chr3	111707586	111735735	28149	transgelin 3
PA36326	6886	TAL1	chr1	47678962	47707938	28976	T-cell acute lymphocytic leukemia 1
PA36327	6887	TAL2	chr9	108408562	108428393	19831	T-cell acute lymphocytic leukemia 2
PA36328	6888	TALDO1	chr11	737417	768024	30607	transaldolase 1
PA142672392	132001	TAMM41	chr3	11828916	11898393	69477	TAM41, mitochondrial translocator assembly and maintenance protein, homolog (S. cerevisiae)
PA142670838	85461	TANC1	chr2	159815146	160092170	277024	tetratricopeptide repeat, ankyrin repeat and coiled-coil containing 1
PA142670837	26115	TANC2	chr17	61033913	61508067	474154	tetratricopeptide repeat, ankyrin repeat and coiled-coil containing 2
PA143485406	128989	TANGO2	chr22	19994554	20056449	61895	transport and golgi organization 2 homolog (Drosophila)
PA162405811	79613	TANGO6	chr16	68867456	69122085	254629	transport and golgi organization 6 homolog (Drosophila)
PA36330	10010	TANK	chr2	161983438	162095687	112249	TRAF family member-associated NFKB activator
PA134872946	57551	TAOK1	chr17	27707943	27881921	173978	TAO kinase 1
PA134907964	9344	TAOK2	chr16	29975188	30006583	31395	TAO kinase 2
PA134975064	51347	TAOK3	chr12	118584606	118820750	236144	TAO kinase 3
PA35021	6890	TAP1	chr6	32809986	32831748	21762	transporter 1, ATP-binding cassette, sub-family B (MDR/TAP)
PA35022	6891	TAP2	chr6	32786610	32816547	29937	transporter 2, ATP-binding cassette, sub-family B (MDR/TAP)
PA36331	6892	TAPBP	chr6	33264471	33292164	27693	TAP binding protein (tapasin)
PA134955671	55080	TAPBPL	chr12	6551177	6574488	23311	TAP binding protein-like
PA162405167	202018	TAPT1	chr4	16159128	16238161	79033	transmembrane anterior posterior transformation 1
PA36333	6894	TARBP1	chr1	234524059	234624863	100804	TAR (HIV-1) RNA binding protein 1
PA36334	6895	TARBP2	chr12	53883557	53903215	19658	TAR (HIV-1) RNA binding protein 2
PA36336	23435	TARDBP	chr1	11062462	11088549	26087	TAR DNA binding protein
PA165394443	441864	TARM1	chr19	54570149	54594634	24485	T cell-interacting, activating receptor on myeloid cells 1
PA36337	6897	TARS	chr5	33430802	33471196	40394	threonyl-tRNA synthetase
PA162405200	80222	TARS2	chr1	150449840	150483085	33245	threonyl-tRNA synthetase 2, mitochondrial (putative)
PA128394753	123283	TARSL2	chr15	102190955	102274807	83852	threonyl-tRNA synthetase-like 2
PA37882	80835	TAS1R1	chr1	6604987	6642817	37830	taste receptor, type 1, member 1
PA37919	80834	TAS1R2	chr1	19163093	19196155	33062	taste receptor, type 1, member 2
PA38012	83756	TAS1R3	chr1	1256726	1272844	16118	taste receptor, type 1, member 3
PA37921	50834	TAS2R1	chr5	9626109	9640463	14354	taste receptor, type 2, member 1
PA37928	50839	TAS2R10	chr12	10974945	10988868	13923	taste receptor, type 2, member 10
PA37929	50838	TAS2R13	chr12	11057525	11072161	14636	taste receptor, type 2, member 13
PA37930	50840	TAS2R14	chr12	11087853	11101806	13953	taste receptor, type 2, member 14
PA37931	50833	TAS2R16	chr7	122631759	122645754	13995	taste receptor, type 2, member 16
PA134932609	259294	TAS2R19	chr12	11171271	11185170	13899	taste receptor, type 2, member 19
PA134870599	259295	TAS2R20	chr12	11145561	11160474	14913	taste receptor, type 2, member 20
PA37922	50831	TAS2R3	chr7	141453897	141467997	14100	taste receptor, type 2, member 3
PA134917827	259293	TAS2R30	chr12	11282884	11296843	13959	taste receptor, type 2, member 30
PA134893789	259290	TAS2R31	chr12	11179986	11194006	14020	taste receptor, type 2, member 31
PA33936	5726	TAS2R38	chr7	141669431	141683573	14142	taste receptor, type 2, member 38
PA38739	259285	TAS2R39	chr7	142870512	142884528	14016	taste receptor, type 2, member 39
PA37923	50832	TAS2R4	chr7	141468289	141482188	13899	taste receptor, type 2, member 4
PA38738	259286	TAS2R40	chr7	142909172	142923143	13971	taste receptor, type 2, member 40
PA38737	259287	TAS2R41	chr7	143164966	143178889	13923	taste receptor, type 2, member 41
PA38741	353164	TAS2R42	chr12	11335599	11349543	13944	taste receptor, type 2, member 42
PA38729	259289	TAS2R43	chr12	11240886	11254912	14026	taste receptor, type 2, member 43
PA38731	259292	TAS2R46	chr12	11210964	11224893	13929	taste receptor, type 2, member 46
PA37924	54429	TAS2R5	chr7	141477129	141494338	17209	taste receptor, type 2, member 5
PA38736	259296	TAS2R50	chr12	11135512	11149511	13999	taste receptor, type 2, member 50
PA134879120	338398	TAS2R60	chr7	143130546	143144502	13956	taste receptor, type 2, member 60
PA37925	50837	TAS2R7	chr12	10951131	10965226	14095	taste receptor, type 2, member 7
PA37926	50836	TAS2R8	chr12	10955650	10969579	13929	taste receptor, type 2, member 8
PA37927	50835	TAS2R9	chr12	10958693	10972767	14074	taste receptor, type 2, member 9
PA25671	55617	TASP1	chr20	13367036	13629583	262547	taspase, threonine aspartase, 1
PA36338	6898	TAT	chr16	71597754	71620998	23244	tyrosine aminotransferase
PA134971804	83940	TATDN1	chr8	125497735	125561329	63594	TatD DNase domain containing 1
PA134959721	9797	TATDN2	chr3	10280177	10325906	45729	TatD DNase domain containing 2
PA142670831	128387	TATDN3	chr1	212955170	212993167	37997	TatD DNase domain containing 3
PA36339	8887	TAX1BP1	chr7	27768992	27872386	103394	Tax1 (human T-cell leukemia virus type I) binding protein 1
PA134950693	30851	TAX1BP3	chr17	3563187	3581973	18786	Tax1 (human T-cell leukemia virus type I) binding protein 3
PA36341	6901	TAZ	chrX	153629877	153653065	23188	tafazzin
PA134924486	219793	TBATA	chr10	72527995	72555157	27162	thymus, brain and testes associated
PA36342	23216	TBC1D1	chr4	37879606	38143796	264190	TBC1 (tre-2/USP6, BUB2, cdc16) domain family, member 1
PA134888210	83874	TBC1D10A	chr22	30684979	30732955	47976	TBC1 domain family, member 10A
PA142670835	26000	TBC1D10B	chr16	30365422	30391522	26100	TBC1 domain family, member 10B
PA142670836	374403	TBC1D10C	chr11	67161384	67180561	19177	TBC1 domain family, member 10C
PA134891743	23232	TBC1D12	chr10	96151956	96299089	147133	TBC1 domain family, member 12
PA134898118	54662	TBC1D13	chr9	131539510	131575711	36201	TBC1 domain family, member 13
PA128394697	57533	TBC1D14	chr4	6901171	7037845	136674	TBC1 domain family, member 14
PA134946839	64786	TBC1D15	chr12	72223487	72323629	100142	TBC1 domain family, member 15
PA134881634	125058	TBC1D16	chr17	77903142	78019657	116515	TBC1 domain family, member 16
PA134922509	79735	TBC1D17	chr19	50370682	50395007	24325	TBC1 domain family, member 17
PA134980991	55296	TBC1D19	chr4	26575546	26761232	185686	TBC1 domain family, member 19
PA38280	55357	TBC1D2	chr9	100958280	101028003	69723	TBC1 domain family, member 2
PA25683	128637	TBC1D20	chr20	413124	453187	40063	TBC1 domain family, member 20
PA134890585	161514	TBC1D21	chr15	74155922	74184555	28633	TBC1 domain family, member 21
PA25888	25771	TBC1D22A	chr22	47148514	47574342	425828	TBC1 domain family, member 22A
PA134867087	55633	TBC1D22B	chr6	37215528	37303746	88218	TBC1 domain family, member 22B
PA142670829	55773	TBC1D23	chr3	99969661	100047096	77435	TBC1 domain family, member 23
PA144596267	57465	TBC1D24	chr16	2515146	2558734	43588	TBC1 domain family, member 24
PA162405201	4943	TBC1D25	chrX	48388075	48423997	35922	TBC1 domain family, member 25
PA162405218	353149	TBC1D26	chr17	15625591	15651098	25507	TBC1 domain family, member 26
PA162405287	254272	TBC1D28	chr17	18535738	18557740	22002	TBC1 domain family, member 28
PA162405312	26083	TBC1D29	chr17	28874124	28893511	19387	TBC1 domain family, member 29
PA142670832	23102	TBC1D2B	chr15	78284327	78379994	95667	TBC1 domain family, member 2B
PA134941179	729873	TBC1D3	chr17	36334528	36359276	24748	TBC1 domain family, member 3
PA162405327	23329	TBC1D30	chr12	65208352	65277802	69450	TBC1 domain family, member 30
PA142670600	93594	TBC1D31	chr8	124074920	124167393	92473	TBC1 domain family, member 31
PA134871908	221322	TBC1D32	chr6	121397627	121665646	268019	TBC1 domain family, member 32
PA142670833	414059	TBC1D3B	chr17	34490061	34514035	23974	TBC1 domain family, member 3B
PA142670834	414060	TBC1D3C	chr17	34578085	34602039	23954	TBC1 domain family, member 3C
PA145007592	84218	TBC1D3F	chr17	36273868	36297915	24047	TBC1 domain family, member 3F
PA145007622	101060321	TBC1D3G	chr17	34794174	34818184	24010	TBC1 domain family, member 3G
PA145007654	729877	TBC1D3H	chr17	34742936	34767050	24114	TBC1 domain family, member 3H
PA38807	9882	TBC1D4	chr13	75855809	76066782	210973	TBC1 domain family, member 4
PA38808	9779	TBC1D5	chr3	17195654	17794240	598586	TBC1 domain family, member 5
PA134929978	51256	TBC1D7	chr6	13302183	13338787	36604	TBC1 domain family, member 7
PA134885935	11138	TBC1D8	chr2	101620690	101777858	157168	TBC1 domain family, member 8 (with GRAM domain)
PA145148061	54885	TBC1D8B	chrX	106035919	106122380	86461	TBC1 domain family, member 8B (with GRAM domain)
PA128394607	23158	TBC1D9	chr4	141538936	141687471	148535	TBC1 domain family, member 9 (with GRAM domain)
PA145148062	23061	TBC1D9B	chr5	179286071	179344879	58808	TBC1 domain family, member 9B (with GRAM domain)
PA36343	6902	TBCA	chr5	76983995	77082185	98190	tubulin folding cofactor A
PA162405357	1155	TBCB	chr19	36595888	36619849	23961	tubulin folding cofactor B
PA36344	6903	TBCC	chr6	42709234	42723884	14650	tubulin folding cofactor C
PA143485628	55171	TBCCD1	chr3	186260856	186298332	37476	TBCC domain containing 1
PA36345	6904	TBCD	chr17	80699938	80904062	204124	tubulin folding cofactor D
PA36346	6905	TBCE	chr1	235520728	235615280	94552	tubulin folding cofactor E
PA162405374	219899	TBCEL	chr11	120884802	120965787	80985	tubulin folding cofactor E-like
PA165664603	93627	TBCK	chr4	106964233	107247861	283628	TBC1 domain containing kinase
PA36348	29110	TBK1	chr12	64835840	64898899	63059	TANK-binding kinase 1
PA142670830	9755	TBKBP1	chr17	45761441	45792429	30988	TBK1 binding protein 1
PA36349	6907	TBL1X	chrX	9421335	9690780	269445	transducin (beta)-like 1X-linked
PA134928556	79718	TBL1XR1	chr3	176735542	176925048	189506	transducin (beta)-like 1 X-linked receptor 1
PA38564	90665	TBL1Y	chrY	6768727	6962977	194250	transducin (beta)-like 1, Y-linked
PA36350	26608	TBL2	chr7	72980274	73003013	22739	transducin (beta)-like 2
PA36351	10607	TBL3	chr16	2012064	2031751	19687	transducin (beta)-like 3
PA36352	6908	TBP	chr6	170853384	170884958	31574	TATA box binding protein
PA36353	9519	TBPL1	chr6	134263308	134311638	48330	TBP-like 1
PA134990291	387332	TBPL2	chr14	55877928	55917263	39335	TATA box binding protein like 2
PA36354	10716	TBR1	chr2	162262620	162285381	22761	T-box, brain, 1
PA134926528	84897	TBRG1	chr11	124482742	124508822	26080	transforming growth factor beta regulator 1
PA134882196	9238	TBRG4	chr7	45136699	45161346	24647	transforming growth factor beta regulator 4
PA36355	6899	TBX1	chr22	19734226	19774116	39890	T-box 1
PA36356	347853	TBX10	chr11	67395774	67417031	21257	T-box 10
PA36357	6913	TBX15	chr1	119422666	119542179	119513	T-box 15
PA36358	9096	TBX18	chr6	85439214	85483954	44740	T-box 18
PA36359	9095	TBX19	chr1	168240278	168286664	46386	T-box 19
PA36360	6909	TBX2	chr17	59467257	59489827	22570	T-box 2
PA36361	57057	TBX20	chr7	35239042	35303711	64669	T-box 20
PA36362	30009	TBX21	chr17	45800610	45826485	25875	T-box 21
PA36363	50945	TBX22	chrX	79260255	79290268	30013	T-box 22
PA36365	6926	TBX3	chr12	115105059	115131969	26910	T-box 3
PA36366	9496	TBX4	chr17	59519134	59565471	46337	T-box 4
PA36367	6910	TBX5	chr12	114788735	114856247	67512	T-box 5
PA36368	6911	TBX6	chr16	30094114	30113258	19144	T-box 6
PA348	6915	TBXA2R	chr19	3591504	3616831	25327	thromboxane A2 receptor
PA349	6916	TBXAS1	chr7	139468047	139723125	255078	thromboxane A synthase 1 (platelet)
PA162405395	123036	TC2N	chr14	92243266	92343880	100614	tandem C2 domains, nuclear
PA142672384	285343	TCAIM	chr3	44369574	44453940	84366	T cell activation inhibitor, mitochondrial
PA36370	8557	TCAP	chr17	37811599	37825807	14208	titin-cap
PA36371	6917	TCEA1	chr8	54876116	54945008	68892	transcription elongation factor A (SII), 1
PA36373	6919	TCEA2	chr20	62678439	62706700	28261	transcription elongation factor A (SII), 2
PA36374	6920	TCEA3	chr1	23704555	23761269	56714	transcription elongation factor A (SII), 3
PA36375	9338	TCEAL1	chrX	102873648	102888881	15233	transcription elongation factor A (SII)-like 1
PA134922072	140597	TCEAL2	chrX	101370660	101385684	15024	transcription elongation factor A (SII)-like 2
PA128394737	85012	TCEAL3	chrX	102852834	102867855	15021	transcription elongation factor A (SII)-like 3
PA128394724	79921	TCEAL4	chrX	102821159	102845659	24500	transcription elongation factor A (SII)-like 4
PA134950668	340543	TCEAL5	chrX	102525618	102541797	16179	transcription elongation factor A (SII)-like 5
PA142670828	158931	TCEAL6	chrX	101391933	101407388	15455	transcription elongation factor A (SII)-like 6
PA134936264	56849	TCEAL7	chrX	102575114	102590251	15137	transcription elongation factor A (SII)-like 7
PA134991274	90843	TCEAL8	chrX	102504923	102520121	15198	transcription elongation factor A (SII)-like 8
PA164726422	170082	TCEANC	chrX	13661252	13686528	25276	transcription elongation factor A (SII) N-terminal and central domain containing
PA142672531	127428	TCEANC2	chr1	54509274	54568416	59142	transcription elongation factor A (SII) N-terminal and central domain containing 2
PA36376	6921	TCEB1	chr8	74854373	74894522	40149	transcription elongation factor B (SIII), polypeptide 1 (15kDa, elongin C)
PA36378	6923	TCEB2	chr16	2818415	2837297	18882	transcription elongation factor B (SIII), polypeptide 2 (18kDa, elongin B)
PA36379	6924	TCEB3	chr1	24059856	24091549	31693	transcription elongation factor B (SIII), polypeptide 3 (110kDa, elongin A)
PA134932220	51224	TCEB3B	chr18	44555943	44571988	16045	transcription elongation factor B polypeptide 3B (elongin A2)
PA134940475	162699	TCEB3C	chr18	44551573	44566449	14876	transcription elongation factor B polypeptide 3C (elongin A3)
PA134878695	728929	TCEB3CL	chr18	44545658	44560298	14640	transcription elongation factor B polypeptide 3C-like
PA38007	10915	TCERG1	chr5	145816873	145894071	77198	transcription elongation regulator 1
PA134864258	256536	TCERG1L	chr10	132887655	133119984	232329	transcription elongation regulator 1-like
PA36381	6938	TCF12	chr15	57200833	57583716	382883	transcription factor 12
PA36382	6939	TCF15	chr20	581637	600910	19273	transcription factor 15 (basic helix-loop-helix)
PA36384	6941	TCF19	chr6	31116303	31137183	20880	transcription factor 19
PA36386	6942	TCF20	chr22	42553019	42674768	121749	transcription factor 20 (AR1)
PA36387	6943	TCF21	chr6	134200259	134219675	19416	transcription factor 21
PA38359	150921	TCF23	chr2	27361835	27379402	17567	transcription factor 23
PA142670826	100129654	TCF24	chr8	67855736	67884825	29089	transcription factor 24
PA145007492	22980	TCF25	chr16	89929994	89980795	50801	transcription factor 25 (basic helix-loop-helix)
PA164742580	6929	TCF3	chr19	1606289	1662328	56039	transcription factor 3
PA164742621	6925	TCF4	chr18	52886562	53313252	426690	transcription factor 4
PA36392	6932	TCF7	chr5	133440402	133486920	46518	transcription factor 7 (T-cell specific, HMG-box)
PA36393	83439	TCF7L1	chr2	85350583	85540511	189928	transcription factor 7-like 1 (T-cell specific, HMG-box)
PA36394	6934	TCF7L2	chr10	114699978	114930437	230459	transcription factor 7-like 2 (T-cell specific, HMG-box)
PA36398	10732	TCFL5	chr20	61469467	61503115	33648	transcription factor-like 5 (basic helix-loop-helix)
PA36503	7062	TCHH	chr1	152075793	152097930	22137	trichohyalin
PA134982007	126637	TCHHL1	chr1	152053620	152071540	17920	trichohyalin-like 1
PA143485629	84260	TCHP	chr12	110328079	110358874	30795	trichoplein, keratin filament binding
PA36399	10312	TCIRG1	chr11	67796462	67821366	24904	T-cell, immune regulator 1, ATPase, H+ transporting, lysosomal V0 subunit A3
PA36400	8115	TCL1A	chr14	96173304	96190533	17229	T-cell leukemia/lymphoma 1A
PA36401	9623	TCL1B	chr14	96142754	96161980	19226	T-cell leukemia/lymphoma 1B
PA36403	6947	TCN1	chr11	59617281	59644041	26760	transcobalamin I (vitamin B12 binding protein, R binder family)
PA36404	6948	TCN2	chr22	30993070	31026047	32977	transcobalamin II
PA36405	6949	TCOF1	chr5	149727202	149782871	55669	Treacher Collins-Franceschetti syndrome 1
PA36406	6950	TCP1	chr6	160196530	160222135	25605	t-complex 1
PA36407	6953	TCP10	chr6	167783577	167807998	24421	t-complex 10
PA36408	140290	TCP10L	chr21	33944151	33967845	23694	t-complex 10-like
PA134917651	401285	TCP10L2	chr6	167574081	167599396	25315	t-complex 10-like 2
PA36409	6954	TCP11	chr6	35082848	35119187	36339	t-complex 11, testis-specific
PA142670824	55346	TCP11L1	chr11	33050963	33098109	47146	t-complex 11, testis-specific-like 1
PA142670825	255394	TCP11L2	chr12	106686570	106744365	57795	t-complex 11, testis-specific-like 2
PA36412	6988	TCTA	chr3	49439639	49456909	17270	T-cell leukemia translocation altered
PA36413	202500	TCTE1	chr6	44244248	44275458	31210	t-complex-associated-testis-expressed 1
PA36415	6991	TCTE3	chr6	170137215	170161638	24423	t-complex-associated-testis-expressed 3
PA142670822	200132	TCTEX1D1	chr1	67207978	67247730	39752	Tctex1 domain containing 1
PA162405435	255758	TCTEX1D2	chr3	196015090	196055165	40075	Tctex1 domain containing 2
PA162405436	343521	TCTEX1D4	chr1	45268580	45283378	14798	Tctex1 domain containing 4
PA162405437	79600	TCTN1	chr12	111041832	111089935	48103	tectonic family member 1
PA162405472	79867	TCTN2	chr12	124145660	124195950	50290	tectonic family member 2
PA162405513	26123	TCTN3	chr10	97420153	97463900	43747	tectonic family member 3
PA36419	6996	TDG	chr12	104349593	104385656	36063	thymine-DNA glycosylase
PA36420	6997	TDGF1	chr3	46606045	46626953	20908	teratocarcinoma-derived growth factor 1
PA36427	6999	TDO2	chr4	156814845	156844558	29713	tryptophan 2,3-dioxygenase
PA421	55775	TDP1	chr14	90411944	90514108	102164	tyrosyl-DNA phosphodiesterase 1
PA165618310	51567	TDP2	chr6	24647205	24677115	29910	tyrosyl-DNA phosphodiesterase 2
PA36430	56165	TDRD1	chr10	115929015	115995425	66410	tudor domain containing 1
PA142670823	126668	TDRD10	chr1	154464695	154523624	58929	tudor domain containing 10
PA162405542	91646	TDRD12	chr19	33200679	33284714	84035	tudor domain containing 12
PA134962690	81550	TDRD3	chr13	60960591	61151013	190422	tudor domain containing 3
PA134953461	163589	TDRD5	chr1	179550748	179663407	112659	tudor domain containing 5
PA134945900	221400	TDRD6	chr6	46645612	46675056	29444	tudor domain containing 6
PA134937960	23424	TDRD7	chr9	100164302	100261407	97105	tudor domain containing 7
PA134890186	122402	TDRD9	chr14	104384776	104522004	137228	tudor domain containing 9
PA36431	11022	TDRKH	chr1	151739741	151773052	33311	tudor and KH domain containing
PA142672361	157695	TDRP	chr8	436790	505781	68991	testis development related protein
PA36432	7003	TEAD1	chr11	12685969	12969284	283315	TEA domain family member 1 (SV40 transcriptional enhancer factor)
PA36433	8463	TEAD2	chr19	49840852	49875714	34862	TEA domain family member 2
PA36434	7005	TEAD3	chr6	35438374	35474884	36510	TEA domain family member 3
PA36435	7004	TEAD4	chr12	3058478	3152842	94364	TEA domain family member 4
PA36436	7006	TEC	chr4	48134800	48281814	147014	tec protein tyrosine kinase
PA164726436	25851	TECPR1	chr7	97841755	97891563	49808	tectonin beta-propeller repeat containing 1
PA164726437	9895	TECPR2	chr14	102819300	102971818	152518	tectonin beta-propeller repeat containing 2
PA28946	9524	TECR	chr19	14630379	14679792	49413	trans-2,3-enoyl-CoA reductase
PA165664664	253017	TECRL	chr4	65139024	65285196	146172	trans-2,3-enoyl-CoA reductase-like
PA36437	7007	TECTA	chr11	120963375	121065202	101827	tectorin alpha
PA36438	6975	TECTB	chr10	114033213	114067793	34580	tectorin beta
PA142670818	127670	TEDDM1	chr1	182364252	182379751	15499	transmembrane epididymal protein 1
PA36439	7008	TEF	chr22	41753337	41798332	44995	thyrotrophic embryonic factor
PA142672226	79736	TEFM	chr17	29223001	29243286	20285	transcription elongation factor, mitochondrial
PA36441	7010	TEK	chr9	27099147	27233172	134025	TEK tyrosine kinase, endothelial
PA37976	83659	TEKT1	chr17	6700300	6745077	44777	tektin 1
PA36442	27285	TEKT2	chr1	36539676	36556877	17201	tektin 2 (testicular)
PA37865	64518	TEKT3	chr17	15204129	15254958	50829	tektin 3
PA142670819	150483	TEKT4	chr2	95527188	95545568	18380	tektin 4
PA162405603	146279	TEKT5	chr16	10718358	10798802	80444	tektin 5
PA162405604	9894	TELO2	chr16	1533352	1563460	30108	telomere maintenance 2
PA165431550	100134934	TEN1	chr17	73965298	73999667	34369	TEN1 CST complex subunit
PA134976096	23371	TENC1	chr12	53430810	53461163	30353	tensin like C1 domain containing phosphatase (tensin 2)
PA31904	10178	TENM1	chrX	123506753	124107666	600913	teneurin transmembrane protein 1
PA134909677	57451	TENM2	chr5	166396083	167694162	1298079	teneurin transmembrane protein 2
PA134961178	55714	TENM3	chr4	183055112	183727177	672065	teneurin transmembrane protein 3
PA134896466	26011	TENM4	chr11	78361328	79162014	800686	teneurin transmembrane protein 4
PA36443	7011	TEP1	chr14	20830826	20892331	61505	telomerase-associated protein 1
PA165450719	374739	TEPP	chr16	58000339	58025020	24681	testis, prostate and placenta expressed
PA36445	7013	TERF1	chr8	73911097	73962987	51890	telomeric repeat binding factor (NIMA-interacting) 1
PA36446	7014	TERF2	chr16	69386464	69429891	43427	telomeric repeat binding factor 2
PA134976325	54386	TERF2IP	chr16	75671602	75694340	22738	telomeric repeat binding factor 2, interacting protein
PA36447	7015	TERT	chr5	1250282	1305178	54896	telomerase reverse transcriptase
PA37906	26136	TES	chr7	115840547	115901840	61293	testis derived transcript (3 LIM domains)
PA143485630	54997	TESC	chr12	117473728	117547251	73523	tescalcin
PA36448	7016	TESK1	chr9	35595281	35613038	17757	testis-specific kinase 1
PA36449	10420	TESK2	chr1	45806555	45966840	160285	testis-specific kinase 2
PA128394561	9840	TESPA1	chr12	55339087	55388965	49878	thymocyte expressed, positive selection associated 1
PA162405605	80312	TET1	chr10	70310117	70457239	147122	tet methylcytosine dioxygenase 1
PA162405634	54790	TET2	chr4	106057032	106203960	146928	tet methylcytosine dioxygenase 2
PA162405645	200424	TET3	chr2	74202211	74338303	136092	tet methylcytosine dioxygenase 3
PA134991964	54881	TEX10	chr9	103061357	103125856	64499	testis expressed 10
PA134938764	83639	TEX101	chr19	43882763	43925767	43004	testis expressed 101
PA36450	56159	TEX11	chrX	69745790	70138567	392777	testis expressed 11
PA36451	56158	TEX12	chr11	111994926	112046279	51353	testis expressed 12
PA36452	56157	TEX13A	chrX	104460611	104475358	14747	testis expressed 13A
PA36453	56156	TEX13B	chrX	107221094	107235600	14506	testis expressed 13B
PA36454	56155	TEX14	chr17	56631038	56779416	148378	testis expressed 14
PA36455	56154	TEX15	chr8	30685939	30780512	94573	testis expressed 15
PA165433159	400629	TEX19	chr17	80307123	80324652	17529	testis expressed 19
PA142670820	55852	TEX2	chr17	62221795	62350653	128858	testis expressed 2
PA144596482	122046	TEX26	chr13	31496834	31552639	55805	testis expressed 26
PA134885680	113419	TEX261	chr2	71210068	71232001	21933	testis expressed 261
PA134875244	51368	TEX264	chr3	51695191	51741339	46148	testis expressed 264
PA162405646	1527	TEX28	chrX	153495930	153533564	37634	testis expressed 28
PA134935852	121793	TEX29	chr13	111963015	111999594	36579	testis expressed 29
PA147358470	93081	TEX30	chr13	103415460	103436168	20708	testis expressed 30
PA162378965	339669	TEX33	chr22	37384160	37413877	29717	testis expressed 33
PA134904440	84066	TEX35	chr1	178472212	178495635	23423	testis expressed 35
PA134969142	387718	TEX36	chr10	127262091	127381735	119644	testis expressed 36
PA162379191	200523	TEX37	chr2	88814115	88832196	18081	testis expressed 37
PA164716726	25858	TEX40	chr11	64057863	64075239	17376	testis expressed 40
PA162380336	389320	TEX43	chr5	125957414	125974974	17560	testis expressed 43
PA142670821	374618	TEX9	chr15	56526207	56742032	215825	testis expressed 9
PA36457	7018	TF	chr3	133454977	133500850	45873	transferrin
PA36458	7019	TFAM	chr10	60134903	60161990	27087	transcription factor A, mitochondrial
PA36459	7020	TFAP2A	chr6	10390419	10429797	39378	transcription factor AP-2 alpha (activating enhancer binding protein 2 alpha)
PA36460	7021	TFAP2B	chr6	50776439	50818326	41887	transcription factor AP-2 beta (activating enhancer binding protein 2 beta)
PA36461	7022	TFAP2C	chr20	55194358	55217339	22981	transcription factor AP-2 gamma (activating enhancer binding protein 2 gamma)
PA37984	83741	TFAP2D	chr6	50671257	50743746	72489	transcription factor AP-2 delta (activating enhancer binding protein 2 delta)
PA134992283	339488	TFAP2E	chr1	36028971	36063929	34958	transcription factor AP-2 epsilon (activating enhancer binding protein 2 epsilon)
PA36462	7023	TFAP4	chr16	4304187	4333001	28814	transcription factor AP-4 (activating enhancer binding protein 4)
PA38198	51106	TFB1M	chr6	155571495	155645631	74136	transcription factor B1, mitochondrial
PA38348	64216	TFB2M	chr1	246700863	246739565	38702	transcription factor B2, mitochondrial
PA36463	7024	TFCP2	chr12	51484539	51576926	92387	transcription factor CP2
PA134980544	29842	TFCP2L1	chr2	121971163	122052778	81615	transcription factor CP2-like 1
PA36464	7027	TFDP1	chr13	114229003	114298788	69785	transcription factor Dp-1
PA36466	7029	TFDP2	chr3	141660270	141878386	218116	transcription factor Dp-2 (E2F dimerization partner 2)
PA134898258	51270	TFDP3	chrX	132347697	132362376	14679	transcription factor Dp family, member 3
PA36467	7030	TFE3	chrX	48883237	48910990	27753	transcription factor binding to IGHM enhancer 3
PA36468	7942	TFEB	chr6	41648716	41713997	65281	transcription factor EB
PA36469	22797	TFEC	chr7	115572202	115809950	237748	transcription factor EC
PA36470	7031	TFF1	chr21	43779391	43796644	17253	trefoil factor 1
PA36471	7032	TFF2	chr21	43763466	43781208	17742	trefoil factor 2
PA36472	7033	TFF3	chr21	43728777	43745706	16929	trefoil factor 3 (intestinal)
PA36473	10342	TFG	chr3	100418128	100470811	52683	TRK-fused gene
PA38441	24144	TFIP11	chr22	26884893	26918462	33569	tuftelin interacting protein 11
PA36475	7035	TFPI	chr2	188325957	188429219	103262	tissue factor pathway inhibitor (lipoprotein-associated coagulation inhibitor)
PA36476	7980	TFPI2	chr7	93511709	93530303	18594	tissue factor pathway inhibitor 2
PA37802	29844	TFPT	chr19	54607320	54629055	21735	TCF3 (E2A) fusion partner (in childhood Leukemia)
PA36477	7036	TFR2	chr7	100215039	100250332	35293	transferrin receptor 2
PA36478	7037	TFRC	chr3	195773155	195819032	45877	transferrin receptor
PA36479	7038	TG	chr8	133869149	134150146	280997	thyroglobulin
PA128395791	23483	TGDS	chr13	95223308	95258511	35203	TDP-glucose 4,6-dehydratase
PA36480	7039	TGFA	chr2	70671412	70791147	119735	transforming growth factor, alpha
PA350	7040	TGFB1	chr19	41833812	41869831	36019	transforming growth factor, beta 1
PA36481	7041	TGFB1I1	chr16	31473476	31492281	18805	transforming growth factor beta 1 induced transcript 1
PA36482	7042	TGFB2	chr1	218508676	218620961	112285	transforming growth factor, beta 2
PA36483	7043	TGFB3	chr14	76421440	76459334	37894	transforming growth factor, beta 3
PA36484	7045	TGFBI	chr5	135354584	135402507	47923	transforming growth factor, beta-induced, 68kDa
PA36485	7046	TGFBR1	chr9	101857412	101919474	62062	transforming growth factor, beta receptor 1
PA36486	7048	TGFBR2	chr3	30637994	30738634	100640	transforming growth factor, beta receptor II (70/80kDa)
PA36487	7049	TGFBR3	chr1	92142900	92381559	238659	transforming growth factor, beta receptor III
PA134963946	9392	TGFBRAP1	chr2	105862861	105956148	93287	transforming growth factor, beta receptor associated protein 1
PA36489	7050	TGIF1	chr18	3401925	3461409	59484	TGFB-induced factor homeobox 1
PA38035	60436	TGIF2	chr20	35191876	35225355	33479	TGFB-induced factor homeobox 2
PA38582	90316	TGIF2LX	chrX	89166940	89180882	13942	TGFB-induced factor homeobox 2-like, X-linked
PA38581	90655	TGIF2LY	chrY	3437126	3451082	13956	TGFB-induced factor homeobox 2-like, Y-linked
PA36490	7051	TGM1	chr14	24715159	24743115	27956	transglutaminase 1
PA36491	7052	TGM2	chr20	36753863	36804910	51047	transglutaminase 2
PA36492	7053	TGM3	chr20	2266613	2324725	58112	transglutaminase 3
PA36493	7047	TGM4	chr3	44906098	44959093	52995	transglutaminase 4
PA36494	9333	TGM5	chr15	43521793	43569055	47262	transglutaminase 5
PA38098	343641	TGM6	chr20	2351554	2416399	64845	transglutaminase 6
PA134870048	116179	TGM7	chr15	43565479	43604453	38974	transglutaminase 7
PA37959	10618	TGOLN2	chr2	85542141	85565419	23278	trans-golgi network protein 2
PA162405660	96764	TGS1	chr8	56675791	56741007	65216	trimethylguanosine synthase 1
PA351	7054	TH	chr11	2182159	2203107	20948	tyrosine hydroxylase
PA134882460	63892	THADA	chr2	43454975	43833185	378210	thyroid adenoma associated
PA134920361	55145	THAP1	chr8	42688817	42708474	19657	THAP domain containing, apoptosis associated protein 1
PA134988462	56906	THAP10	chr15	71170681	71194772	24091	THAP domain containing 10
PA134979842	57215	THAP11	chr16	67866213	67881098	14885	THAP domain containing 11
PA134886354	83591	THAP2	chr12	72047677	72077428	29751	THAP domain containing, apoptosis associated protein 2
PA134987111	90326	THAP3	chr1	6674925	6698646	23721	THAP domain containing, apoptosis associated protein 3
PA134864723	51078	THAP4	chr2	242520820	242586753	65933	THAP domain containing 4
PA134905837	168451	THAP5	chr7	108199671	108220189	20518	THAP domain containing 5
PA134873449	152815	THAP6	chr4	76429654	76471610	41956	THAP domain containing 6
PA134964580	80764	THAP7	chr22	21351061	21366404	15343	THAP domain containing 7
PA134973337	199745	THAP8	chr19	36522886	36555664	32778	THAP domain containing 8
PA134981371	79725	THAP9	chr4	83811837	83844284	32447	THAP domain containing 9
PA36496	7056	THBD	chr20	23023270	23040301	17031	thrombomodulin
PA36497	7057	THBS1	chr15	39863280	39892668	29388	thrombospondin 1
PA36498	7058	THBS2	chr6	169612875	169664137	51262	thrombospondin 2
PA36499	7059	THBS3	chr1	155162379	155187772	25393	thrombospondin 3
PA36500	7060	THBS4	chr5	79321170	79382111	60941	thrombospondin 4
PA134953737	51298	THEG	chr19	358750	386688	27938	theg spermatid protein
PA142670813	117145	THEM4	chr1	151840342	151892361	52019	thioesterase superfamily member 4
PA142670814	284486	THEM5	chr1	151815220	151836173	20953	thioesterase superfamily member 5
PA142672318	51337	THEM6	chr8	143798621	143821350	22729	thioesterase superfamily member 6
PA165618330	387357	THEMIS	chr6	128026339	128249776	223437	thymocyte selection associated
PA128394550	9473	THEMIS2	chr1	28189055	28216196	27141	thymocyte selection associated family member 2
PA162405691	54974	THG1L	chr5	157148323	157169982	21659	tRNA-histidine guanylyltransferase 1-like (S. cerevisiae)
PA134906927	79896	THNSL1	chr10	25295508	25318593	23085	threonine synthase-like 1 (S. cerevisiae)
PA162405692	55258	THNSL2	chr2	88459814	88489156	29342	threonine synthase-like 2 (S. cerevisiae)
PA134887435	9984	THOC1	chr18	211520	278059	66539	THO complex 1
PA128395788	57187	THOC2	chrX	122731412	122876904	145492	THO complex 2
PA134893535	84321	THOC3	chr5	175383534	175405318	21784	THO complex 3
PA38188	8563	THOC5	chr22	29901156	29959749	58593	THO complex 5
PA142670592	79228	THOC6	chr16	3064032	3080756	16724	THO complex 6 homolog (Drosophila)
PA144596266	80145	THOC7	chr3	63816546	63859597	43051	THO complex 7 homolog (Drosophila)
PA36505	7064	THOP1	chr19	2775464	2816599	41135	thimet oligopeptidase 1
PA36506	7066	THPO	chr3	184086773	184107368	20595	thrombopoietin
PA36507	7067	THRA	chr17	38208446	38253120	44674	thyroid hormone receptor, alpha
PA134893249	9967	THRAP3	chr1	36680017	36773958	93941	thyroid hormone receptor associated protein 3
PA36508	7068	THRB	chr3	24155644	24546772	391128	thyroid hormone receptor, beta
PA36509	7069	THRSP	chr11	77764907	77782403	17496	thyroid hormone responsive
PA134937912	55901	THSD1	chr13	52931506	52990629	59123	thrombospondin, type I, domain containing 1
PA143485631	79875	THSD4	chr15	71397935	72078722	680787	thrombospondin, type I, domain containing 4
PA162405715	221981	THSD7A	chr7	11407062	11881824	474762	thrombospondin, type I, domain containing 7A
PA162405776	80731	THSD7B	chr2	137629718	138438287	808569	thrombospondin, type I, domain containing 7B
PA38774	79178	THTPA	chr14	23970969	24031790	60821	thiamine triphosphatase
PA134983093	55623	THUMPD1	chr16	20729498	20763405	33907	THUMP domain containing 1
PA134976355	80745	THUMPD2	chr2	39960200	40016416	56216	THUMP domain containing 2
PA134969445	25917	THUMPD3	chr3	9394660	9431475	36815	THUMP domain containing 3
PA36510	7070	THY1	chr11	119285655	119304246	18591	Thy-1 cell surface antigen
PA128394653	29087	THYN1	chr11	134115172	134133289	18117	thymocyte nuclear protein 1
PA36511	7072	TIA1	chr2	70433576	70485886	52310	TIA1 cytotoxic granule-associated RNA binding protein
PA36512	9220	TIAF1	chr17	27397539	27412627	15088	TGFB1-induced anti-apoptotic factor 1
PA36513	7073	TIAL1	chr10	121329977	121366541	36564	TIA1 cytotoxic granule-associated RNA binding protein-like 1
PA36514	7074	TIAM1	chr21	32487736	32941290	453554	T-cell lymphoma invasion and metastasis 1
PA36515	26230	TIAM2	chr6	155306488	155581857	275369	T-cell lymphoma invasion and metastasis 2
PA142670812	148022	TICAM1	chr19	4812936	4841754	28818	toll-like receptor adaptor molecule 1
PA134881157	353376	TICAM2	chr5	114911339	114962142	50803	toll-like receptor adaptor molecule 2
PA142672278	90381	TICRR	chr15	90108818	90174254	65436	TOPBP1-interacting checkpoint and replication regulator
PA36516	7075	TIE1	chr1	43756566	43791781	35215	tyrosine kinase with immunoglobulin-like and EGF-like domains 1
PA162405777	92610	TIFA	chr4	113193782	113217059	23277	TRAF-interacting protein with forkhead-associated domain
PA162405786	497189	TIFAB	chr5	134781558	134798089	16531	TRAF-interacting protein with forkhead-associated domain, family member B
PA38382	200765	TIGD1	chr2	233409779	233425226	15447	tigger transposable element derived 1
PA38526	166815	TIGD2	chr4	90022651	90039734	17083	tigger transposable element derived 2
PA38527	220359	TIGD3	chr11	65112282	65128084	15802	tigger transposable element derived 3
PA38528	201798	TIGD4	chr4	153686837	153710916	24079	tigger transposable element derived 4
PA38529	84948	TIGD5	chr8	144670074	144685485	15411	tigger transposable element derived 5
PA38525	81789	TIGD6	chr5	149369686	149390730	21044	tigger transposable element derived 6
PA38524	91151	TIGD7	chr16	3345808	3365439	19631	tigger transposable element derived 7
PA164726482	201633	TIGIT	chr3	114002833	114032135	29302	T cell immunoreceptor with Ig and ITIM domains
PA134989118	91937	TIMD4	chr5	156343293	156400266	56973	T-cell immunoglobulin and mucin domain containing 4
PA36520	8914	TIMELESS	chr12	56807157	56853200	46043	timeless circadian clock
PA36521	26519	TIMM10	chr11	57292936	57308232	15296	translocase of inner mitochondrial membrane 10 homolog (yeast)
PA28438	26515	TIMM10B	chr11	6492677	6509109	16432	translocase of inner mitochondrial membrane 10 homolog B (yeast)
PA36522	26517	TIMM13	chr19	2422622	2437914	15292	translocase of inner mitochondrial membrane 13 homolog (yeast)
PA38228	10440	TIMM17A	chr1	201914619	201942789	28170	translocase of inner mitochondrial membrane 17 homolog A (yeast)
PA38226	10245	TIMM17B	chrX	48747730	48765489	17759	translocase of inner mitochondrial membrane 17 homolog B (yeast)
PA134897360	29090	TIMM21	chr18	71805746	71829204	23458	translocase of inner mitochondrial membrane 21 homolog (yeast)
PA38230	29928	TIMM22	chr17	890357	908407	18050	translocase of inner mitochondrial membrane 22 homolog (yeast)
PA38227	100287932	TIMM23	chr10	51589080	51633386	44306	translocase of inner mitochondrial membrane 23 homolog (yeast)
PA134877974	100652748	TIMM23B	chr10	51361379	51397920	36541	translocase of inner mitochondrial membrane 23 homolog B (yeast)
PA38229	10469	TIMM44	chr19	7988603	8018708	30105	translocase of inner mitochondrial membrane 44 homolog (yeast)
PA134902846	92609	TIMM50	chr19	39961052	39984528	23476	translocase of inner mitochondrial membrane 50 homolog (S. cerevisiae)
PA36523	1678	TIMM8A	chrX	100572548	100613957	41409	translocase of inner mitochondrial membrane 8 homolog A (yeast)
PA36524	26521	TIMM8B	chr11	111952524	111967522	14998	translocase of inner mitochondrial membrane 8 homolog B (yeast)
PA36525	26520	TIMM9	chr14	58872370	58904232	31862	translocase of inner mitochondrial membrane 9 homolog (yeast)
PA25900	51300	TIMMDC1	chr3	119207324	119246128	38804	translocase of inner mitochondrial membrane domain containing 1
PA36526	7076	TIMP1	chrX	47431690	47449190	17500	TIMP metallopeptidase inhibitor 1
PA36527	7077	TIMP2	chr17	76846059	76931472	85413	TIMP metallopeptidase inhibitor 2
PA36528	7078	TIMP3	chr22	33186802	33262028	75226	TIMP metallopeptidase inhibitor 3
PA36529	7079	TIMP4	chr3	12191568	12210851	19283	TIMP metallopeptidase inhibitor 4
PA37905	27283	TINAG	chr6	54163203	54257950	94747	tubulointerstitial nephritis antigen
PA38810	64129	TINAGL1	chr1	32032086	32056290	24204	tubulointerstitial nephritis antigen-like 1
PA36530	26277	TINF2	chr14	24700454	24722233	21779	TERF1 (TRF1)-interacting nuclear factor 2
PA134885396	25976	TIPARP	chr3	156382205	156427559	45354	TCDD-inducible poly(ADP-ribose) polymerase
PA147357269	54962	TIPIN	chr15	66626008	66689074	63066	TIMELESS interacting protein
PA142670811	261726	TIPRL	chr1	168138171	168174352	36181	TOR signaling pathway regulator
PA134972842	114609	TIRAP	chr11	126142800	126167828	25028	toll-interleukin 1 receptor (TIR) domain containing adaptor protein
PA38268	93643	TJAP1	chr6	43435261	43477294	42033	tight junction associated protein 1 (peripheral)
PA36532	7082	TJP1	chr15	29989338	30271038	281700	tight junction protein 1
PA36533	9414	TJP2	chr9	71704875	71873124	168249	tight junction protein 2
PA36534	27134	TJP3	chr19	3698335	3753811	55476	tight junction protein 3
PA352	7083	TK1	chr17	76167160	76193285	26125	thymidine kinase 1, soluble
PA36535	7084	TK2	chr16	66538906	66594315	55409	thymidine kinase 2, mitochondrial
PA36537	7086	TKT	chr3	53255723	53300130	44407	transketolase
PA36538	8277	TKTL1	chrX	153513979	153561713	47734	transketolase-like 1
PA142670806	84076	TKTL2	chr4	164389245	164405047	15802	transketolase-like 2
PA142670807	116238	TLCD1	chr17	27048366	27063949	15583	TLC domain containing 1
PA162405795	727910	TLCD2	chr17	1603084	1623662	20578	TLC domain containing 2
PA144596416	57707	TLDC1	chr16	84506966	84548366	41400	TBC/LysM-associated domain containing 1
PA25658	140711	TLDC2	chr20	35494570	35525632	31062	TBC/LysM-associated domain containing 2
PA36539	7088	TLE1	chr9	84195598	84313596	117998	transducin-like enhancer of split 1 (E(sp1) homolog, Drosophila)
PA36540	7089	TLE2	chr19	2994636	3057846	63210	transducin-like enhancer of split 2
PA36541	7090	TLE3	chr15	70337129	70400274	63145	transducin-like enhancer of split 3
PA36542	7091	TLE4	chr9	82176878	82344658	167780	transducin-like enhancer of split 4
PA134948893	79816	TLE6	chr19	2967536	2998182	30646	transducin-like enhancer of split 6
PA36543	9874	TLK1	chr2	171844333	172097824	253491	tousled-like kinase 1
PA36544	11011	TLK2	chr17	60544447	60695842	151395	tousled-like kinase 2
PA36545	7092	TLL1	chr4	166784390	167029330	244940	tolloid-like 1
PA36546	7093	TLL2	chr10	98121363	98283683	162320	tolloid-like 2
PA36547	7094	TLN1	chr9	35694334	35742392	48058	talin 1
PA37958	83660	TLN2	chr15	62672769	63139830	467061	talin 2
PA36549	7096	TLR1	chr4	38794876	38816814	21938	toll-like receptor 1
PA38011	81793	TLR10	chr4	38770860	38794611	23751	toll-like receptor 10
PA36550	7097	TLR2	chr4	154595404	154630243	34839	toll-like receptor 2
PA36551	7098	TLR3	chr4	186980309	187009252	28943	toll-like receptor 3
PA36552	7099	TLR4	chr9	120456453	120482769	26316	toll-like receptor 4
PA36553	7100	TLR5	chr1	223279748	223326624	46876	toll-like receptor 5
PA38183	10333	TLR6	chr4	38822325	38868438	46113	toll-like receptor 6
PA38008	51284	TLR7	chrX	12875202	12911480	36278	toll-like receptor 7
PA38009	51311	TLR8	chrX	12914739	12944288	29549	toll-like receptor 8
PA38010	54106	TLR9	chr3	52252096	52270179	18083	toll-like receptor 9
PA35095	3195	TLX1	chr10	102881061	102900546	19485	T-cell leukemia homeobox 1
PA35096	3196	TLX2	chr2	74730686	74747275	16589	T-cell leukemia homeobox 2
PA37797	30012	TLX3	chr5	170726288	170742138	15850	T-cell leukemia homeobox 3
PA142670798	83941	TM2D1	chr1	62143718	62201095	57377	TM2 domain containing 1
PA142670799	83877	TM2D2	chr8	38843327	38864335	21008	TM2 domain containing 2
PA142670800	80213	TM2D3	chr15	102170429	102202594	32165	TM2 domain containing 3
PA36554	4071	TM4SF1	chr3	149083805	149105647	21842	transmembrane 4 L six family member 1
PA142670801	116441	TM4SF18	chr3	149033285	149061548	28263	transmembrane 4 L six family member 18
PA142670802	116211	TM4SF19	chr3	196047417	196075291	27874	transmembrane 4 L six family member 19
PA142670803	79853	TM4SF20	chr2	228223872	228254022	30150	transmembrane 4 L six family member 20
PA36557	7104	TM4SF4	chr3	149182368	149224181	41813	transmembrane 4 L six family member 4
PA36558	9032	TM4SF5	chr17	4665187	4689506	24319	transmembrane 4 L six family member 5
PA36561	53346	TM6SF1	chr15	83766301	83809111	42810	transmembrane 6 superfamily member 1
PA36562	53345	TM6SF2	chr19	19371841	19394074	22233	transmembrane 6 superfamily member 2
PA36564	7108	TM7SF2	chr11	64869326	64886707	17381	transmembrane 7 superfamily member 2
PA134949354	51768	TM7SF3	chr12	27121503	27177360	55857	transmembrane 7 superfamily member 3
PA36565	10548	TM9SF1	chr14	24655353	24676288	20935	transmembrane 9 superfamily member 1
PA36566	9375	TM9SF2	chr13	100143628	100219302	75674	transmembrane 9 superfamily member 2
PA144596264	56889	TM9SF3	chr10	98274867	98356809	81942	transmembrane 9 superfamily member 3
PA134937613	9777	TM9SF4	chr20	30687309	30758061	70752	transmembrane 9 superfamily protein member 4
PA162379923	55319	TMA16	chr4	164405673	164444691	39018	translation machinery associated 16 homolog (S. cerevisiae)
PA143485423	51372	TMA7	chr3	48471686	48488537	16851	translation machinery associated 7 homolog (S. cerevisiae)
PA142670804	64114	TMBIM1	chr2	219135917	219167280	31363	transmembrane BAX inhibitor motif containing 1
PA142670805	51643	TMBIM4	chr12	66527717	66573808	46091	transmembrane BAX inhibitor motif containing 4
PA36440	7009	TMBIM6	chr12	50125293	50161717	36424	transmembrane BAX inhibitor motif containing 6
PA38156	117531	TMC1	chr9	75126717	75454267	327550	transmembrane channel-like 1
PA38158	117532	TMC2	chr20	2507253	2625494	118241	transmembrane channel-like 2
PA134916179	342125	TMC3	chr15	81621760	81676418	54658	transmembrane channel-like 3
PA134874063	147798	TMC4	chr19	54660833	54686944	26111	transmembrane channel-like 4
PA134923498	79838	TMC5	chr16	19411839	19513435	101596	transmembrane channel-like 5
PA134949466	11322	TMC6	chr17	76105999	76138488	32489	transmembrane channel-like 6
PA134988099	79905	TMC7	chr16	18985256	19078264	93008	transmembrane channel-like 7
PA134892288	147138	TMC8	chr17	76115505	76142049	26544	transmembrane channel-like 8
PA134951990	23023	TMCC1	chr3	129363635	129622419	258784	transmembrane and coiled-coil domain family 1
PA134963344	9911	TMCC2	chr1	205187038	205245471	58433	transmembrane and coiled-coil domain family 2
PA134874359	57458	TMCC3	chr12	94957900	95054324	96424	transmembrane and coiled-coil domain family 3
PA142670792	54499	TMCO1	chr1	165690528	165748159	57631	transmembrane and coiled-coil domains 1
PA142670793	127391	TMCO2	chr1	40703573	40720365	16792	transmembrane and coiled-coil domains 2
PA134989495	55002	TMCO3	chr13	114135308	114207544	72236	transmembrane and coiled-coil domains 3
PA142670794	255104	TMCO4	chr1	20005706	20136424	130718	transmembrane and coiled-coil domains 4
PA162405808	145942	TMCO5A	chr15	38216801	38246623	29822	transmembrane and coiled-coil domains 5A
PA162405810	55374	TMCO6	chr5	140009012	140027989	18977	transmembrane and coiled-coil domains 6
PA134972147	11018	TMED1	chr19	10939743	10956983	17240	transmembrane emp24 protein transport domain containing 1
PA128394579	10972	TMED10	chr14	75595171	75653349	58178	transmembrane emp24-like trafficking protein 10 (yeast)
PA164726508	100379220	TMED11P	chr4	1105985	1126952	20967	transmembrane emp24 protein transport domain containing 11, pseudogene
PA142670796	10959	TMED2	chr12	124059076	124085688	26612	transmembrane emp24 domain trafficking protein 2
PA134958958	23423	TMED3	chr15	79593404	79678802	85398	transmembrane emp24 protein transport domain containing 3
PA134983854	222068	TMED4	chr7	44614493	44631881	17388	transmembrane emp24 protein transport domain containing 4
PA134942067	50999	TMED5	chr1	93612299	93656246	43947	transmembrane emp24 protein transport domain containing 5
PA128394759	146456	TMED6	chr16	69374149	69395712	21563	transmembrane emp24 protein transport domain containing 6
PA134891536	51014	TMED7	chr5	114945905	114971876	25971	transmembrane emp24 protein transport domain containing 7
PA165660570	100302736	TMED7-TICAM2	chr5	114911339	114971876	60537	TMED7-TICAM2 readthrough
PA134948632	283578	TMED8	chr14	77802102	77853396	51294	transmembrane emp24 protein transport domain containing 8
PA134881976	54732	TMED9	chr5	177009213	177026108	16895	transmembrane emp24 protein transport domain containing 9
PA36567	8577	TMEFF1	chr9	103225520	103342918	117398	transmembrane protein with EGF-like and two follistatin-like domains 1
PA36568	23671	TMEFF2	chr2	192767615	193069645	302030	transmembrane protein with EGF-like and two follistatin-like domains 2
PA142670749	55273	TMEM100	chr17	53793988	53819482	25494	transmembrane protein 100
PA142670750	84336	TMEM101	chr17	42085556	42110519	24963	transmembrane protein 101
PA142670751	284114	TMEM102	chr17	7328762	7343998	15236	transmembrane protein 102
PA142670753	54868	TMEM104	chr17	72762622	72838922	76300	transmembrane protein 104
PA142670754	284186	TMEM105	chr17	79282070	79314474	32404	transmembrane protein 105
PA142670755	113277	TMEM106A	chr17	41353865	41375061	21196	transmembrane protein 106A
PA142670756	54664	TMEM106B	chr7	12240848	12279890	39042	transmembrane protein 106B
PA142670757	79022	TMEM106C	chr12	48347330	48365661	18331	transmembrane protein 106C
PA142670758	84314	TMEM107	chr17	8073296	8089723	16427	transmembrane protein 107
PA142670759	66000	TMEM108	chr3	132747171	133119619	372448	transmembrane protein 108
PA142670760	79073	TMEM109	chr11	60671351	60693915	22564	transmembrane protein 109
PA134893886	8834	TMEM11	chr17	21098263	21127974	29711	transmembrane protein 11
PA142670761	375346	TMEM110	chr3	52867772	52941597	73825	transmembrane protein 110
PA162405852	283953	TMEM114	chr16	8616502	8632226	15724	transmembrane protein 114
PA143485636	11070	TMEM115	chr3	50389180	50406939	17759	transmembrane protein 115
PA143485637	89894	TMEM116	chr12	112366086	112461023	94937	transmembrane protein 116
PA143485638	84216	TMEM117	chr12	44219853	44786543	566690	transmembrane protein 117
PA143485640	338773	TMEM119	chr12	108980622	109001894	21272	transmembrane protein 119
PA162405862	144404	TMEM120B	chr12	122140658	122222974	82316	transmembrane protein 120B
PA143485641	80757	TMEM121	chr14	105982953	105999554	16601	transmembrane protein 121
PA143485643	114908	TMEM123	chr11	102264056	102333775	69719	transmembrane protein 123
PA143485644	128218	TMEM125	chr1	43725665	43742673	17008	transmembrane protein 125
PA143485645	84233	TMEM126A	chr11	85348963	85370597	21634	transmembrane protein 126A
PA143485646	55863	TMEM126B	chr11	85329617	85350583	20966	transmembrane protein 126B
PA143485647	55654	TMEM127	chr2	96912946	96941751	28805	transmembrane protein 127
PA143485648	85013	TMEM128	chr4	4234269	4259965	25696	transmembrane protein 128
PA143485649	92305	TMEM129	chr4	1714679	1733084	18405	transmembrane protein 129, E3 ubiquitin protein ligase
PA143485650	222865	TMEM130	chr7	98441111	98477673	36562	transmembrane protein 130
PA143485651	23505	TMEM131	chr2	98369799	98622389	252590	transmembrane protein 131
PA134886953	54972	TMEM132A	chr11	60681913	60707631	25718	transmembrane protein 132A
PA143485652	114795	TMEM132B	chr12	125801162	126149915	348753	transmembrane protein 132B
PA143485653	92293	TMEM132C	chr12	128741948	129195460	453512	transmembrane protein 132C
PA143485654	121256	TMEM132D	chr12	129553271	130398212	844941	transmembrane protein 132D
PA143485655	124842	TMEM132E	chr17	32897768	32969337	71569	transmembrane protein 132E
PA143485656	83935	TMEM133	chr11	100852811	100867666	14855	transmembrane protein 133
PA143485657	80194	TMEM134	chr11	67228819	67246748	17929	transmembrane protein 134
PA143485658	65084	TMEM135	chr11	86738886	87042876	303990	transmembrane protein 135
PA144596257	219902	TMEM136	chr11	120185838	120207397	21559	transmembrane protein 136
PA144596259	51524	TMEM138	chr11	61119473	61139977	20504	transmembrane protein 138
PA144596260	135932	TMEM139	chr7	142972040	142988141	16101	transmembrane protein 139
PA144596261	55281	TMEM140	chr7	134822766	134853967	31201	transmembrane protein 140
PA144596262	85014	TMEM141	chr9	139675777	139690769	14992	transmembrane protein 141
PA144596251	55260	TMEM143	chr19	48832613	48877489	44876	transmembrane protein 143
PA144596252	55314	TMEM144	chr4	159112749	159179439	66690	transmembrane protein 144
PA144596253	284339	TMEM145	chr19	42807477	42832214	24737	transmembrane protein 145
PA144596255	10430	TMEM147	chr19	36026502	36041429	14927	transmembrane protein 147
PA134974524	28978	TMEM14A	chr6	52525884	52554386	28502	transmembrane protein 14A
PA134964501	81853	TMEM14B	chr6	10737995	10773389	35394	transmembrane protein 14B
PA134874746	51522	TMEM14C	chr6	10713148	10744577	31429	transmembrane protein 14C
PA134907907	645203	TMEM14D	chr10	70300776	70314697	13921	transmembrane protein 14D (pseudogene)
PA162405891	645843	TMEM14E	chr3	152054487	152068779	14292	transmembrane protein 14E
PA165697532	129303	TMEM150A	chr2	85822670	85839822	17152	transmembrane protein 150A
PA165394503	284417	TMEM150B	chr19	55820653	55855416	34763	transmembrane protein 150B
PA165664735	441027	TMEM150C	chr4	83401329	83493595	92266	transmembrane protein 150C
PA162405898	256472	TMEM151A	chr11	66049373	66067135	17762	transmembrane protein 151A
PA162405899	441151	TMEM151B	chr6	44228480	44250182	21702	transmembrane protein 151B
PA145007430	201799	TMEM154	chr4	153544266	153611317	67051	transmembrane protein 154
PA145007448	132332	TMEM155	chr4	122677085	122696516	19431	transmembrane protein 155
PA145007464	80008	TMEM156	chr4	38965052	39044041	78989	transmembrane protein 156
PA128395777	25907	TMEM158	chr3	45262956	45277814	14858	transmembrane protein 158 (gene/pseudogene)
PA145147935	57146	TMEM159	chr16	21159703	21194937	35234	transmembrane protein 159
PA145147949	54958	TMEM160	chr19	47546167	47561882	15715	transmembrane protein 160
PA145147959	54929	TMEM161A	chr19	19227425	19259310	31885	transmembrane protein 161A
PA145147987	153396	TMEM161B	chr5	87482450	87574665	92215	transmembrane protein 161B
PA145148025	81615	TMEM163	chr2	135210330	135488219	277889	transmembrane protein 163
PA145148045	84187	TMEM164	chrX	109235641	109424016	188375	transmembrane protein 164
PA147357214	55858	TMEM165	chr4	56252080	56295342	43262	transmembrane protein 165
PA162405909	153339	TMEM167A	chr5	82345665	82383272	37607	transmembrane protein 167A
PA162405910	56900	TMEM167B	chr1	109623403	109642554	19151	transmembrane protein 167B
PA147357253	64418	TMEM168	chr7	112402364	112440768	38404	transmembrane protein 168
PA162405911	92691	TMEM169	chr2	216936589	216970506	33917	transmembrane protein 169
PA134962933	200728	TMEM17	chr2	62724356	62743604	19248	transmembrane protein 17
PA162405922	124491	TMEM170A	chr16	75474136	75508584	34448	transmembrane protein 170A
PA162405923	100113407	TMEM170B	chr6	11528460	11586757	58297	transmembrane protein 170B
PA162405933	134285	TMEM171	chr5	72400286	72430765	30479	transmembrane protein 171
PA162405934	340061	TMEM173	chr5	138852113	138872343	20230	transmembrane protein 173
PA162405935	134288	TMEM174	chr5	72454080	72474073	19993	transmembrane protein 174
PA162405946	84286	TMEM175	chr4	916175	955444	39269	transmembrane protein 175
PA162405947	55365	TMEM176A	chr7	150487854	150505208	17354	transmembrane protein 176A
PA162405966	28959	TMEM176B	chr7	150485375	150508448	23073	transmembrane protein 176B
PA162405985	80775	TMEM177	chr2	120426743	120442694	15951	transmembrane protein 177
PA162405994	130733	TMEM178A	chr2	39882638	39948103	65465	transmembrane protein 178A
PA162405995	388021	TMEM179	chr14	105056330	105081097	24767	transmembrane protein 179
PA162405996	374395	TMEM179B	chr11	62544281	62560872	16591	transmembrane protein 179B
PA134873089	129787	TMEM18	chr2	664793	687439	22646	transmembrane protein 18
PA162406011	79847	TMEM180	chr10	104211149	104242546	31397	transmembrane protein 180
PA162406036	57583	TMEM181	chr6	158947468	159059467	111999	transmembrane protein 181
PA162406075	130827	TMEM182	chr2	103368490	103453948	85458	transmembrane protein 182
PA162406090	92703	TMEM183A	chr1	202966520	202996976	30456	transmembrane protein 183A
PA162406111	653659	TMEM183B	chr3	149696448	149711153	14705	transmembrane protein 183B
PA162406118	202915	TMEM184A	chr7	1578871	1606066	27195	transmembrane protein 184A
PA162406140	25829	TMEM184B	chr22	38609415	38679040	69625	transmembrane protein 184B
PA162406163	55751	TMEM184C	chr4	148528539	148559674	31135	transmembrane protein 184C
PA27062	84548	TMEM185A	chrX	148675216	148723487	48271	transmembrane protein 185A
PA162406190	25880	TMEM186	chr16	8886037	8901505	15468	transmembrane protein 186
PA162406199	8269	TMEM187	chrX	153227991	153251646	23655	transmembrane protein 187
PA162406209	387521	TMEM189	chr20	48737274	48780335	43061	transmembrane protein 189
PA162406226	387522	TMEM189-UBE2V1	chr20	48694661	48780335	85674	TMEM189-UBE2V1 readthrough
PA134909388	55266	TMEM19	chr12	72069878	72100840	30962	transmembrane protein 19
PA162406247	147744	TMEM190	chr19	55878204	55892612	14408	transmembrane protein 190
PA162406273	201931	TMEM192	chr4	165994230	166044024	49794	transmembrane protein 192
PA162406290	23306	TMEM194A	chr12	57446426	57482574	36148	transmembrane protein 194A
PA162406311	100131211	TMEM194B	chr2	191368619	191409468	40849	transmembrane protein 194B
PA162406335	256130	TMEM196	chr7	19755938	19822404	66466	transmembrane protein 196
PA162406347	130612	TMEM198	chr2	220398385	220418317	19932	transmembrane protein 198
PA162406348	147007	TMEM199	chr17	26674687	26692089	17402	transmembrane protein 199
PA36570	23670	TMEM2	chr9	74295282	74394373	99091	transmembrane protein 2
PA162406349	114801	TMEM200A	chr6	130677426	130767569	90143	transmembrane protein 200A
PA162406350	399474	TMEM200B	chr1	29442937	29460421	17484	transmembrane protein 200B
PA165429148	645369	TMEM200C	chr18	5886411	5905373	18962	transmembrane protein 200C
PA162406359	199953	TMEM201	chr1	9638932	9677935	39003	transmembrane protein 201
PA162406376	338949	TMEM202	chr15	72680668	72703708	23040	transmembrane protein 202
PA162406377	94107	TMEM203	chr9	140095534	140110090	14556	transmembrane protein 203
PA162406384	79652	TMEM204	chr16	1568742	1608581	39839	transmembrane protein 204
PA162406385	374882	TMEM205	chr19	11450452	11467065	16613	transmembrane protein 205
PA162406386	55248	TMEM206	chr1	212534816	212598267	63451	transmembrane protein 206
PA162406407	131920	TMEM207	chr3	190143444	190177665	34221	transmembrane protein 207
PA162406408	29100	TMEM208	chr16	67251006	67266182	15176	transmembrane protein 208
PA162406425	84928	TMEM209	chr7	129801555	129855338	53783	transmembrane protein 209
PA162406474	255349	TMEM211	chr22	25328208	25345314	17106	transmembrane protein 211
PA162406475	389177	TMEM212	chr3	171551139	171580108	28969	transmembrane protein 212
PA162406494	155006	TMEM213	chr7	138472664	138493769	21105	transmembrane protein 213
PA162406505	54867	TMEM214	chr2	27245774	27267565	21791	transmembrane protein 214
PA162406544	401498	TMEM215	chr9	32773497	32792199	18702	transmembrane protein 215
PA162406553	51259	TMEM216	chr11	61149832	61169335	19503	transmembrane protein 216
PA162406568	221468	TMEM217	chr6	37176954	37235931	58977	transmembrane protein 217
PA162406569	219854	TMEM218	chr11	124961266	124991659	30393	transmembrane protein 218
PA162406570	124446	TMEM219	chr16	29963351	29987373	24022	transmembrane protein 219
PA162406587	388335	TMEM220	chr17	10613631	10643646	30015	transmembrane protein 220
PA162406588	100130519	TMEM221	chr19	17543318	17569376	26058	transmembrane protein 221
PA162406598	84065	TMEM222	chr1	27638636	27665891	27255	transmembrane protein 222
PA164726538	79064	TMEM223	chr11	62554787	62569486	14699	transmembrane protein 223
PA164726548	338661	TMEM225	chr11	123750633	123766340	15707	transmembrane protein 225
PA165618420	730130	TMEM229A	chr7	123667970	123683523	15553	transmembrane protein 229A
PA165479330	161145	TMEM229B	chr14	67910801	67992445	81644	transmembrane protein 229B
PA25746	29058	TMEM230	chr20	5046129	5103736	57607	transmembrane protein 230
PA165450754	79583	TMEM231	chr16	75569015	75600184	31169	transmembrane protein 231
PA165660571	642987	TMEM232	chr5	109752197	110072507	320310	transmembrane protein 232
PA165513584	387890	TMEM233	chr12	120021264	120082861	61597	transmembrane protein 233
PA134931867	653567	TMEM236	chr10	17784260	17845866	61606	transmembrane protein 236
PA24745	65062	TMEM237	chr2	202481907	202518252	36345	transmembrane protein 237
PA142672520	339453	TMEM240	chr1	1467158	1485740	18582	transmembrane protein 240
PA134952915	85019	TMEM241	chr18	20872977	21027925	154948	transmembrane protein 241
PA25936	729515	TMEM242	chr6	157707054	157755253	48199	transmembrane protein 242
PA134985688	79161	TMEM243	chr7	86822477	86859889	37412	transmembrane protein 243, mitochondrial
PA134909151	253582	TMEM244	chr6	130149389	130192416	43027	transmembrane protein 244
PA25980	23731	TMEM245	chr9	111774415	111892225	117810	transmembrane protein 245
PA134867545	84302	TMEM246	chr9	104232442	104259475	27033	transmembrane protein 246
PA147358581	55069	TMEM248	chr7	66376203	66426538	50335	transmembrane protein 248
PA134919013	84866	TMEM25	chr11	118391803	118420313	28510	transmembrane protein 25
PA134977710	26175	TMEM251	chr14	93641296	93656431	15135	transmembrane protein 251
PA134989660	169693	TMEM252	chr9	71148496	71165783	17287	transmembrane protein 252
PA143485392	643382	TMEM253	chr14	21557096	21574883	17787	transmembrane protein 253
PA134875855	80195	TMEM254	chr10	81828402	81855307	26905	transmembrane protein 254
PA142671885	55026	TMEM255A	chrX	119389505	119455391	65886	transmembrane protein 255A
PA142671886	348013	TMEM255B	chr13	114452191	114518225	66034	transmembrane protein 255B
PA142672244	254863	TMEM256	chr17	7303293	7317450	14157	transmembrane protein 256
PA27059	9142	TMEM257	chrX	144898928	144914374	15446	transmembrane protein 257
PA25478	746	TMEM258	chr11	61553602	61570085	16483	transmembrane protein 258
PA134936083	91304	TMEM259	chr19	1006650	1031173	24523	transmembrane protein 259
PA134887276	219623	TMEM26	chr10	63163401	63223208	59807	transmembrane protein 26
PA134894829	54916	TMEM260	chr14	57036509	57119233	82724	transmembrane protein 260
PA134876562	90871	TMEM261	chr9	7793490	7809799	16309	transmembrane protein 261
PA142672295	90488	TMEM263	chr12	107339544	107370813	31269	transmembrane protein 263
PA134994199	57393	TMEM27	chrX	15642439	15693154	50715	transmembrane protein 27
PA134936902	55754	TMEM30A	chr6	75959638	76004632	44994	transmembrane protein 30A
PA134993260	161291	TMEM30B	chr14	61741088	61758530	17442	transmembrane protein 30B
PA134926659	203562	TMEM31	chrX	102955837	102971960	16123	transmembrane protein 31
PA134963055	55161	TMEM33	chr4	41927137	41965824	38687	transmembrane protein 33
PA134905238	59353	TMEM35	chrX	100323836	100354356	30520	transmembrane protein 35
PA134897608	140738	TMEM37	chr2	120177501	120199096	21595	transmembrane protein 37
PA134891982	79041	TMEM38A	chr19	16761938	16802830	40892	transmembrane protein 38A
PA134916126	55151	TMEM38B	chr9	108446806	108541892	95086	transmembrane protein 38B
PA134956032	55254	TMEM39A	chr3	119144807	119192529	47722	transmembrane protein 39A
PA134933688	55116	TMEM39B	chr1	32528503	32571467	42964	transmembrane protein 39B
PA134940002	55287	TMEM40	chr3	12772392	12811038	38646	transmembrane protein 40
PA134873545	90407	TMEM41A	chr3	185204389	185226845	22456	transmembrane protein 41A
PA134898265	440026	TMEM41B	chr11	9299201	9346315	47114	transmembrane protein 41B
PA134914008	131616	TMEM42	chr3	44893408	44910156	16748	transmembrane protein 42
PA134871907	79188	TMEM43	chr3	14156440	14188180	31740	transmembrane protein 43
PA134916107	93109	TMEM44	chr3	194305402	194364150	58748	transmembrane protein 44
PA134868262	55076	TMEM45A	chr3	100201463	100299297	97834	transmembrane protein 45A
PA134909603	120224	TMEM45B	chr11	129675732	129732898	57166	transmembrane protein 45B
PA134971248	83604	TMEM47	chrX	34642181	34685405	43224	transmembrane protein 47
PA37796	10329	TMEM5	chr12	64163583	64206338	42755	transmembrane protein 5
PA142670766	23585	TMEM50A	chr1	25654789	25691852	37063	transmembrane protein 50A
PA25835	757	TMEM50B	chr21	34801793	34862316	60523	transmembrane protein 50B
PA142670767	55092	TMEM51	chr1	15469028	15549974	80946	transmembrane protein 51
PA142670768	339456	TMEM52	chr1	1846029	1860740	14711	transmembrane protein 52
PA143485388	120939	TMEM52B	chr12	10321557	10347403	25846	transmembrane protein 52B
PA142670769	79639	TMEM53	chr1	45115920	45150253	34333	transmembrane protein 53
PA142670770	113452	TMEM54	chr1	33357196	33377041	19845	transmembrane protein 54
PA142670771	55529	TMEM55A	chr8	92003499	92063203	59704	transmembrane protein 55A
PA134919069	90809	TMEM55B	chr14	20923012	20939637	16625	transmembrane protein 55B
PA142670772	148534	TMEM56	chr1	95572894	95666163	93269	transmembrane protein 56
PA142670773	55219	TMEM57	chr1	25747388	25829700	82312	transmembrane protein 57
PA25620	9528	TMEM59	chr1	54494346	54529135	34789	transmembrane protein 59
PA162406615	25789	TMEM59L	chr19	18713682	18734849	21167	transmembrane protein 59-like
PA134910139	85025	TMEM60	chr7	77420045	77437747	17702	transmembrane protein 60
PA142670774	199964	TMEM61	chr1	55436271	55460966	24695	transmembrane protein 61
PA142670775	80021	TMEM62	chr15	43415722	43480342	64620	transmembrane protein 62
PA142670776	9725	TMEM63A	chr1	226030233	226080420	50187	transmembrane protein 63A
PA134911221	55362	TMEM63B	chr6	44084599	44126256	41657	transmembrane protein 63B
PA134993950	57156	TMEM63C	chr14	77638102	77728838	90736	transmembrane protein 63C
PA142670777	169200	TMEM64	chr8	91631223	91668133	36910	transmembrane protein 64
PA142670778	157378	TMEM65	chr8	125320159	125394940	74781	transmembrane protein 65
PA142670780	91147	TMEM67	chr8	94757072	94834462	77390	transmembrane protein 67
PA142670781	137695	TMEM68	chr8	56648317	56695955	47638	transmembrane protein 68
PA142670782	51249	TMEM69	chr1	46143847	46163110	19263	transmembrane protein 69
PA142670783	54968	TMEM70	chr8	74878377	74898018	19641	transmembrane protein 70
PA142670784	137835	TMEM71	chr8	133719191	133782914	63723	transmembrane protein 71
PA164726549	643236	TMEM72	chr10	45396764	45433642	36878	transmembrane protein 72
PA142670785	157753	TMEM74	chr8	109788165	109809770	21605	transmembrane protein 74
PA25759	55321	TMEM74B	chr20	1158213	1176077	17864	transmembrane protein 74B
PA143485632	84283	TMEM79	chr1	156242704	156265234	22530	transmembrane protein 79
PA142670734	283232	TMEM80	chr11	685591	708028	22437	transmembrane protein 80
PA143485633	388730	TMEM81	chr1	205049257	205063588	14331	transmembrane protein 81
PA162406636	388595	TMEM82	chr1	16058987	16077292	18305	transmembrane protein 82
PA142670737	144110	TMEM86A	chr11	18710351	18729332	18981	transmembrane protein 86A
PA142670738	255043	TMEM86B	chr19	55735002	55750632	15630	transmembrane protein 86B
PA142670739	25963	TMEM87A	chr15	42499726	42575797	76071	transmembrane protein 87A
PA142670740	84910	TMEM87B	chr2	112802800	112879895	77095	transmembrane protein 87B
PA142670741	92162	TMEM88	chr17	7748181	7762417	14236	transmembrane protein 88
PA165752745	643965	TMEM88B	chr1	1351508	1366167	14659	transmembrane protein 88B
PA142670742	440955	TMEM89	chr3	48655275	48669189	13914	transmembrane protein 89
PA38211	58986	TMEM8A	chr16	417776	441950	24174	transmembrane protein 8A
PA165586305	51754	TMEM8B	chr9	35819222	35857844	38622	transmembrane protein 8B
PA165586306	389827	TMEM8C	chr9	136376708	136400068	23360	transmembrane protein 8C
PA38696	252839	TMEM9	chr1	201100900	201150710	49810	transmembrane protein 9
PA142670743	641649	TMEM91	chr19	41846873	41892988	46115	transmembrane protein 91
PA142670744	162461	TMEM92	chr17	48338767	48361846	23079	transmembrane protein 92
PA142670746	339168	TMEM95	chr17	7248497	7263538	15041	transmembrane protein 95
PA143485635	27346	TMEM97	chr17	26636121	26658711	22590	transmembrane protein 97
PA142670747	26022	TMEM98	chr17	31244928	31271667	26739	transmembrane protein 98
PA142670748	147184	TMEM99	chr17	38965344	38995526	30182	transmembrane protein 99
PA25482	56674	TMEM9B	chr11	8965840	8996553	30713	TMEM9 domain family, member B
PA36571	7110	TMF1	chr3	69065978	69111484	45506	TATA element modulatory factor 1
PA134972473	259236	TMIE	chr3	46732823	46755413	22590	transmembrane inner ear
PA142670725	388364	TMIGD1	chr17	28640351	28671065	30714	transmembrane and immunoglobulin domain containing 1
PA145148047	126259	TMIGD2	chr19	4289224	4312428	23204	transmembrane and immunoglobulin domain containing 2
PA38311	55217	TMLHE	chrX	154715672	154852622	136950	trimethyllysine hydroxylase, epsilon
PA36572	7111	TMOD1	chr9	100253462	100370177	116715	tropomodulin 1
PA36573	29767	TMOD2	chr15	52033758	52111560	77802	tropomodulin 2 (neuronal)
PA36574	29766	TMOD3	chr15	52111825	52207335	95510	tropomodulin 3 (ubiquitous)
PA36575	29765	TMOD4	chr1	151139463	151158547	19084	tropomodulin 4 (muscle)
PA36576	7112	TMPO	chr12	98899351	98947157	47806	thymopoietin
PA164726564	643853	TMPPE	chr3	33035219	33148689	113470	transmembrane protein with metallophosphoesterase domain
PA142670726	339967	TMPRSS11A	chr4	68773019	68839232	66213	transmembrane protease, serine 11A
PA142670727	132724	TMPRSS11B	chr4	69089371	69121412	32041	transmembrane protease, serine 11B
PA165664737	401136	TMPRSS11BNL	chr4	69051242	69093798	42556	TMPRSS11B N terminal-like
PA142670728	9407	TMPRSS11D	chr4	68683594	68759716	76122	transmembrane protease, serine 11D
PA142670729	28983	TMPRSS11E	chr4	69303167	69366322	63155	transmembrane protease, serine 11E
PA142670730	389208	TMPRSS11F	chr4	68915916	69005587	89671	transmembrane protease, serine 11F
PA142670731	283471	TMPRSS12	chr12	51226701	51284667	57966	transmembrane (C-terminal) protease, serine 12
PA142670732	84000	TMPRSS13	chr11	117768356	117810168	41812	transmembrane protease, serine 13
PA33839	5651	TMPRSS15	chr21	19638433	19785970	147537	transmembrane protease, serine 15
PA36577	7113	TMPRSS2	chr21	42833236	42890085	56849	transmembrane protease, serine 2
PA36578	64699	TMPRSS3	chr21	43788996	43826955	37959	transmembrane protease, serine 3
PA36579	56649	TMPRSS4	chr11	117937727	117999323	61596	transmembrane protease, serine 4
PA37920	80975	TMPRSS5	chr11	113555268	113587151	31883	transmembrane protease, serine 5
PA134880399	164656	TMPRSS6	chr22	37458476	37509693	51217	transmembrane protease, serine 6
PA134928796	344805	TMPRSS7	chr3	111748465	111803116	54651	transmembrane protease, serine 7
PA134967594	360200	TMPRSS9	chr19	2371507	2429480	57973	transmembrane protease, serine 9
PA36580	9168	TMSB10	chr2	85122763	85136799	14036	thymosin beta 10
PA164726573	11013	TMSB15A	chrX	101765610	101781699	16089	thymosin beta 15a
PA164726584	286527	TMSB15B	chrX	103207200	103223563	16363	thymosin beta 15B
PA36581	7114	TMSB4X	chrX	12983226	12998346	15120	thymosin beta 4, X-linked
PA36583	7115	TMSB4XP1	chr1	42962464	42976088	13624	thymosin beta 4, X-linked pseudogene 1
PA36584	7116	TMSB4XP2	chr2	3661739	3675350	13611	thymosin beta 4, X-linked pseudogene 2
PA36585	7117	TMSB4XP8	chr4	91756644	91770266	13622	thymosin beta 4, X-linked pseudogene 8
PA36582	9087	TMSB4Y	chrY	15805447	15820904	15457	thymosin beta 4, Y-linked
PA142670718	83857	TMTC1	chr12	29650746	29947692	296946	transmembrane and tetratricopeptide repeat containing 1
PA142670719	160335	TMTC2	chr12	83070731	83531647	460916	transmembrane and tetratricopeptide repeat containing 2
PA142670720	160418	TMTC3	chr12	88526073	88596664	70591	transmembrane and tetratricopeptide repeat containing 3
PA142670721	84899	TMTC4	chr13	101253090	101337103	84013	transmembrane and tetratricopeptide repeat containing 4
PA134863959	83590	TMUB1	chr7	150775172	150790620	15448	transmembrane and ubiquitin-like domain containing 1
PA145147917	79089	TMUB2	chr17	42254300	42272099	17799	transmembrane and ubiquitin-like domain containing 2
PA37968	81542	TMX1	chr14	51696886	51727373	30487	thioredoxin-related transmembrane protein 1
PA164726611	51075	TMX2	chr11	57469995	57511445	41450	thioredoxin-related transmembrane protein 2
PA164726632	54495	TMX3	chr18	66337925	66392535	54610	thioredoxin-related transmembrane protein 3
PA164726669	56255	TMX4	chr20	7958713	8010393	51680	thioredoxin-related transmembrane protein 4
PA35103	3371	TNC	chr9	117778854	117890536	111682	tenascin C
PA435	7124	TNF	chr6	31533344	31549113	15769	tumor necrosis factor
PA36591	7126	TNFAIP1	chr17	26652548	26677035	24487	tumor necrosis factor, alpha-induced protein 1 (endothelial)
PA36592	7127	TNFAIP2	chr14	103579762	103606776	27014	tumor necrosis factor, alpha-induced protein 2
PA36593	7128	TNFAIP3	chr6	138178325	138207451	29126	tumor necrosis factor, alpha-induced protein 3
PA36595	7130	TNFAIP6	chr2	152204106	152239562	35456	tumor necrosis factor, alpha-induced protein 6
PA134957136	25816	TNFAIP8	chr5	118594418	118733294	138876	tumor necrosis factor, alpha-induced protein 8
PA142670722	126282	TNFAIP8L1	chr19	4629527	4658580	29053	tumor necrosis factor, alpha-induced protein 8-like 1
PA142670723	79626	TNFAIP8L2	chr1	151119095	151135731	16636	tumor necrosis factor, alpha-induced protein 8-like 2
PA142670724	388121	TNFAIP8L3	chr15	51345798	51407473	61675	tumor necrosis factor, alpha-induced protein 8-like 3
PA36597	8797	TNFRSF10A	chr8	23045970	23092680	46710	tumor necrosis factor receptor superfamily, member 10a
PA36598	8795	TNFRSF10B	chr8	22874646	22936700	62054	tumor necrosis factor receptor superfamily, member 10b
PA36599	8794	TNFRSF10C	chr8	22950327	22977950	27623	tumor necrosis factor receptor superfamily, member 10c, decoy without an intracellular domain
PA36600	8793	TNFRSF10D	chr8	22990101	23031543	41442	tumor necrosis factor receptor superfamily, member 10d, decoy with truncated death domain
PA36601	8792	TNFRSF11A	chr18	59982520	60057943	75423	tumor necrosis factor receptor superfamily, member 11a, NFKB activator
PA36602	4982	TNFRSF11B	chr8	119932796	119974383	41587	tumor necrosis factor receptor superfamily, member 11b
PA134976874	51330	TNFRSF12A	chr16	3060313	3075384	15071	tumor necrosis factor receptor superfamily, member 12A
PA38509	23495	TNFRSF13B	chr17	16839398	16885432	46034	tumor necrosis factor receptor superfamily, member 13B
PA38466	115650	TNFRSF13C	chr22	42318036	42332821	14785	tumor necrosis factor receptor superfamily, member 13C
PA36605	8764	TNFRSF14	chr1	2477291	2498268	20977	tumor necrosis factor receptor superfamily, member 14
PA36606	608	TNFRSF17	chr16	12048964	12064925	15961	tumor necrosis factor receptor superfamily, member 17
PA36607	8784	TNFRSF18	chr1	1135888	1152163	16275	tumor necrosis factor receptor superfamily, member 18
PA36608	55504	TNFRSF19	chr13	24134509	24253244	118735	tumor necrosis factor receptor superfamily, member 19
PA36609	7132	TNFRSF1A	chr12	6434923	6461283	26360	tumor necrosis factor receptor superfamily, member 1A
PA36610	7133	TNFRSF1B	chr1	12217044	12272279	55235	tumor necrosis factor receptor superfamily, member 1B
PA37775	27242	TNFRSF21	chr6	47196263	47287683	91420	tumor necrosis factor receptor superfamily, member 21
PA36603	8718	TNFRSF25	chr1	6517787	6537432	19645	tumor necrosis factor receptor superfamily, member 25
PA36611	7293	TNFRSF4	chr1	1143706	1159703	15997	tumor necrosis factor receptor superfamily, member 4
PA36614	8771	TNFRSF6B	chr20	62318004	62333051	15047	tumor necrosis factor receptor superfamily, member 6b, decoy
PA36616	943	TNFRSF8	chr1	12113434	12207264	93830	tumor necrosis factor receptor superfamily, member 8
PA36617	3604	TNFRSF9	chr1	7972931	8013225	40294	tumor necrosis factor receptor superfamily, member 9
PA36618	8743	TNFSF10	chr3	172220298	172251297	30999	tumor necrosis factor (ligand) superfamily, member 10
PA36619	8600	TNFSF11	chr13	43126872	43185149	58277	tumor necrosis factor (ligand) superfamily, member 11
PA36620	8742	TNFSF12	chr17	7442375	7464207	21832	tumor necrosis factor (ligand) superfamily, member 12
PA162406662	407977	TNFSF12-TNFSF13	chr17	7442375	7467925	25550	TNFSF12-TNFSF13 readthrough
PA36621	8741	TNFSF13	chr17	7451609	7467925	16316	tumor necrosis factor (ligand) superfamily, member 13
PA434	10673	TNFSF13B	chr13	108911875	108963832	51957	tumor necrosis factor (ligand) superfamily, member 13b
PA36622	8740	TNFSF14	chr19	6658264	6680599	22335	tumor necrosis factor (ligand) superfamily, member 14
PA36623	9966	TNFSF15	chr9	117543915	117578408	34493	tumor necrosis factor (ligand) superfamily, member 15
PA36624	8995	TNFSF18	chr1	173007360	173030103	22743	tumor necrosis factor (ligand) superfamily, member 18
PA36625	7292	TNFSF4	chr1	173149870	173186471	36601	tumor necrosis factor (ligand) superfamily, member 4
PA36628	944	TNFSF8	chr9	117652623	117702875	50252	tumor necrosis factor (ligand) superfamily, member 8
PA36629	8744	TNFSF9	chr19	6521010	6538939	17929	tumor necrosis factor (ligand) superfamily, member 9
PA134893180	23043	TNIK	chr3	170777292	171188197	410905	TRAF2 and NCK interacting kinase
PA128394573	10318	TNIP1	chr5	150406504	150477221	70717	TNFAIP3 interacting protein 1
PA134957006	79155	TNIP2	chr4	2740387	2768103	27716	TNFAIP3 interacting protein 2
PA134934429	79931	TNIP3	chr4	122049563	122158624	109061	TNFAIP3 interacting protein 3
PA36630	8711	TNK1	chr17	7274293	7296093	21800	tyrosine kinase, non-receptor, 1
PA134909759	10188	TNK2	chr3	195587235	195645880	58645	tyrosine kinase, non-receptor, 2
PA36631	8658	TNKS	chr8	9402756	9642856	240100	tankyrase, TRF1-interacting ankyrin-related ADP-ribose polymerase
PA38789	85456	TNKS1BP1	chr11	57064103	57102485	38382	tankyrase 1 binding protein 1, 182kDa
PA38019	80351	TNKS2	chr10	93548151	93628232	80081	tankyrase, TRF1-interacting ankyrin-related ADP-ribose polymerase 2
PA134878561	64102	TNMD	chrX	99829790	99858007	28217	tenomodulin
PA134973710	63923	TNN	chr1	175026994	175120202	93208	tenascin N
PA36632	7134	TNNC1	chr3	52482107	52498057	15950	troponin C type 1 (slow)
PA36633	7125	TNNC2	chr20	44448853	44465953	17100	troponin C type 2 (fast)
PA36634	7135	TNNI1	chr1	201369895	201400874	30979	troponin I type 1 (skeletal, slow)
PA36635	7136	TNNI2	chr11	1850233	1865910	15677	troponin I type 2 (skeletal, fast)
PA36636	7137	TNNI3	chr19	55660135	55679100	18965	troponin I type 3 (cardiac)
PA134976654	51086	TNNI3K	chr1	74691071	75013116	322045	TNNI3 interacting kinase
PA36637	7138	TNNT1	chr19	55641161	55670752	29591	troponin T type 1 (skeletal, slow)
PA36638	7139	TNNT2	chr1	201325136	201356836	31700	troponin T type 2 (cardiac)
PA36639	7140	TNNT3	chr11	1930799	1962936	32137	troponin T type 3 (skeletal, fast)
PA36640	7141	TNP1	chr2	217721181	217734782	13601	transition protein 1 (during histone to protamine replacement)
PA36641	7142	TNP2	chr16	11358714	11373160	14446	transition protein 2 (during histone to protamine replacement)
PA30192	3842	TNPO1	chr5	72102418	72213215	110797	transportin 1
PA134921349	30000	TNPO2	chr19	12807008	12844838	37830	transportin 2
PA134888159	23534	TNPO3	chr7	128591234	128705227	113993	transportin 3
PA36642	7143	TNR	chr1	175288935	175722752	433817	tenascin R
PA36649	84629	TNRC18	chr7	5343421	5473177	129756	trinucleotide repeat containing 18
PA36656	27327	TNRC6A	chr16	24731028	24840548	109520	trinucleotide repeat containing 6A
PA134992981	23112	TNRC6B	chr22	40430046	40734812	304766	trinucleotide repeat containing 6B
PA134880671	57690	TNRC6C	chr17	75990194	76107916	117722	trinucleotide repeat containing 6C
PA36660	7145	TNS1	chr2	218661512	218818796	157284	tensin 1
PA134888115	64759	TNS3	chr7	47311752	47631742	319990	tensin 3
PA142670717	84951	TNS4	chr17	38629080	38667933	38853	tensin 4
PA36662	7148	TNXB	chr6	32005932	32087151	81219	tenascin XB
PA36663	10140	TOB1	chr17	48936584	48955339	18755	transducer of ERBB2, 1
PA36664	10766	TOB2	chr22	41826492	41854234	27742	transducer of ERBB2, 2
PA38064	114034	TOE1	chr1	45795342	45812650	17308	target of EGR1, member 1 (nuclear)
PA134876213	54472	TOLLIP	chr11	1292598	1340892	48294	toll interacting protein
PA36666	10043	TOM1	chr22	35685268	35746987	61719	target of myb1 (chicken)
PA36667	10040	TOM1L1	chr17	52967880	53042328	74448	target of myb1 (chicken)-like 1
PA36668	146691	TOM1L2	chr17	17743822	17885784	141962	target of myb1-like 2 (chicken)
PA134964372	9804	TOMM20	chr1	235269656	235302256	32600	translocase of outer mitochondrial membrane 20 homolog (yeast)
PA162406689	387990	TOMM20L	chr14	58852644	58878419	25775	translocase of outer mitochondrial membrane 20 homolog (yeast)-like
PA38275	56993	TOMM22	chr22	39067954	39083765	15811	translocase of outer mitochondrial membrane 22 homolog (yeast)
PA38032	10953	TOMM34	chr20	43567771	43599114	31343	translocase of outer mitochondrial membrane 34
PA38274	10452	TOMM40	chr19	45384477	45409946	25469	translocase of outer mitochondrial membrane 40 homolog (yeast)
PA142670714	84134	TOMM40L	chr1	161185729	161203536	17807	translocase of outer mitochondrial membrane 40 homolog (yeast)-like
PA164726670	401505	TOMM5	chr9	37585410	37602636	17226	translocase of outer mitochondrial membrane 5 homolog (yeast)
PA164726679	100188893	TOMM6	chr6	41745181	41760634	15453	translocase of outer mitochondrial membrane 6 homolog (yeast)
PA134864325	54543	TOMM7	chr7	22849251	22872471	23220	translocase of outer mitochondrial membrane 7 homolog (yeast)
PA36669	9868	TOMM70A	chr3	100079303	100130242	50939	translocase of outer mitochondrial membrane 70 homolog A (S. cerevisiae)
PA31605	4796	TONSL	chr8	145651163	145679871	28708	tonsoku-like, DNA repair protein
PA353	7150	TOP1	chr20	39647462	39756127	108665	topoisomerase (DNA) I
PA134922772	116447	TOP1MT	chr8	144388494	144452147	63653	topoisomerase (DNA) I, mitochondrial
PA354	7153	TOP2A	chr17	38541773	38584202	42429	topoisomerase (DNA) II alpha 170kDa
PA36672	7155	TOP2B	chr3	25636396	25716396	80000	topoisomerase (DNA) II beta 180kDa
PA36673	7156	TOP3A	chr17	18174235	18228321	54086	topoisomerase (DNA) III alpha
PA36674	8940	TOP3B	chr22	22308397	22347219	38822	topoisomerase (DNA) III beta
PA165696874	375337	TOPAZ1	chr3	44273378	44376590	103212	testis and ovary specific PAZ domain containing 1
PA134934073	11073	TOPBP1	chr3	133316449	133390762	74313	topoisomerase (DNA) II binding protein 1
PA134979531	10210	TOPORS	chr9	32537542	32562626	25084	topoisomerase I binding, arginine/serine-rich, E3 ubiquitin protein ligase
PA142672308	548324	TOPORS-AS1	chr9	32541142	32569858	28716	TOPORS antisense RNA 1
PA27556	1861	TOR1A	chr9	132572221	132596441	24220	torsin family 1, member A (torsin A)
PA142670715	26092	TOR1AIP1	chr1	179841177	179892212	51035	torsin A interacting protein 1
PA142670716	163590	TOR1AIP2	chr1	179806102	179857867	51765	torsin A interacting protein 2
PA36676	27348	TOR1B	chr9	132555428	132576563	21135	torsin family 1, member B (torsin B)
PA36677	27433	TOR2A	chr9	130490803	130507628	16825	torsin family 2, member A
PA36678	64222	TOR3A	chr1	179040415	179070158	29743	torsin family 3, member A
PA162380839	54863	TOR4A	chr9	140162280	140180093	17813	torsin family 4, member A
PA162406704	9760	TOX	chr8	59714977	60041767	326790	thymocyte selection-associated high mobility group box
PA162406727	84969	TOX2	chr20	42533492	42701256	167764	TOX high mobility group box family member 2
PA162406752	27324	TOX3	chr16	52468682	52591714	123032	TOX high mobility group box family member 3
PA162406753	9878	TOX4	chr14	21935335	21970319	34984	TOX high mobility group box family member 4
PA36679	7157	TP53	chr17	7568720	7600868	32148	tumor protein p53
PA164726680	63970	TP53AIP1	chr11	128801627	128823294	21667	tumor protein p53 regulated apoptosis inducing protein 1
PA36680	7158	TP53BP1	chr15	43692262	43812707	120445	tumor protein p53 binding protein 1
PA36681	7159	TP53BP2	chr1	223964595	224043674	79079	tumor protein p53 binding protein 2
PA134967898	9537	TP53I11	chr11	44904454	44982919	78465	tumor protein p53 inducible protein 11
PA143485659	90313	TP53I13	chr17	27884198	27903175	18977	tumor protein p53 inducible protein 13
PA134923704	9540	TP53I3	chr2	24297303	24318085	20782	tumor protein p53 inducible protein 3
PA38278	94241	TP53INP1	chr8	95935200	95971615	36415	tumor protein p53 inducible nuclear protein 1
PA25650	58476	TP53INP2	chr20	33282147	33304240	22093	tumor protein p53 inducible nuclear protein 2
PA25774	112858	TP53RK	chr20	45310004	45328301	18297	TP53 regulating kinase
PA164726682	24150	TP53TG3	chr16	32681849	32697448	15599	TP53 target 3
PA165450804	729355	TP53TG3B	chr16	33252120	33267719	15599	TP53 target 3B
PA25639	27296	TP53TG5	chr20	43999520	44019937	20417	TP53 target 5
PA162406776	8626	TP63	chr3	189338942	189618068	279126	tumor protein p63
PA36684	7161	TP73	chr1	3559129	3655765	96636	tumor protein p73
PA36685	7162	TPBG	chr6	83062923	83080134	17211	trophoblast glycoprotein
PA134922711	53373	TPCN1	chr12	113649260	113739390	90130	two pore segment channel 1
PA134937857	219931	TPCN2	chr11	68806350	68861072	54722	two pore segment channel 2
PA36686	7163	TPD52	chr8	80944103	81093836	149733	tumor protein D52
PA36687	7164	TPD52L1	chr6	125464876	125587644	122768	tumor protein D52-like 1
PA36688	7165	TPD52L2	chr20	62486581	62525898	39317	tumor protein D52-like 2
PA142670712	89882	TPD52L3	chr9	6318349	6334900	16551	tumor protein D52-like 3
PA134901246	91978	TPGS1	chr19	497497	522654	25157	tubulin polyglutamylase complex subunit 1
PA128394637	25941	TPGS2	chr18	34356513	34419179	62666	tubulin polyglutamylase complex subunit 2
PA355	7166	TPH1	chr11	18039084	18072354	33270	tryptophan hydroxylase 1
PA128747823	121278	TPH2	chr12	72322626	72429221	106595	tryptophan hydroxylase 2
PA36689	7167	TPI1	chr12	6966288	6983110	16822	triosephosphate isomerase 1
PA38235	27010	TPK1	chr7	144146034	144543488	397454	thiamin pyrophosphokinase 1
PA36690	7168	TPM1	chr15	63324838	63367114	42276	tropomyosin 1 (alpha)
PA36691	7169	TPM2	chr9	35678990	35700583	21593	tropomyosin 2 (beta)
PA36692	7170	TPM3	chr1	154124780	154174611	49831	tropomyosin 3
PA36693	7171	TPM4	chr19	16168317	16216815	48498	tropomyosin 4
PA356	7172	TPMT	chr6	18125542	18165374	39832	thiopurine S-methyltransferase
PA36694	7173	TPO	chr2	1407233	1550445	143212	thyroid peroxidase
PA26600	1200	TPP1	chr11	6630997	6650692	19695	tripeptidyl peptidase I
PA36695	7174	TPP2	chr13	103239286	103334524	95238	tripeptidyl peptidase II
PA162406809	11076	TPPP	chr5	656977	703510	46533	tubulin polymerization promoting protein
PA162406822	122664	TPPP2	chr14	21488345	21503334	14989	tubulin polymerization-promoting protein family member 2
PA162406823	51673	TPPP3	chr16	67420710	67437449	16739	tubulin polymerization-promoting protein family member 3
PA36696	7175	TPR	chr1	186277784	186354883	77099	translocated promoter region, nuclear basket protein
PA165698543	131601	TPRA1	chr3	127288907	127319602	30695	transmembrane protein, adipocyte asscociated 1
PA162406838	285386	TPRG1	chr3	188807910	189044271	236361	tumor protein p63 regulated 1
PA162406855	127262	TPRG1L	chr1	3531556	3549695	18139	tumor protein p63 regulated 1-like
PA143485660	51002	TPRKB	chr2	73952744	73974765	22021	TP53RK binding protein
PA165586341	286262	TPRN	chr9	140083069	140105163	22094	taperin
PA142670706	284355	TPRX1	chr19	48301500	48332308	30808	tetra-peptide repeat homeobox 1
PA36698	7177	TPSAB1	chr16	1280678	1295555	14877	tryptase alpha/beta 1
PA37846	64499	TPSB2	chr16	1275336	1290185	14849	tryptase beta 2 (gene/pseudogene)
PA37845	23430	TPSD1	chr16	1296273	1311494	15221	tryptase delta 1
PA37849	25823	TPSG1	chr16	1268651	1285254	16603	tryptase gamma 1
PA36699	8460	TPST1	chr7	65660259	65828438	168179	tyrosylprotein sulfotransferase 1
PA36700	8459	TPST2	chr22	26918714	26996089	77375	tyrosylprotein sulfotransferase 2
PA36701	7178	TPT1	chr13	45908005	45925505	17500	tumor protein, translationally-controlled 1
PA36702	7179	TPTE	chr21	10903741	11000920	97179	transmembrane phosphatase with tensin homology
PA134917664	93492	TPTE2	chr13	19994017	20145714	151697	transmembrane phosphoinositide 3-phosphatase and tensin homolog 2
PA25638	22974	TPX2	chr20	30316904	30392605	75701	TPX2, microtubule-associated
PA164726707	29896	TRA2A	chr7	23541399	23581656	40257	transformer 2 alpha homolog (Drosophila)
PA35697	6434	TRA2B	chr3	185629356	185665924	36568	transformer 2 beta homolog (Drosophila)
PA145147893	80305	TRABD	chr22	50614344	50641027	26683	TraB domain containing
PA165696373	129293	TRABD2A	chr2	85045774	85118369	72595	TraB domain containing 2A
PA36707	8717	TRADD	chr16	67185088	67203812	18724	TNFRSF1A-associated via death domain
PA36708	7185	TRAF1	chr9	123661671	123701451	39780	TNF receptor-associated factor 1
PA164742666	7186	TRAF2	chr9	139766341	139824853	58512	TNF receptor-associated factor 2
PA36710	7187	TRAF3	chr14	103233816	103380837	147021	TNF receptor-associated factor 3
PA134943602	26146	TRAF3IP1	chr2	239219185	239312541	93356	TNF receptor-associated factor 3 interacting protein 1
PA25938	10758	TRAF3IP2	chr6	111873581	111937477	63896	TRAF3 interacting protein 2
PA142670711	80342	TRAF3IP3	chr1	209919393	209958668	39275	TRAF3 interacting protein 3
PA36711	9618	TRAF4	chr17	27061023	27080976	19953	TNF receptor-associated factor 4
PA36712	7188	TRAF5	chr1	211489849	211551403	61554	TNF receptor-associated factor 5
PA36713	7189	TRAF6	chr11	36502317	36541863	39546	TNF receptor-associated factor 6, E3 ubiquitin protein ligase
PA134917323	84231	TRAF7	chr16	2195763	2231130	35367	TNF receptor-associated factor 7, E3 ubiquitin protein ligase
PA142670704	10906	TRAFD1	chr12	112553349	112594408	41059	TRAF-type zinc finger domain containing 1
PA142670705	10293	TRAIP	chr3	49863028	49903992	40964	TRAF interacting protein
PA128394593	22906	TRAK1	chr3	42045294	42270382	225088	trafficking protein, kinesin binding 1
PA24744	66008	TRAK2	chr2	202238930	202326319	87389	trafficking protein, kinesin binding 2
PA134955644	23471	TRAM1	chr8	71482453	71530694	48241	translocation associated membrane protein 1
PA134911361	133022	TRAM1L1	chr4	118001710	118016736	15026	translocation associated membrane protein 1-like 1
PA128394555	9697	TRAM2	chr6	52359200	52451862	92662	translocation associated membrane protein 2
PA165698606	9881	TRANK1	chr3	36865308	36996548	131240	tetratricopeptide repeat and ankyrin repeat containing 1
PA36781	10131	TRAP1	chr16	3705038	3777598	72560	TNF receptor-associated protein 1
PA134988492	58485	TRAPPC1	chr17	7830663	7845317	14654	trafficking protein particle complex 1
PA162406870	7109	TRAPPC10	chr21	45422206	45529433	107227	trafficking protein particle complex 10
PA162379849	60684	TRAPPC11	chr4	184570420	184637747	67327	trafficking protein particle complex 11
PA134944710	51112	TRAPPC12	chr2	3373446	3486342	112896	trafficking protein particle complex 12
PA162380280	80006	TRAPPC13	chr5	64910558	64964954	54396	trafficking protein particle complex 13
PA35631	6399	TRAPPC2	chrX	13727361	13762754	35393	trafficking protein particle complex 2
PA145147879	51693	TRAPPC2L	chr16	88913465	88932086	18621	trafficking protein particle complex 2-like
PA134972272	27095	TRAPPC3	chr1	36599170	36631654	32484	trafficking protein particle complex 3
PA134866254	100128327	TRAPPC3L	chr6	116814646	116876773	62127	trafficking protein particle complex 3-like
PA134906910	51399	TRAPPC4	chr11	118879241	118897384	18143	trafficking protein particle complex 4
PA134875218	126003	TRAPPC5	chr19	7735707	7750748	15041	trafficking protein particle complex 5
PA134963625	79090	TRAPPC6A	chr19	45663186	45691501	28315	trafficking protein particle complex 6A
PA134973191	122553	TRAPPC6B	chr14	39614015	39649634	35619	trafficking protein particle complex 6B
PA165429149	22878	TRAPPC8	chr18	29406136	29533175	127039	trafficking protein particle complex 8
PA162406921	83696	TRAPPC9	chr8	140737324	141478678	741354	trafficking protein particle complex 9
PA128394655	50852	TRAT1	chr3	108531631	108576714	45083	T cell receptor associated transmembrane adaptor 1
PA162406922	1787	TRDMT1	chr10	17176828	17254093	77265	tRNA aspartic acid methyltransferase 1
PA36941	10345	TRDN	chr6	123534484	123968428	433944	triadin
PA36946	11181	TREH	chr11	118525942	118560381	34439	trehalase (brush-border membrane glycoprotein)
PA38467	54210	TREM1	chr6	41239999	41264457	24458	triggering receptor expressed on myeloid cells 1
PA38468	54209	TREM2	chr6	41123244	41140924	17680	triggering receptor expressed on myeloid cells 2
PA134878709	340205	TREML1	chr6	41113998	41132087	18089	triggering receptor expressed on myeloid cells-like 1
PA134921444	79865	TREML2	chr6	41154552	41178925	24373	triggering receptor expressed on myeloid cells-like 2
PA134993202	285852	TREML4	chr6	41186062	41209120	23058	triggering receptor expressed on myeloid cells-like 4
PA134923539	55809	TRERF1	chr6	42189669	42429943	240274	transcriptional regulating factor 1
PA36949	11277	TREX1	chr3	48496919	48512044	15125	three prime repair exonuclease 1
PA36950	11219	TREX2	chrX	152707178	152721945	14767	three prime repair exonuclease 2
PA36978	7200	TRH	chr3	129683236	129699781	16545	thyrotropin-releasing hormone
PA142670702	29953	TRHDE	chr12	72656314	73062422	406108	thyrotropin-releasing hormone degrading enzyme
PA36979	7201	TRHR	chr8	110089653	110134813	45160	thyrotropin-releasing hormone receptor
PA143485661	51499	TRIAP1	chr12	120878764	120894215	15451	TP53 regulated inhibitor of apoptosis 1
PA134963922	10221	TRIB1	chr8	126432563	126453647	21084	tribbles pseudokinase 1
PA128394647	28951	TRIB2	chr2	12846998	12885860	38862	tribbles pseudokinase 2
PA25804	57761	TRIB3	chr20	346447	381203	34756	tribbles pseudokinase 3
PA35536	10107	TRIM10	chr6	30116722	30138711	21989	tripartite motif containing 10
PA38112	81559	TRIM11	chr1	228578373	228604584	26211	tripartite motif containing 11
PA162406947	10206	TRIM13	chr13	50561143	50595603	34460	tripartite motif containing 13
PA38113	9830	TRIM14	chr9	100795071	100891695	96624	tripartite motif containing 14
PA38114	89870	TRIM15	chr6	30120968	30143473	22505	tripartite motif containing 15
PA38215	10626	TRIM16	chr17	15528277	15597625	69348	tripartite motif containing 16
PA144596249	147166	TRIM16L	chr17	18591311	18642431	51120	tripartite motif containing 16-like
PA37768	51127	TRIM17	chr1	228591858	228614583	22725	tripartite motif containing 17
PA38070	23321	TRIM2	chr4	154063650	154263474	199824	tripartite motif containing 2
PA36136	6737	TRIM21	chr11	4403127	4424926	21799	tripartite motif containing 21
PA38129	10346	TRIM22	chr11	5700817	5735093	34276	tripartite motif containing 22
PA24943	373	TRIM23	chr5	64882507	64930187	47680	tripartite motif containing 23
PA36519	8805	TRIM24	chr7	138135079	138273333	138254	tripartite motif containing 24
PA37519	7706	TRIM25	chr17	54962270	55001409	39139	tripartite motif containing 25
PA37544	7726	TRIM26	chr6	30149232	30191271	42039	tripartite motif containing 26
PA162406956	5987	TRIM27	chr6	28867779	28901768	33989	tripartite motif containing 27
PA38131	10155	TRIM28	chr19	59045824	59065087	19263	tripartite motif containing 28
PA38218	23650	TRIM29	chr11	119978994	120066237	87243	tripartite motif containing 29
PA35534	10612	TRIM3	chr11	6466843	6505689	38846	tripartite motif containing 3
PA38117	11074	TRIM31	chr6	30067674	30090867	23193	tripartite motif containing 31
PA38130	22954	TRIM32	chr9	119350147	119466579	116432	tripartite motif containing 32
PA38118	51592	TRIM33	chr1	114932399	115063781	131382	tripartite motif containing 33
PA35533	53840	TRIM34	chr11	5631174	5668628	37454	tripartite motif containing 34
PA38115	23087	TRIM35	chr8	27139404	27178834	39430	tripartite motif containing 35
PA38111	55521	TRIM36	chr5	114457459	114526243	68784	tripartite motif containing 36
PA35497	4591	TRIM37	chr17	57056999	57194266	137267	tripartite motif containing 37
PA35532	10475	TRIM38	chr6	25952917	25990557	37640	tripartite motif containing 38
PA35535	56658	TRIM39	chr6	30284227	30314506	30279	tripartite motif containing 39
PA38108	89122	TRIM4	chr7	99485030	99527223	42193	tripartite motif containing 4
PA38663	135644	TRIM40	chr6	30093885	30119512	25627	tripartite motif containing 40
PA134918519	90933	TRIM41	chr5	180640263	180665808	25545	tripartite motif containing 41
PA134894780	287015	TRIM42	chr3	140386866	140422992	36126	tripartite motif containing 42
PA134936799	129868	TRIM43	chr2	96247766	96268471	20705	tripartite motif containing 43
PA165697592	653192	TRIM43B	chr2	96139715	96160479	20764	tripartite motif containing 43B
PA134906584	54765	TRIM44	chr11	35674353	35833930	159577	tripartite motif containing 44
PA134873644	80263	TRIM45	chr1	117650677	117674411	23734	tripartite motif containing 45
PA134914315	80128	TRIM46	chr1	155135702	155160447	24745	tripartite motif containing 46
PA134883590	91107	TRIM47	chr17	73867242	73884683	17441	tripartite motif containing 47
PA134981425	79097	TRIM48	chr11	55019658	55041595	21937	tripartite motif containing 48
PA34425	57093	TRIM49	chr11	89527823	89551743	23920	tripartite motif containing 49
PA165543723	729384	TRIM49D2	chr11	89647232	89669231	21999	tripartite motif containing 49D2
PA38109	85363	TRIM5	chr11	5673740	5716339	42599	tripartite motif containing 5
PA38778	135892	TRIM50	chr7	72723532	72752085	28553	tripartite motif containing 50
PA134949173	84767	TRIM51	chr11	55640773	55662286	21513	tripartite motif-containing 51
PA134943216	84851	TRIM52	chr5	180680373	180698161	17788	tripartite motif containing 52
PA34434	57159	TRIM54	chr2	27495297	27533307	38010	tripartite motif containing 54
PA34432	84675	TRIM55	chr8	67029131	67090720	61589	tripartite motif containing 55
PA134958549	81844	TRIM56	chr7	100718786	100736909	18123	tripartite motif containing 56
PA134942549	25893	TRIM58	chr1	247793007	248046440	253433	tripartite motif containing 58
PA134899610	286827	TRIM59	chr3	160150291	160177626	27335	tripartite motif containing 59
PA38110	117854	TRIM6	chr11	5607331	5637188	29857	tripartite motif containing 6
PA162406977	445372	TRIM6-TRIM34	chr11	5607865	5668628	60763	TRIM6-TRIM34 readthrough
PA134909634	166655	TRIM60	chr4	165943151	165965896	22745	tripartite motif containing 60
PA134868214	391712	TRIM61	chr4	165872598	165908818	36220	tripartite motif containing 61
PA134890243	55223	TRIM62	chr1	33608000	33657671	49671	tripartite motif containing 62
PA34431	84676	TRIM63	chr1	26374792	26404142	29350	tripartite motif containing 63, E3 ubiquitin protein ligase
PA25492	120146	TRIM64	chr11	89691672	89710240	18568	tripartite motif containing 64
PA165543724	642446	TRIM64B	chr11	89600606	89619185	18579	tripartite motif containing 64B
PA165543740	646754	TRIM64C	chr11	49072266	49090664	18398	tripartite motif containing 64C
PA134877726	201292	TRIM65	chr17	73882041	73903084	21043	tripartite motif containing 65
PA134954583	9866	TRIM66	chr11	8630584	8714205	83621	tripartite motif containing 66
PA134947738	440730	TRIM67	chr1	231288674	231360314	71640	tripartite motif containing 67
PA134939870	55128	TRIM68	chr11	4616902	4639489	22587	tripartite motif containing 68
PA162407010	140691	TRIM69	chr15	45018314	45063027	44713	tripartite motif containing 69
PA38398	81786	TRIM7	chr5	180617924	180642293	24369	tripartite motif containing 7
PA144596246	131405	TRIM71	chr3	32849510	32936771	87261	tripartite motif containing 71, E3 ubiquitin protein ligase
PA144596247	493829	TRIM72	chr16	31215342	31239510	24168	tripartite motif containing 72, E3 ubiquitin protein ligase
PA38510	375593	TRIM73	chr7	75011234	75037896	26662	tripartite motif containing 73
PA38454	378108	TRIM74	chr7	72427016	72449997	22981	tripartite motif containing 74
PA37983	81603	TRIM8	chr10	104393326	104421076	27750	tripartite motif containing 8
PA38116	114088	TRIM9	chr14	51438979	51572422	133443	tripartite motif containing 9
PA162407030	339976	TRIML1	chr4	189050598	189071649	21051	tripartite motif family-like 1
PA162407031	205860	TRIML2	chr4	189009427	189040416	30989	tripartite motif family-like 2
PA36982	7204	TRIO	chr5	14133817	14513313	379496	trio Rho guanine nucleotide exchange factor
PA142670699	11078	TRIOBP	chr22	38082995	38175563	92568	TRIO and F-actin binding protein
PA36983	9322	TRIP10	chr19	6729693	6754529	24836	thyroid hormone receptor interactor 10
PA36984	9321	TRIP11	chr14	92431243	92516484	85241	thyroid hormone receptor interactor 11
PA36985	9320	TRIP12	chr2	230628098	230796763	168665	thyroid hormone receptor interactor 12
PA36986	9319	TRIP13	chr5	882764	921164	38400	thyroid hormone receptor interactor 13
PA36988	9325	TRIP4	chr15	64670003	64750502	80499	thyroid hormone receptor interactor 4
PA36989	7205	TRIP6	chr7	100454950	100474076	19126	thyroid hormone receptor interactor 6
PA164717477	286144	TRIQK	chr8	93892758	93988372	95614	triple QxxK/R motif containing
PA134943037	54802	TRIT1	chr1	40303703	40359177	55474	tRNA isopentenyltransferase 1
PA134867808	55621	TRMT1	chr19	13212714	13237573	24859	tRNA methyltransferase 1 homolog (S. cerevisiae)
PA134979919	93587	TRMT10A	chr4	100464864	100495189	30325	tRNA methyltransferase 10 homolog A (S. cerevisiae)
PA134938884	158234	TRMT10B	chr9	37743797	37781969	38172	tRNA methyltransferase 10 homolog B (S. cerevisiae)
PA134988378	54931	TRMT10C	chr3	101270680	101288290	17610	tRNA methyltransferase 10 homolog C (S. cerevisiae)
PA162407032	60487	TRMT11	chr6	126297576	126363422	65846	tRNA methyltransferase 11 homolog (S. cerevisiae)
PA165543757	51504	TRMT112	chr11	64081163	64095455	14292	tRNA methyltransferase 11-2 homolog (S. cerevisiae)
PA142670700	55039	TRMT12	chr8	125453048	125468267	15219	tRNA methyltransferase 12 homolog (S. cerevisiae)
PA143485428	54482	TRMT13	chr1	100588669	100619054	30385	tRNA methyltransferase 13 homolog (S. cerevisiae)
PA25612	81627	TRMT1L	chr1	185084217	185136230	52013	tRNA methyltransferase 1 homolog (S. cerevisiae)-like
PA164726751	27037	TRMT2A	chr22	20096389	20114818	18429	tRNA methyltransferase 2 homolog A (S. cerevisiae)
PA164726782	79979	TRMT2B	chrX	100261334	100317105	55771	tRNA methyltransferase 2 homolog B (S. cerevisiae)
PA145008869	152992	TRMT44	chr4	8432532	8481282	48750	tRNA methyltransferase 44 homolog (S. cerevisiae)
PA134952106	57570	TRMT5	chr14	61435159	61457888	22729	tRNA methyltransferase 5
PA162407063	51605	TRMT6	chr20	5915479	5941204	25725	tRNA methyltransferase 6
PA164726783	115708	TRMT61A	chr14	103985509	104006410	20901	tRNA methyltransferase 61A
PA164726796	55006	TRMT61B	chr2	29069687	29103175	33488	tRNA methyltransferase 61B
PA142670701	55687	TRMU	chr22	46721298	46756237	34939	tRNA 5-methylaminomethyl-2-thiouridylate methyltransferase
PA164727240	54952	TRNAU1AP	chr1	28869529	28908057	38528	tRNA selenocysteine 1 associated protein 1
PA164727311	388610	TRNP1	chr1	27310189	27330377	20188	TMF1-regulated nuclear protein 1
PA38446	51095	TRNT1	chr3	3158600	3193919	35319	tRNA nucleotidyl transferase, CCA-adding, 1
PA37002	7216	TRO	chrX	54936996	54960864	23868	trophinin
PA37003	10024	TROAP	chr12	49706971	49728514	21543	trophinin associated protein
PA36137	6738	TROVE2	chr1	193018552	193063907	45355	TROVE domain family, member 2
PA24808	8989	TRPA1	chr8	72930486	72997819	67333	transient receptor potential cation channel, subfamily A, member 1
PA357	7220	TRPC1	chr3	142433266	142529730	96464	transient receptor potential cation channel, subfamily C, member 1
PA37008	7222	TRPC3	chr4	122797183	122882909	85726	transient receptor potential cation channel, subfamily C, member 3
PA37009	7223	TRPC4	chr13	38207773	38453939	246166	transient receptor potential cation channel, subfamily C, member 4
PA25730	26133	TRPC4AP	chr20	33587207	33690618	103411	transient receptor potential cation channel, subfamily C, member 4 associated protein
PA37010	7224	TRPC5	chrX	111014542	111336004	321462	transient receptor potential cation channel, subfamily C, member 5
PA37011	7225	TRPC6	chr11	101319295	101464687	145392	transient receptor potential cation channel, subfamily C, member 6
PA164742693	57113	TRPC7	chr5	135545458	135711164	165706	transient receptor potential cation channel, subfamily C, member 7
PA35496	4308	TRPM1	chr15	31290264	31463476	173212	transient receptor potential cation channel, subfamily M, member 1
PA37012	7226	TRPM2	chr21	45760046	45865964	105918	transient receptor potential cation channel, subfamily M, member 2
PA38271	80036	TRPM3	chr9	73140979	74071782	930803	transient receptor potential cation channel, subfamily M, member 3
PA38272	54795	TRPM4	chr19	49651016	49718098	67082	transient receptor potential cation channel, subfamily M, member 4
PA37869	29850	TRPM5	chr11	2422745	2454275	31530	transient receptor potential cation channel, subfamily M, member 5
PA38479	140803	TRPM6	chr9	77334411	77513010	178599	transient receptor potential cation channel, subfamily M, member 6
PA38273	54822	TRPM7	chr15	50846351	50989012	142661	transient receptor potential cation channel, subfamily M, member 7
PA38270	79054	TRPM8	chr2	234816043	234931166	115123	transient receptor potential cation channel, subfamily M, member 8
PA37013	7227	TRPS1	chr8	116417724	116723299	305575	trichorhinophalangeal syndrome I
PA134964265	83707	TRPT1	chr11	63988271	64003726	15455	tRNA phosphotransferase 1
PA37329	7442	TRPV1	chr17	3465740	3522705	56965	transient receptor potential cation channel, subfamily V, member 1
PA38292	51393	TRPV2	chr17	16308856	16343317	34461	transient receptor potential cation channel, subfamily V, member 2
PA38481	162514	TRPV3	chr17	3410796	3471289	60493	transient receptor potential cation channel, subfamily V, member 3
PA38293	59341	TRPV4	chr12	110217892	110281212	63320	transient receptor potential cation channel, subfamily V, member 4
PA35045	56302	TRPV5	chr7	142602648	142640820	38172	transient receptor potential cation channel, subfamily V, member 5
PA37832	55503	TRPV6	chr7	142565956	142593490	27534	transient receptor potential cation channel, subfamily V, member 6
PA37020	8295	TRRAP	chr7	98466113	98613866	147753	transformation/transcription domain-associated protein
PA38086	142940	TRUB1	chr10	116687952	116740439	52487	TruB pseudouridine (psi) synthase family member 1
PA38209	26995	TRUB2	chr9	131068396	131094697	26301	TruB pseudouridine (psi) synthase family member 2
PA142672430	128229	TSACC	chr1	156297105	156319786	22681	TSSK6 activating co-chaperone
PA37034	7248	TSC1	chr9	135763735	135830094	66359	tuberous sclerosis 1
PA37035	7249	TSC2	chr16	2087472	2141713	54241	tuberous sclerosis 2
PA134887618	8848	TSC22D1	chr13	45003279	45160701	157422	TSC22 domain family, member 1
PA142670697	9819	TSC22D2	chr3	150116101	150180906	64805	TSC22 domain family, member 2
PA27504	1831	TSC22D3	chrX	106953451	107030559	77108	TSC22 domain family, member 3
PA142670698	81628	TSC22D4	chr7	100061142	100086902	25760	TSC22 domain family, member 4
PA162407135	116461	TSEN15	chr1	184010811	184046346	35535	TSEN15 tRNA splicing endonuclease subunit
PA142670695	80746	TSEN2	chr3	12507748	12583672	75924	TSEN2 tRNA splicing endonuclease subunit
PA134871088	79042	TSEN34	chr19	54684112	54701394	17282	TSEN34 tRNA splicing endonuclease subunit
PA142670692	283989	TSEN54	chr17	73502609	73523821	21212	TSEN54 tRNA splicing endonuclease subunit
PA37037	10102	TSFM	chr12	58166528	58199639	33111	Ts translation elongation factor, mitochondrial
PA38068	7251	TSG101	chr11	18498858	18558503	59645	tumor susceptibility 101
PA37933	80705	TSGA10	chr2	99610724	99781187	170463	testis specific, 10
PA134983361	254187	TSGA10IP	chr11	65703115	65730434	27319	testis specific, 10 interacting protein
PA37038	114960	TSGA13	chr7	130350486	130382268	31782	testis specific, 13
PA37041	7252	TSHB	chr1	115562445	115579930	17485	thyroid stimulating hormone, beta
PA37042	7253	TSHR	chr14	81411333	81615646	204313	thyroid stimulating hormone receptor
PA35599	10194	TSHZ1	chr18	72912710	73004905	92195	teashirt zinc finger homeobox 1
PA37589	128553	TSHZ2	chr20	51578946	52114869	535923	teashirt zinc finger homeobox 2
PA134887020	57616	TSHZ3	chr19	31762851	31850190	87339	teashirt zinc finger homeobox 3
PA164727339	60385	TSKS	chr19	50240011	50276587	36576	testis-specific serine kinase substrate
PA162407150	25987	TSKU	chr11	76483357	76512198	28841	tsukushi, small leucine rich proteoglycan
PA162407159	85480	TSLP	chr5	110395778	110416722	20944	thymic stromal lymphopoietin
PA37047	7247	TSN	chr2	122503121	122528429	25308	translin
PA142670693	203062	TSNARE1	chr8	143290441	143494543	204102	t-SNARE domain containing 1
PA37048	7257	TSNAX	chr1	231654399	231705270	50871	translin-associated factor X
PA134961990	55815	TSNAXIP1	chr16	67830829	67864971	34142	translin-associated factor X interacting protein 1
PA134938100	10103	TSPAN1	chr1	46630749	46654634	23885	tetraspanin 1
PA142670686	83882	TSPAN10	chr17	79599349	79618779	19430	tetraspanin 10
PA142670687	441631	TSPAN11	chr12	31069536	31152537	83001	tetraspanin 11
PA134954047	23554	TSPAN12	chr7	120424374	120508420	84046	tetraspanin 12
PA134868624	27075	TSPAN13	chr7	16783351	16827161	43810	tetraspanin 13
PA128394731	81619	TSPAN14	chr10	82204038	82285394	81356	tetraspanin 14
PA128394634	23555	TSPAN15	chr10	71166821	71274569	107748	tetraspanin 15
PA134989909	26526	TSPAN16	chr19	11396798	11440672	43874	tetraspanin 16
PA128394740	26262	TSPAN17	chr5	176064388	176089059	24671	tetraspanin 17
PA142670688	90139	TSPAN18	chr11	44738731	44956978	218247	tetraspanin 18
PA142670689	144448	TSPAN19	chr12	85405090	85440055	34965	tetraspanin 19
PA134938787	10100	TSPAN2	chr1	115587632	115642121	54489	tetraspanin 2
PA134913500	10099	TSPAN3	chr15	77333359	77373570	40211	tetraspanin 3
PA34949	6302	TSPAN31	chr12	58128784	58145026	16242	tetraspanin 31
PA33257	10077	TSPAN32	chr11	2313195	2342430	29235	tetraspanin 32
PA142670690	340348	TSPAN33	chr7	128774712	128812534	37822	tetraspanin 33
PA36560	7106	TSPAN4	chr11	832824	870116	37292	tetraspanin 4
PA134864098	10098	TSPAN5	chr4	99388518	99589812	201294	tetraspanin 5
PA36559	7105	TSPAN6	chrX	99879105	99902101	22996	tetraspanin 6
PA36555	7102	TSPAN7	chrX	38410731	38551172	140441	tetraspanin 7
PA36556	7103	TSPAN8	chr12	71515877	71561779	45902	tetraspanin 8
PA142670694	10867	TSPAN9	chr12	3176521	3398730	222209	tetraspanin 9
PA25824	54084	TSPEAR	chr21	45914775	46141495	226720	thrombospondin-type laminin G domain and EAR repeats
PA25473	706	TSPO	chr22	43537520	43562248	24728	translocator protein (18kDa)
PA165618396	222642	TSPO2	chr6	41000237	41015076	14839	translocator protein 2
PA37049	7258	TSPY1	chrY	9294564	9310359	15795	testis specific protein, Y-linked 1
PA165791579	100289087	TSPY10	chrY	9355495	9371285	15790	testis specific protein, Y-linked 10
PA134958857	64591	TSPY2	chrY	6104264	6120055	15791	testis specific protein, Y-linked 2
PA164727366	728137	TSPY3	chrY	9226030	9241827	15797	testis specific protein, Y-linked 3
PA165791608	728395	TSPY4	chrY	9165098	9180888	15790	testis specific protein, Y-linked 4
PA165791643	728403	TSPY8	chrY	9185442	9201203	15761	testis specific protein, Y-linked 8
PA37050	7259	TSPYL1	chr6	116593022	116611280	18258	TSPY-like 1
PA134930188	64061	TSPYL2	chrX	53101542	53120728	19186	TSPY-like 2
PA134942080	23270	TSPYL4	chr6	116568127	116585261	17134	TSPY-like 4
PA128394738	85453	TSPYL5	chr8	98282714	98300192	17478	TSPY-like 5
PA134953500	388951	TSPYL6	chr2	54477315	54493409	16094	TSPY-like 6
PA142670691	55720	TSR1	chr17	2222972	2250678	27706	TSR1, 20S rRNA accumulation, homolog (S. cerevisiae)
PA145147877	90121	TSR2	chrX	54456853	54474730	17877	TSR2, 20S rRNA accumulation, homolog (S. cerevisiae)
PA25558	115939	TSR3	chr16	1396241	1411873	15632	TSR3, 20S rRNA accumulation, homolog (S. cerevisiae)
PA37051	7260	TSSC1	chr2	3189741	3391653	201912	tumor suppressing subtransferable candidate 1
PA37054	10078	TSSC4	chr11	2411723	2428108	16385	tumor suppressing subtransferable candidate 4
PA37944	83942	TSSK1B	chr5	112765251	112780728	15477	testis-specific serine kinase 1B
PA36208	23617	TSSK2	chr22	19108321	19123136	14815	testis-specific serine kinase 2
PA37964	81629	TSSK3	chr1	32808365	32833098	24733	testis-specific serine kinase 3
PA134908318	283629	TSSK4	chr14	24664753	24680568	15815	testis-specific serine kinase 4
PA142670682	83983	TSSK6	chr19	19622028	19636469	14441	testis-specific serine kinase 6
PA37055	7263	TST	chr22	37403900	37426224	22324	thiosulfate sulfurtransferase (rhodanese)
PA37056	7264	TSTA3	chr8	144691788	144710358	18570	tissue specific transplantation antigen P35B
PA165752768	100131187	TSTD1	chr1	161004418	161018887	14469	thiosulfate sulfurtransferase (rhodanese)-like domain containing 1
PA165586365	158427	TSTD2	chr9	100359362	100405962	46600	thiosulfate sulfurtransferase (rhodanese)-like domain containing 2
PA134866142	84630	TTBK1	chr6	43201222	43258997	57775	tau tubulin kinase 1
PA134913925	146057	TTBK2	chr15	43027928	43223037	195109	tau tubulin kinase 2
PA37057	7265	TTC1	chr5	159426156	159495550	69394	tetratricopeptide repeat domain 1
PA134886066	54970	TTC12	chr11	113175251	113247345	72094	tetratricopeptide repeat domain 12
PA134931681	79573	TTC13	chr1	231038987	231124618	85631	tetratricopeptide repeat domain 13
PA134937037	151613	TTC14	chr3	180309918	180339120	29202	tetratricopeptide repeat domain 14
PA134871808	158248	TTC16	chr9	130468358	130496879	28521	tetratricopeptide repeat domain 16
PA134912435	55761	TTC17	chr11	43370435	43519483	149048	tetratricopeptide repeat domain 17
PA134922384	54902	TTC19	chr17	15892694	15935723	43029	tetratricopeptide repeat domain 19
PA134915959	199223	TTC21A	chr3	39139152	39183394	44242	tetratricopeptide repeat domain 21A
PA134882767	79809	TTC21B	chr2	166726872	166820348	93476	tetratricopeptide repeat domain 21B
PA142670674	55001	TTC22	chr1	55243752	55276941	33189	tetratricopeptide repeat domain 22
PA142670675	64927	TTC23	chr15	99673528	99801431	127903	tetratricopeptide repeat domain 23
PA162407169	153657	TTC23L	chr5	34829269	34902567	73298	tetratricopeptide repeat domain 23-like
PA142670676	164118	TTC24	chr1	156539519	156559562	20043	tetratricopeptide repeat domain 24
PA142670677	83538	TTC25	chr17	40076888	40120669	43781	tetratricopeptide repeat domain 25
PA144596245	79989	TTC26	chr7	138808490	138877550	69060	tetratricopeptide repeat domain 26
PA145007326	55622	TTC27	chr2	32843087	33049118	206031	tetratricopeptide repeat domain 27
PA145147752	23331	TTC28	chr22	28371002	29085853	714851	tetratricopeptide repeat domain 28
PA145147799	83894	TTC29	chr4	147625179	147877034	251855	tetratricopeptide repeat domain 29
PA37058	7267	TTC3	chr21	38435554	38578408	142854	tetratricopeptide repeat domain 3
PA145147829	92104	TTC30A	chr2	178476026	178493694	17668	tetratricopeptide repeat domain 30A
PA145147835	150737	TTC30B	chr2	178411880	178427524	15644	tetratricopeptide repeat domain 30B
PA145147843	64427	TTC31	chr2	74700200	74724691	24491	tetratricopeptide repeat domain 31
PA145147867	130502	TTC32	chr2	20093514	20111747	18233	tetratricopeptide repeat domain 32
PA162407196	23548	TTC33	chr5	40708678	40766072	57394	tetratricopeptide repeat domain 33
PA162407211	100287898	TTC34	chr1	2569807	2716230	146423	tetratricopeptide repeat domain 34
PA162407225	143941	TTC36	chr11	118388210	118404740	16530	tetratricopeptide repeat domain 36
PA162407226	9652	TTC37	chr5	94796599	94900709	104110	tetratricopeptide repeat domain 37
PA162407227	55020	TTC38	chr22	46653861	46692905	39044	tetratricopeptide repeat domain 38
PA162407260	22996	TTC39A	chr1	51749930	51820785	70855	tetratricopeptide repeat domain 39A
PA162407261	158219	TTC39B	chr9	15167842	15317358	149516	tetratricopeptide repeat domain 39B
PA162407262	125488	TTC39C	chr18	21562737	21718574	155837	tetratricopeptide repeat domain 39C
PA142670683	286495	TTC3P1	chrX	74957373	74972914	15541	tetratricopeptide repeat domain 3 pseudogene 1
PA37059	7268	TTC4	chr1	55171495	55211330	39835	tetratricopeptide repeat domain 4
PA134919164	91875	TTC5	chr14	20754290	20784153	29863	tetratricopeptide repeat domain 5
PA134868995	319089	TTC6	chr14	38139377	38279038	139661	tetratricopeptide repeat domain 6
PA134993362	57217	TTC7A	chr2	47158313	47306275	147962	tetratricopeptide repeat domain 7A
PA134947112	145567	TTC7B	chr14	91003932	91292823	288891	tetratricopeptide repeat domain 7B
PA134877629	123016	TTC8	chr14	89280574	89347335	66761	tetratricopeptide repeat domain 8
PA134905515	23508	TTC9	chr14	71098504	71145077	46573	tetratricopeptide repeat domain 9
PA142670684	148014	TTC9B	chr19	40718965	40734306	15341	tetratricopeptide repeat domain 9B
PA142670685	283237	TTC9C	chr11	62485545	62509110	23565	tetratricopeptide repeat domain 9C
PA37062	7270	TTF1	chr9	135247935	135292238	44303	transcription termination factor, RNA polymerase I
PA37063	8458	TTF2	chr1	117592910	117648492	55582	transcription termination factor, RNA polymerase II
PA165392722	9675	TTI1	chr20	36608419	36671870	63451	TELO2 interacting protein 1
PA142672360	80185	TTI2	chr8	33353027	33380703	27676	TELO2 interacting protein 2
PA37066	7272	TTK	chr6	80704322	80755244	50922	TTK protein kinase
PA134934330	150465	TTL	chr2	113229743	113293223	63480	tubulin tyrosine ligase
PA35030	25809	TTLL1	chr22	43432522	43495434	62912	tubulin tyrosine ligase-like family, member 1
PA142670679	254173	TTLL10	chr1	1099286	1136315	37029	tubulin tyrosine ligase-like family, member 10
PA25977	158135	TTLL11	chr9	124574953	124865885	290932	tubulin tyrosine ligase-like family, member 11
PA143485663	23170	TTLL12	chr22	43559628	43593137	33509	tubulin tyrosine ligase-like family, member 12
PA143485664	440307	TTLL13	chr15	90782764	90811709	28945	tubulin tyrosine ligase-like family, member 13
PA134888799	83887	TTLL2	chr6	167728574	167759177	30603	tubulin tyrosine ligase-like family, member 2
PA134942870	26140	TTLL3	chr3	9841632	9881040	39408	tubulin tyrosine ligase-like family, member 3
PA134935712	9654	TTLL4	chr2	219565558	219623139	57581	tubulin tyrosine ligase-like family, member 4
PA164742694	23093	TTLL5	chr14	76117551	76424425	306874	tubulin tyrosine ligase-like family, member 5
PA143485662	284076	TTLL6	chr17	46836593	46904469	67876	tubulin tyrosine ligase-like family, member 6
PA142670678	79739	TTLL7	chr1	84332057	84474850	142793	tubulin tyrosine ligase-like family, member 7
PA162407295	164714	TTLL8	chr22	50463026	50505364	42338	tubulin tyrosine ligase-like family, member 8
PA25666	164395	TTLL9	chr20	30448440	30535770	87330	tubulin tyrosine ligase-like family, member 9
PA37067	7273	TTN	chr2	179387716	179682150	294434	titin
PA37068	7274	TTPA	chr8	63969047	64008612	39565	tocopherol (alpha) transfer protein
PA162407296	79183	TTPAL	chr20	43094526	43126244	31718	tocopherol (alpha) transfer protein-like
PA37069	7276	TTR	chr18	29161730	29181987	20257	transthyretin
PA37778	57348	TTYH1	chr19	54916605	54950899	34294	tweety family member 1
PA37823	94015	TTYH2	chr17	72199696	72261159	61463	tweety family member 2
PA134908427	80727	TTYH3	chr7	2661603	2707436	45833	tweety family member 3
PA37070	7275	TUB	chr11	8030742	8130654	99912	tubby bipartite transcription factor
PA162407319	7846	TUBA1A	chr12	49575578	49593107	17529	tubulin, alpha 1a
PA162407332	10376	TUBA1B	chr12	49518565	49535304	16739	tubulin, alpha 1b
PA162407345	84790	TUBA1C	chr12	49611715	49670117	58402	tubulin, alpha 1c
PA162407346	7278	TUBA3C	chr13	19744910	19765992	21082	tubulin, alpha 3c
PA162407361	113457	TUBA3D	chr2	132223580	132243507	19927	tubulin, alpha 3d
PA162407376	112714	TUBA3E	chr2	130946318	130966034	19716	tubulin, alpha 3e
PA162407391	7277	TUBA4A	chr2	220111433	220129330	17897	tubulin, alpha 4a
PA38613	80086	TUBA4B	chr2	220107965	220139910	31945	tubulin, alpha 4b (pseudogene)
PA37074	51807	TUBA8	chr22	18583453	18617498	34045	tubulin, alpha 8
PA134953102	79861	TUBAL3	chr10	5432061	5456793	24732	tubulin, alpha-like 3
PA358	203068	TUBB	chr6	30678012	30696199	18187	tubulin, beta class I
PA38100	81027	TUBB1	chr20	57584309	57604709	20400	tubulin, beta 1 class VI
PA142670670	7280	TUBB2A	chr6	3150900	3167783	16883	tubulin, beta 2A class IIa
PA142670671	347733	TUBB2B	chr6	3221495	3237968	16473	tubulin, beta 2B class IIb
PA134953867	10381	TUBB3	chr16	89978417	90005505	27088	tubulin, beta 3 class III
PA134949465	10382	TUBB4A	chr19	6491330	6512595	21265	tubulin, beta 4A class IVa
PA142670672	10383	TUBB4B	chr9	140125711	140141159	15448	tubulin, beta 4B class IVb
PA128394736	84617	TUBB6	chr18	12298218	12329568	31350	tubulin, beta 6 class V
PA37076	56604	TUBB7P	chr4	190900678	190916024	15346	tubulin, beta 7, pseudogene
PA134909953	51174	TUBD1	chr17	57933840	57980306	46466	tubulin, delta 1
PA134936770	51175	TUBE1	chr6	112388860	112418751	29891	tubulin, epsilon 1
PA37079	7283	TUBG1	chr17	40751358	40770256	18898	tubulin, gamma 1
PA37081	27175	TUBG2	chr17	40801266	40822024	20758	tubulin, gamma 2
PA38598	10844	TUBGCP2	chr10	135089134	135135841	46707	tubulin, gamma complex associated protein 2
PA38597	10426	TUBGCP3	chr13	113136319	113252494	116175	tubulin, gamma complex associated protein 3
PA162407404	27229	TUBGCP4	chr15	43653257	43701258	48001	tubulin, gamma complex associated protein 4
PA38599	114791	TUBGCP5	chr15	22823395	22876891	53496	tubulin, gamma complex associated protein 5
PA38507	85378	TUBGCP6	chr22	50653118	50693453	40335	tubulin, gamma complex associated protein 6
PA37082	7284	TUFM	chr16	28850732	28867729	16997	Tu translation elongation factor, mitochondrial
PA37084	7286	TUFT1	chr1	151502781	151559059	56278	tuftelin 1
PA37085	7287	TULP1	chr6	35462651	35490715	28064	tubby like protein 1
PA37086	7288	TULP2	chr19	49381222	49411996	30774	tubby like protein 2
PA37087	7289	TULP3	chr12	2990033	3053306	63273	tubby like protein 3
PA134880863	56995	TULP4	chr6	158643268	158935860	292592	tubby like protein 4
PA134889281	286319	TUSC1	chr9	25673387	25688856	15469	tumor suppressor candidate 1
PA134968273	11334	TUSC2	chr3	50359341	50375668	16327	tumor suppressor candidate 2
PA128394537	7991	TUSC3	chr8	15387596	15627158	239562	tumor suppressor candidate 3
PA134868023	286753	TUSC5	chr17	1172957	1207281	34324	tumor suppressor candidate 5
PA162407405	64852	TUT1	chr11	62338431	62369109	30678	terminal uridylyl transferase 1, U6 snRNA-specific
PA134902394	780776	TVP23A	chr16	10852221	10922651	70430	trans-golgi network vesicle protein 23 homolog A (S. cerevisiae)
PA134871046	51030	TVP23B	chr17	18674458	18713027	38569	trans-golgi network vesicle protein 23 homolog B (S. cerevisiae)
PA142671894	201158	TVP23C	chr17	15402578	15476945	74367	trans-golgi network vesicle protein 23 homolog C (S. cerevisiae)
PA162407406	5756	TWF1	chr12	44184526	44210178	25652	twinfilin actin-binding protein 1
PA162407429	11344	TWF2	chr3	52259626	52283183	23557	twinfilin actin-binding protein 2
PA37088	7291	TWIST1	chr7	19036315	19167295	130980	twist family bHLH transcription factor 1
PA134973713	117581	TWIST2	chr2	239821979	239835237	13258	twist family bHLH transcription factor 2
PA134878254	221830	TWISTNB	chr7	19732085	19758660	26575	TWIST neighbor
PA37089	57045	TWSG1	chr18	9324765	9405424	80659	twisted gastrulation BMP signaling modulator 1
PA37090	7294	TXK	chr4	48065410	48146273	80863	TXK tyrosine kinase
PA142670668	200081	TXLNA	chr1	32635293	32666886	31593	taxilin alpha
PA134878600	167838	TXLNB	chr6	139558198	139655148	96950	taxilin beta
PA38588	55787	TXLNG	chrX	16794555	16865642	71087	taxilin gamma
PA38545	246126	TXLNG2P	chrY	21719244	21772056	52812	taxilin gamma 2, pseudogene
PA37091	7295	TXN	chr9	113003092	113028920	25828	thioredoxin
PA38245	25828	TXN2	chr22	36860083	36888072	27989	thioredoxin 2
PA134915251	51061	TXNDC11	chr16	11769939	11846707	76768	thioredoxin domain containing 11
PA142670665	51060	TXNDC12	chr1	52482803	52531843	49040	thioredoxin domain containing 12 (endoplasmic reticulum)
PA162407473	79770	TXNDC15	chr5	134199427	134240323	40896	thioredoxin domain containing 15
PA162407488	57544	TXNDC16	chr14	52894308	53029301	134993	thioredoxin domain containing 16
PA162407489	84817	TXNDC17	chr17	6534222	6550861	16639	thioredoxin domain containing 17
PA38147	84203	TXNDC2	chr18	9875723	9892272	16549	thioredoxin domain containing 2 (spermatozoa)
PA134992492	81567	TXNDC5	chr6	7878483	7921047	42564	thioredoxin domain containing 5 (endoplasmic reticulum)
PA134935003	255220	TXNDC8	chr9	113062762	113110163	47401	thioredoxin domain containing 8 (spermatozoa)
PA134957934	10190	TXNDC9	chr2	99932487	99967155	34668	thioredoxin domain containing 9
PA38194	10628	TXNIP	chr1	145428438	145445635	17197	thioredoxin interacting protein
PA134967488	9352	TXNL1	chr18	54267053	54315920	48867	thioredoxin-like 1
PA134937290	10907	TXNL4A	chr18	77729867	77758546	28679	thioredoxin-like 4A
PA134944912	54957	TXNL4B	chr16	72115756	72138215	22459	thioredoxin-like 4B
PA37093	7296	TXNRD1	chr12	104599537	104747085	147548	thioredoxin reductase 1
PA38302	10587	TXNRD2	chr22	19860040	19939359	79319	thioredoxin reductase 2
PA134920642	114112	TXNRD3	chr3	126322895	126385056	62161	thioredoxin reductase 3
PA165698675	645840	TXNRD3NB	chr3	126287622	126337398	49776	thioredoxin reductase 3 neighbor
PA37094	7297	TYK2	chr19	10458204	10501248	43044	tyrosine kinase 2
PA162407502	1890	TYMP	chr22	50961181	50978514	17333	thymidine phosphorylase
PA359	7298	TYMS	chr18	647590	676499	28909	thymidylate synthetase
PA37095	7299	TYR	chr11	88901040	89031927	130887	tyrosinase
PA37097	7301	TYRO3	chr15	41841220	41874536	33316	TYRO3 protein tyrosine kinase
PA37100	7305	TYROBP	chr19	36392303	36409211	16908	TYRO protein tyrosine kinase binding protein
PA37101	7306	TYRP1	chr9	12683385	12713285	29900	tyrosinase-related protein 1
PA134968651	219743	TYSND1	chr10	71894737	71916496	21759	trypsin domain containing 1
PA134940167	55253	TYW1	chr7	66451792	66707507	255715	tRNA-yW synthesizing protein 1 homolog (S. cerevisiae)
PA164727375	441250	TYW1B	chr7	72020729	72308813	288084	tRNA-yW synthesizing protein 1 homolog B (S. cerevisiae)
PA142672420	127253	TYW3	chr1	75188836	75235361	46525	tRNA-yW synthesizing protein 3 homolog (S. cerevisiae)
PA162379298	129450	TYW5	chr2	200790634	200830459	39825	tRNA-yW synthesizing protein 5
PA37103	7307	U2AF1	chr21	44510066	44537716	27650	U2 small nuclear RNA auxiliary factor 1
PA164742763	199746	U2AF1L4	chr19	36230428	36246409	15981	U2 small nuclear RNA auxiliary factor 1-like 4
PA134908683	11338	U2AF2	chr19	56155416	56189082	33666	U2 small nuclear RNA auxiliary factor 2
PA38062	55075	UACA	chr15	70943893	71065932	122039	uveal autoantigen with coiled-coil domains and ankyrin repeats
PA37107	6675	UAP1	chr1	162521296	162573379	52083	UDP-N-acetylglucosamine pyrophosphorylase 1
PA134943810	91373	UAP1L1	chr9	139961944	139981990	20046	UDP-N-acetylglucosamine pyrophosphorylase 1 like 1
PA37119	7317	UBA1	chrX	47040199	47077527	37328	ubiquitin-like modifier activating enzyme 1
PA162407583	10054	UBA2	chr19	34909264	34963798	54534	ubiquitin-like modifier activating enzyme 2
PA162407622	9039	UBA3	chr3	69100881	69139524	38643	ubiquitin-like modifier activating enzyme 3
PA162407661	79876	UBA5	chr3	132363290	132400467	37177	ubiquitin-like modifier activating enzyme 5
PA37108	7311	UBA52	chr19	18664576	18691270	26694	ubiquitin A-52 residue ribosomal protein fusion product 1
PA162407690	55236	UBA6	chr4	68478479	68576889	98410	ubiquitin-like modifier activating enzyme 6
PA162407761	7318	UBA7	chr3	49839638	49861391	21753	ubiquitin-like modifier activating enzyme 7
PA162407814	10422	UBAC1	chr9	138821815	138863226	41411	UBA domain containing 1
PA162407839	337867	UBAC2	chr13	99842679	100041753	199074	UBA domain containing 2
PA142671782	124402	UBALD1	chr16	4655884	4674927	19043	UBA-like domain containing 1
PA142671783	283991	UBALD2	chr17	74251286	74270379	19093	UBA-like domain containing 2
PA37111	51271	UBAP1	chr9	34169003	34255521	86518	ubiquitin associated protein 1
PA38379	55833	UBAP2	chr9	33918691	34058947	140256	ubiquitin associated protein 2
PA134883839	9898	UBAP2L	chr1	154182427	154246986	64559	ubiquitin associated protein 2-like
PA37112	53347	UBASH3A	chr21	43813971	43870790	56819	ubiquitin associated and SH3 domain containing A
PA162407840	84959	UBASH3B	chr11	122516398	122688187	171789	ubiquitin associated and SH3 domain containing B
PA37113	7314	UBB	chr17	16274367	16289059	14692	ubiquitin B
PA37118	7316	UBC	chr12	125393192	125409587	16395	ubiquitin C
PA38682	10537	UBD	chr6	29520389	29537702	17313	ubiquitin D
PA37122	7319	UBE2A	chrX	118698499	118721381	22882	ubiquitin-conjugating enzyme E2A
PA37123	7320	UBE2B	chr5	133696843	133730799	33956	ubiquitin-conjugating enzyme E2B
PA38057	11065	UBE2C	chr20	44431255	44448596	17341	ubiquitin-conjugating enzyme E2C
PA37124	7321	UBE2D1	chr10	60084739	60133513	48774	ubiquitin-conjugating enzyme E2D 1
PA37125	7322	UBE2D2	chr5	138930751	139011019	80268	ubiquitin-conjugating enzyme E2D 2
PA37126	7323	UBE2D3	chr4	103712540	103800050	87510	ubiquitin-conjugating enzyme E2D 3
PA134954568	51619	UBE2D4	chr7	43956035	43998735	42700	ubiquitin-conjugating enzyme E2D 4 (putative)
PA37127	7324	UBE2E1	chr3	23837384	23936131	98747	ubiquitin-conjugating enzyme E2E 1
PA37128	7325	UBE2E2	chr3	23234498	23635296	400798	ubiquitin-conjugating enzyme E2E 2
PA37129	10477	UBE2E3	chr2	181835112	181931154	96042	ubiquitin-conjugating enzyme E2E 3
PA37130	140739	UBE2F	chr2	238865587	238954423	88836	ubiquitin-conjugating enzyme E2F (putative)
PA37131	7326	UBE2G1	chr17	4169512	4279969	110457	ubiquitin-conjugating enzyme E2G 1
PA37132	7327	UBE2G2	chr21	46185495	46231751	46256	ubiquitin-conjugating enzyme E2G 2
PA37133	7328	UBE2H	chr7	129467572	129602800	135228	ubiquitin-conjugating enzyme E2H
PA37134	7329	UBE2I	chr16	1347420	1380019	32599	ubiquitin-conjugating enzyme E2I
PA134906541	51465	UBE2J1	chr6	90033344	90072619	39275	ubiquitin-conjugating enzyme E2, J1
PA134882268	118424	UBE2J2	chr1	1186292	1219234	32942	ubiquitin-conjugating enzyme E2, J2
PA162407874	3093	UBE2K	chr4	39689664	39787412	97748	ubiquitin-conjugating enzyme E2K
PA37137	7332	UBE2L3	chr22	21893736	21981323	87587	ubiquitin-conjugating enzyme E2L 3
PA37139	9246	UBE2L6	chr11	57316128	57345803	29675	ubiquitin-conjugating enzyme E2L 6
PA37140	9040	UBE2M	chr19	59064079	59080343	16264	ubiquitin-conjugating enzyme E2M
PA37141	7334	UBE2N	chr12	93799088	93846026	46938	ubiquitin-conjugating enzyme E2N
PA134943659	389898	UBE2NL	chrX	142957173	142971362	14189	ubiquitin-conjugating enzyme E2N-like (gene/pseudogene)
PA142670651	63893	UBE2O	chr17	74382613	74459288	76675	ubiquitin-conjugating enzyme E2O
PA38029	55585	UBE2Q1	chr1	154518051	154541138	23087	ubiquitin-conjugating enzyme E2Q family member 1
PA142670652	92912	UBE2Q2	chr15	76125622	76196388	70766	ubiquitin-conjugating enzyme E2Q family member 2
PA165660602	134111	UBE2QL1	chr5	6427460	6499834	72374	ubiquitin-conjugating enzyme E2Q family-like 1
PA134946881	54926	UBE2R2	chr9	33807162	33923401	116239	ubiquitin-conjugating enzyme E2R 2
PA134904441	27338	UBE2S	chr19	55909650	55929325	19675	ubiquitin-conjugating enzyme E2S
PA142670655	29089	UBE2T	chr1	202297785	202321094	23309	ubiquitin-conjugating enzyme E2T (putative)
PA142670656	148581	UBE2U	chr1	64659135	64735969	76834	ubiquitin-conjugating enzyme E2U (putative)
PA37142	7335	UBE2V1	chr20	48694661	48742496	47835	ubiquitin-conjugating enzyme E2 variant 1
PA37143	7336	UBE2V2	chr8	48910966	48980268	69302	ubiquitin-conjugating enzyme E2 variant 2
PA142670657	55284	UBE2W	chr8	74689332	74801145	111813	ubiquitin-conjugating enzyme E2W (putative)
PA142670659	65264	UBE2Z	chr17	46975731	47009422	33691	ubiquitin-conjugating enzyme E2Z
PA37144	7337	UBE3A	chr15	25579396	25694175	114779	ubiquitin protein ligase E3A
PA134872189	89910	UBE3B	chr12	109905215	109977510	72295	ubiquitin protein ligase E3B
PA134905339	9690	UBE3C	chr7	156921655	157065066	143411	ubiquitin protein ligase E3C
PA162407873	90025	UBE3D	chr6	83599186	83785545	186359	ubiquitin protein ligase E3D
PA37147	9354	UBE4A	chr11	118220296	118272926	52630	ubiquitination factor E4A
PA37148	10277	UBE4B	chr1	10083041	10244297	161256	ubiquitination factor E4B
PA162407893	56061	UBFD1	chr16	23558856	23588710	29854	ubiquitin family domain containing 1
PA142670660	29914	UBIAD1	chr1	11323255	11351491	28236	UbiA prenyltransferase domain containing 1
PA37151	5412	UBL3	chr13	30335545	30434820	99275	ubiquitin-like 3
PA37152	8266	UBL4A	chrX	153709056	153724932	15876	ubiquitin-like 4A
PA142670661	164153	UBL4B	chr1	110645062	110659569	14507	ubiquitin-like 4B
PA37805	59286	UBL5	chr19	9928556	9943797	15241	ubiquitin-like 5
PA142670645	84993	UBL7	chr15	74735318	74763545	28227	ubiquitin-like 7
PA142670646	134510	UBLCP1	chr5	158680089	158716048	35959	ubiquitin-like domain containing CTD phosphatase 1
PA37153	29855	UBN1	chr16	4886666	4935363	48697	ubinuclein 1
PA164727415	254048	UBN2	chr7	138905978	138995982	90004	ubinuclein 2
PA134991794	22888	UBOX5	chr20	3085219	3150556	65337	U-box domain containing 5
PA37154	7342	UBP1	chr3	33426828	33491897	65069	upstream binding protein 1 (LBP-1a)
PA37155	29979	UBQLN1	chr9	86271878	86333168	61290	ubiquilin 1
PA37156	29978	UBQLN2	chrX	56580025	56596443	16418	ubiquilin 2
PA37157	50613	UBQLN3	chr11	5525530	5541153	15623	ubiquilin 3
PA25619	56893	UBQLN4	chr1	155999945	156033613	33668	ubiquilin 4
PA162407912	143630	UBQLNL	chr11	5532623	5547956	15333	ubiquilin-like
PA38187	197131	UBR1	chr15	43232095	43408286	176191	ubiquitin protein ligase E3 component n-recognin 1
PA128394621	23304	UBR2	chr6	42521748	42664243	142495	ubiquitin protein ligase E3 component n-recognin 2
PA162407919	130507	UBR3	chr2	170674010	170943641	269631	ubiquitin protein ligase E3 component n-recognin 3 (putative)
PA162407958	23352	UBR4	chr1	19398000	19546812	148812	ubiquitin protein ligase E3 component n-recognin 4
PA162408175	51366	UBR5	chr8	103261501	103434947	173446	ubiquitin protein ligase E3 component n-recognin 5
PA162408298	55148	UBR7	chr14	93663401	93698561	35160	ubiquitin protein ligase E3 component n-recognin 7 (putative)
PA134976337	80019	UBTD1	chr10	99248768	99333960	85192	ubiquitin domain containing 1
PA162408325	92181	UBTD2	chr5	171633648	171720795	87147	ubiquitin domain containing 2
PA37158	7343	UBTF	chr17	42279401	42308994	29593	upstream binding transcription factor, RNA polymerase I
PA164727456	642623	UBTFL1	chr11	89809118	89823299	14181	upstream binding transcription factor, RNA polymerase I-like 1
PA162408336	51035	UBXN1	chr11	62440972	62456554	15582	UBX domain protein 1
PA162408337	127733	UBXN10	chr1	20502578	20525540	22962	UBX domain protein 10
PA162408338	91544	UBXN11	chr1	26605773	26654756	48983	UBX domain protein 11
PA162408375	165324	UBXN2A	chr2	24140132	24226701	86569	UBX domain protein 2A
PA162408394	137886	UBXN2B	chr8	59313823	59367060	53237	UBX domain protein 2B
PA37912	23190	UBXN4	chr2	136489189	136545633	56444	UBX domain protein 4
PA162408446	80700	UBXN6	chr19	4442003	4467791	25788	UBX domain protein 6
PA162408447	26043	UBXN7	chr3	196076745	196169411	92666	UBX domain protein 7
PA162408474	7993	UBXN8	chr8	30591690	30627522	35832	UBX domain protein 8
PA37160	7345	UCHL1	chr4	41248898	41273446	24548	ubiquitin carboxyl-terminal esterase L1 (ubiquitin thiolesterase)
PA37162	7347	UCHL3	chr13	76113616	76183156	69540	ubiquitin carboxyl-terminal esterase L3 (ubiquitin thiolesterase)
PA134916228	51377	UCHL5	chr1	192978496	193039237	60741	ubiquitin carboxyl-terminal hydrolase L5
PA134861770	83549	UCK1	chr9	134396183	134416662	20479	uridine-cytidine kinase 1
PA362	7371	UCK2	chr1	165786732	165883855	97123	uridine-cytidine kinase 2
PA38058	54963	UCKL1	chr20	62568182	62597800	29618	uridine-cytidine kinase 1-like 1
PA165392723	100113386	UCKL1-AS1	chr20	62574737	62591338	16601	UCKL1 antisense RNA 1
PA164727494	221044	UCMA	chr10	13260771	13286331	25560	upper zone of growth plate and cartilage matrix associated
PA37163	7349	UCN	chr2	27527265	27541130	13865	urocortin
PA133787055	90226	UCN2	chr3	48596151	48611201	15050	urocortin 2
PA130413153	114131	UCN3	chr10	5396976	5419169	22193	urocortin 3
PA37164	7350	UCP1	chr4	141478014	141499989	21975	uncoupling protein 1 (mitochondrial, proton carrier)
PA37165	7351	UCP2	chr11	73682716	73703889	21173	uncoupling protein 2 (mitochondrial, proton carrier)
PA37166	7352	UCP3	chr11	73708326	73730282	21956	uncoupling protein 3 (mitochondrial, proton carrier)
PA147357188	55293	UEVLD	chr11	18548156	18620293	72137	UEV and lactate/malate dehyrogenase domains
PA142670644	51506	UFC1	chr1	161113534	161131646	18112	ubiquitin-fold modifier conjugating enzyme 1
PA37167	7353	UFD1L	chr22	19434464	19476818	42354	ubiquitin fusion degradation 1 like (yeast)
PA134937763	23376	UFL1	chr6	96959702	97006152	46450	UFM1-specific ligase 1
PA134863405	51569	UFM1	chr13	38913942	38940143	26201	ubiquitin-fold modifier 1
PA162408522	402682	UFSP1	chr7	100483344	100497339	13995	UFM1-specific peptidase 1 (non-functional)
PA162408529	55325	UFSP2	chr4	186317691	186357139	39448	UFM1-specific peptidase 2
PA37169	7357	UGCG	chr9	114649206	114700649	51443	UDP-glucose ceramide glucosyltransferase
PA37170	7358	UGDH	chr4	39497375	39539218	41843	UDP-glucose 6-dehydrogenase
PA38014	56886	UGGT1	chr2	128838754	128956251	117497	UDP-glucose glycoprotein glucosyltransferase 1
PA38015	55757	UGGT2	chr13	96450834	96715736	264902	UDP-glucose glycoprotein glucosyltransferase 2
PA37172	7360	UGP2	chr2	64058084	64121696	63612	UDP-glucose pyrophosphorylase 2
PA37173	7361	UGT1A	chr2	-1	-1	0	UDP glucuronosyltransferase 1 family, polypeptide A complex locus
PA420	54658	UGT1A1	chr2	234658919	234684945	26026	UDP glucuronosyltransferase 1 family, polypeptide A1
PA37174	54575	UGT1A10	chr2	234535123	234684951	149828	UDP glucuronosyltransferase 1 family, polypeptide A10
PA37175	54574	UGT1A11P	chr2	234502200	234516045	13845	UDP glucuronosyltransferase 1 family, polypeptide A11 pseudogene
PA37176	54573	UGT1A12P	chr2	234484086	234497938	13852	UDP glucuronosyltransferase 1 family, polypeptide A12 pseudogene
PA142670639	404204	UGT1A13P	chr2	234546576	234560673	14097	UDP glucuronosyltransferase 1 family, polypeptide A13 pseudogene
PA37177	54580	UGT1A2P	chr2	234645755	234660187	14432	UDP glucuronosyltransferase 1 family, polypeptide A2 pseudogene
PA37178	54659	UGT1A3	chr2	234627773	234684945	57172	UDP glucuronosyltransferase 1 family, polypeptide A3
PA37179	54657	UGT1A4	chr2	234617438	234684945	67507	UDP glucuronosyltransferase 1 family, polypeptide A4
PA37180	54579	UGT1A5	chr2	234611638	234684945	73307	UDP glucuronosyltransferase 1 family, polypeptide A5
PA37181	54578	UGT1A6	chr2	234590321	234684951	94630	UDP glucuronosyltransferase 1 family, polypeptide A6
PA37182	54577	UGT1A7	chr2	234580584	234684945	104361	UDP glucuronosyltransferase 1 family, polypeptide A7
PA37183	54576	UGT1A8	chr2	234516291	234684945	168654	UDP glucuronosyltransferase 1 family, polypeptide A8
PA419	54600	UGT1A9	chr2	234570544	234684951	114407	UDP glucuronosyltransferase 1 family, polypeptide A9
PA37184	10941	UGT2A1	chr4	70451135	70528967	77832	UDP glucuronosyltransferase 2 family, polypeptide A1, complex locus
PA142670640	574537	UGT2A2	chr4	70451135	70515360	64225	UDP glucuronosyltransferase 2 family, polypeptide A2
PA142670641	79799	UGT2A3	chr4	69791177	69827509	36332	UDP glucuronosyltransferase 2 family, polypeptide A3
PA37186	7365	UGT2B10	chr4	69671713	69700741	29028	UDP glucuronosyltransferase 2 family, polypeptide B10
PA37187	10720	UGT2B11	chr4	70063035	70090449	27414	UDP glucuronosyltransferase 2 family, polypeptide B11
PA37188	7366	UGT2B15	chr4	69509315	69546494	37179	UDP glucuronosyltransferase 2 family, polypeptide B15
PA37189	7367	UGT2B17	chr4	69399902	69444245	44343	UDP glucuronosyltransferase 2 family, polypeptide B17
PA37779	54490	UGT2B28	chr4	70136217	70163768	27551	UDP glucuronosyltransferase 2 family, polypeptide B28
PA360	7363	UGT2B4	chr4	70342883	70401732	58849	UDP glucuronosyltransferase 2 family, polypeptide B4
PA361	7364	UGT2B7	chr4	69945190	69981705	36515	UDP glucuronosyltransferase 2 family, polypeptide B7
PA142670642	133688	UGT3A1	chr5	35950191	36076639	126448	UDP glycosyltransferase 3 family, polypeptide A1
PA142670643	167127	UGT3A2	chr5	36032119	36077023	44904	UDP glycosyltransferase 3 family, polypeptide A2
PA37195	7368	UGT8	chr4	115509611	115601202	91591	UDP glycosyltransferase 8
PA134974001	127933	UHMK1	chr1	162456964	162502419	45455	U2AF homology motif (UHM) kinase 1
PA37196	29128	UHRF1	chr19	4899510	4965165	65655	ubiquitin-like with PHD and ring finger domains 1
PA162408530	54887	UHRF1BP1	chr6	34749794	34848291	98497	UHRF1 binding protein 1
PA162408577	23074	UHRF1BP1L	chr12	100419233	100546642	127409	UHRF1 binding protein 1-like
PA37197	115426	UHRF2	chr9	6403151	6510054	106903	ubiquitin-like with PHD and ring finger domains 2, E3 ubiquitin protein ligase
PA162408624	51720	UIMC1	chr5	176329006	176443795	114789	ubiquitin interaction motif containing 1
PA37915	80329	ULBP1	chr6	150275110	150297846	22736	UL16 binding protein 1
PA37916	80328	ULBP2	chr6	150245901	150273371	27470	UL16 binding protein 2
PA37917	79465	ULBP3	chr6	150380341	150400940	20599	UL16 binding protein 3
PA37198	8408	ULK1	chr12	132369279	132410707	41428	unc-51 like autophagy activating kinase 1
PA37780	9706	ULK2	chr17	19671143	19781239	110096	unc-51 like autophagy activating kinase 2
PA134908392	25989	ULK3	chr15	75125459	75145552	20093	unc-51 like kinase 3
PA134978836	54986	ULK4	chr3	41285090	42066080	780990	unc-51 like kinase 4
PA37199	7369	UMOD	chr16	20341373	20374200	32827	uromodulin
PA37200	89766	UMODL1	chr21	43473068	43566105	93037	uromodulin-like 1
PA363	7372	UMPS	chr3	124439213	124471120	31907	uridine monophosphate synthetase
PA37202	9094	UNC119	chr17	26870725	26889647	18922	unc-119 homolog (C. elegans)
PA38152	84747	UNC119B	chr12	121138238	121164443	26205	unc-119 homolog B (C. elegans)
PA134879020	23025	UNC13A	chr19	17709137	17809123	99986	unc-13 homolog A (C. elegans)
PA37203	10497	UNC13B	chr9	35151976	35408334	256358	unc-13 homolog B (C. elegans)
PA134870087	440279	UNC13C	chr15	54260557	54923806	663249	unc-13 homolog C (C. elegans)
PA134919958	201294	UNC13D	chr17	73820306	73850798	30492	unc-13 homolog D (C. elegans)
PA142670638	55898	UNC45A	chr15	91463410	91500323	36913	unc-45 homolog A (C. elegans)
PA26655	146862	UNC45B	chr17	33464787	33519364	54577	unc-45 homolog B (C. elegans)
PA134984566	25972	UNC50	chr2	99215032	99237978	22946	unc-50 homolog (C. elegans)
PA37204	90249	UNC5A	chr5	176227560	176310899	83339	unc-5 homolog A (C. elegans)
PA37205	219699	UNC5B	chr10	72962292	73065635	103343	unc-5 homolog B (C. elegans)
PA37206	8633	UNC5C	chr4	96080655	96480361	399706	unc-5 homolog C (C. elegans)
PA134906657	222643	UNC5CL	chr6	40991640	41016938	25298	unc-5 homolog C (C. elegans)-like
PA38612	137970	UNC5D	chr8	35082975	35657068	574093	unc-5 homolog D (C. elegans)
PA134994003	57578	UNC79	chr14	93789565	94177222	387657	unc-79 homolog (C. elegans)
PA165697705	285175	UNC80	chr2	210626717	210867024	240307	unc-80 homolog (C. elegans)
PA37207	54346	UNC93A	chr6	167694803	167732502	37699	unc-93 homolog A (C. elegans)
PA37781	81622	UNC93B1	chr11	67755575	67781593	26018	unc-93 homolog B1 (C. elegans)
PA164727495	729196	UNC93B5	chr11	-1	-1	0	unc-93 homolog B5 pseudogene (C. elegans)
PA162408642	340260	UNCX	chr7	1262654	1279613	16959	UNC homeobox
PA364	7374	UNG	chr12	109525399	109551798	26399	uracil-DNA glycosylase
PA162408651	85451	UNK	chr17	73770920	73824886	53966	unkempt family zinc finger
PA37855	64718	UNKL	chr16	1410206	1474750	64544	unkempt family zinc finger-like
PA418	51733	UPB1	chr22	24853344	24925553	72209	ureidopropionase, beta
PA34328	5976	UPF1	chr19	18932744	18982039	49295	UPF1 regulator of nonsense transcripts homolog (yeast)
PA134945630	26019	UPF2	chr10	11959021	12095169	136148	UPF2 regulator of nonsense transcripts homolog (yeast)
PA134961553	65110	UPF3A	chr13	115037059	115074292	37233	UPF3 regulator of nonsense transcripts homolog A (yeast)
PA128394708	65109	UPF3B	chrX	118938115	118996991	58876	UPF3 regulator of nonsense transcripts homolog B (yeast)
PA37209	11045	UPK1A	chr19	36147418	36172387	24969	uroplakin 1A
PA37210	7348	UPK1B	chr3	118882425	118927000	44575	uroplakin 1B
PA37211	7379	UPK2	chr11	118817008	118832269	15261	uroplakin 2
PA37212	7380	UPK3A	chr22	45670868	45694755	23887	uroplakin 3A
PA134952181	80761	UPK3B	chr7	76129650	76160200	30550	uroplakin 3B
PA165618441	100134938	UPK3BL	chr7	102274472	102293238	18766	uroplakin 3B-like
PA365	7378	UPP1	chr7	48118355	48151330	32975	uridine phosphorylase 1
PA134866434	151531	UPP2	chr2	158723213	158995666	272453	uridine phosphorylase 2
PA162408652	139596	UPRT	chrX	74483894	74527732	43838	uracil phosphoribosyltransferase (FUR1) homolog (S. cerevisiae)
PA162408653	55245	UQCC1	chr20	33887369	34009945	122576	ubiquinol-cytochrome c reductase complex assembly factor 1
PA134970806	84300	UQCC2	chr6	33662346	33689504	27158	ubiquinol-cytochrome c reductase complex assembly factor 2
PA162377760	790955	UQCC3	chr11	62429126	62444162	15036	ubiquinol-cytochrome c reductase complex assembly factor 3
PA165378374	29796	UQCR10	chr22	30153358	30169402	16044	ubiquinol-cytochrome c reductase, complex III subunit X
PA165394505	10975	UQCR11	chr19	1594154	1615483	21329	ubiquinol-cytochrome c reductase, complex III subunit XI
PA37213	7381	UQCRB	chr8	97235904	97257862	21958	ubiquinol-cytochrome c reductase binding protein
PA37216	7384	UQCRC1	chr3	48633432	48657391	23959	ubiquinol-cytochrome c reductase core protein I
PA37217	7385	UQCRC2	chr16	21954609	21997668	43059	ubiquinol-cytochrome c reductase core protein II
PA37218	7386	UQCRFS1	chr19	29695167	29714136	18969	ubiquinol-cytochrome c reductase, Rieske iron-sulfur polypeptide 1
PA37220	7388	UQCRH	chr1	46759324	46785448	26124	ubiquinol-cytochrome c reductase hinge protein
PA142670637	27089	UQCRQ	chr5	132192319	132207536	15217	ubiquinol-cytochrome c reductase, complex III subunit VII, 9.5kDa
PA142671135	646625	URAD	chr13	28549243	28572774	23531	ureidoimidazoline (2-oxo-4-hydroxy-4-carboxy-5-) decarboxylase
PA162408676	9875	URB1	chr21	33680330	33775312	94982	URB1 ribosome biogenesis 1 homolog (S. cerevisiae)
PA164727496	9816	URB2	chr1	229751981	229798946	46965	URB2 ribosome biogenesis 2 homolog (S. cerevisiae)
PA165618458	55665	URGCP	chr7	43912485	43975996	63511	upregulator of cell proliferation
PA134962614	8725	URI1	chr19	30404551	30510519	105968	URI1, prefoldin-like chaperone
PA162408677	81605	URM1	chr9	131123598	131157295	33697	ubiquitin related modifier 1
PA134879207	131669	UROC1	chr3	126197008	126246616	49608	urocanate hydratase 1
PA37221	7389	UROD	chr1	45467805	45484341	16536	uroporphyrinogen decarboxylase
PA37222	7390	UROS	chr10	127471091	127521837	50746	uroporphyrinogen III synthase
PA143485394	79650	USB1	chr16	58023450	58058527	35077	U6 snRNA biogenesis 1
PA162408692	55850	USE1	chr19	17316155	17333638	17483	unconventional SNARE in the ER 1 homolog (S. cerevisiae)
PA37223	7391	USF1	chr1	161006041	161025769	19728	upstream transcription factor 1
PA37224	7392	USF2	chr19	35749896	35773724	23828	upstream transcription factor 2, c-fos interacting
PA37226	10083	USH1C	chr11	17512442	17575963	63521	Usher syndrome 1C (autosomal recessive, severe)
PA38126	124590	USH1G	chr17	72909176	72929351	20175	Usher syndrome 1G (autosomal recessive)
PA37228	7399	USH2A	chr1	215793236	216606738	813502	Usher syndrome 2A (autosomal recessive, mild)
PA134909077	83878	USHBP1	chr19	17357537	17385605	28068	Usher syndrome 1C binding protein 1
PA134968209	84833	USMG5	chr10	105145807	105166270	20463	up-regulated during skeletal muscle growth 5 homolog (mouse)
PA142670634	100288307	USMG5P1	chrX	73383696	73397025	13329	up-regulated during skeletal muscle growth 5 homolog (mouse) pseudogene 1
PA162408713	8615	USO1	chr4	76639829	76738366	98537	USO1 vesicle transport factor
PA37233	7398	USP1	chr1	62891975	62920475	28500	ubiquitin specific peptidase 1
PA37234	9100	USP10	chr16	84723555	84816528	92973	ubiquitin specific peptidase 10
PA37235	8237	USP11	chrX	47082089	47110727	28638	ubiquitin specific peptidase 11
PA37236	219333	USP12	chr13	27637287	27756033	118746	ubiquitin specific peptidase 12
PA37237	8975	USP13	chr3	179360933	179510189	149256	ubiquitin specific peptidase 13 (isopeptidase T-3)
PA37238	9097	USP14	chr18	148483	216739	68256	ubiquitin specific peptidase 14 (tRNA-guanine transglycosylase)
PA37239	9958	USP15	chr12	62644121	62806501	162380	ubiquitin specific peptidase 15
PA37240	10600	USP16	chr21	30386938	30429809	42871	ubiquitin specific peptidase 16
PA165586023	377630	USP17L2	chr8	11991677	12006269	14592	ubiquitin specific peptidase 17-like family member 2
PA165664776	728386	USP17L5	chr4	9331129	9345721	14592	ubiquitin specific peptidase 17-like family member 5
PA37241	391627	USP17L9P	chr4	9350108	9364700	14592	ubiquitin specific peptidase 17-like family member 9, pseudogene
PA37242	11274	USP18	chr22	18622758	18663164	40406	ubiquitin specific peptidase 18
PA37243	10869	USP19	chr3	49142479	49168371	25892	ubiquitin specific peptidase 19
PA37244	9099	USP2	chr11	119222925	119262436	39511	ubiquitin specific peptidase 2
PA37245	10868	USP20	chr9	132587696	132647121	59425	ubiquitin specific peptidase 20
PA37246	27005	USP21	chr1	161119248	161138516	19268	ubiquitin specific peptidase 21
PA37247	23326	USP22	chr17	20899906	20956722	56816	ubiquitin specific peptidase 22
PA37248	23358	USP24	chr1	55529032	55691039	162007	ubiquitin specific peptidase 24
PA37249	29761	USP25	chr21	17092327	17255377	163050	ubiquitin specific peptidase 25
PA37782	83844	USP26	chrX	132155659	132241135	85476	ubiquitin specific peptidase 26
PA37250	57646	USP28	chr11	113665597	113756292	90695	ubiquitin specific peptidase 28
PA38349	57663	USP29	chr19	57621509	57646294	24785	ubiquitin specific peptidase 29
PA37251	9960	USP3	chr15	63786710	63889839	103129	ubiquitin specific peptidase 3
PA134971149	84749	USP30	chr12	109480380	109528831	48451	ubiquitin specific peptidase 30
PA164742780	57478	USP31	chr16	23069727	23170591	100864	ubiquitin specific peptidase 31
PA134982542	84669	USP32	chr17	58251551	58479586	228035	ubiquitin specific peptidase 32
PA134955343	23032	USP33	chr1	78158672	78235564	76892	ubiquitin specific peptidase 33
PA134897042	9736	USP34	chr2	61411590	61707868	296278	ubiquitin specific peptidase 34
PA134883706	57558	USP35	chr11	77889858	77928757	38899	ubiquitin specific peptidase 35
PA134949090	57602	USP36	chr17	76780463	76846980	66517	ubiquitin specific peptidase 36
PA134928706	57695	USP37	chr2	219311974	219443084	131110	ubiquitin specific peptidase 37
PA134880611	84640	USP38	chr4	144096070	144146141	50071	ubiquitin specific peptidase 38
PA134905136	10713	USP39	chr2	85819965	85879407	59442	ubiquitin specific peptidase 39
PA37252	7375	USP4	chr3	49311577	49387536	75959	ubiquitin specific peptidase 4 (proto-oncogene)
PA134909324	55230	USP40	chr2	234381165	234485433	104268	ubiquitin specific peptidase 40
PA134876613	373856	USP41	chr22	20702059	20752433	50374	ubiquitin specific peptidase 41
PA134902515	84132	USP42	chr7	6134550	6204195	69645	ubiquitin specific peptidase 42
PA134865304	124739	USP43	chr17	9538015	9636004	97989	ubiquitin specific peptidase 43
PA134931457	84101	USP44	chr12	95907336	95955278	47942	ubiquitin specific peptidase 44
PA134889604	85015	USP45	chr6	99877182	99973565	96383	ubiquitin specific peptidase 45
PA134922048	64854	USP46	chr4	53454126	53535502	81376	ubiquitin specific peptidase 46
PA134880952	55031	USP47	chr11	11852970	11983872	130902	ubiquitin specific peptidase 47
PA134947522	84196	USP48	chr1	22001791	22119688	117897	ubiquitin specific peptidase 48
PA134954570	25862	USP49	chr6	41754634	41873099	118465	ubiquitin specific peptidase 49
PA37253	8078	USP5	chr12	6951285	6978796	27511	ubiquitin specific peptidase 5 (isopeptidase T)
PA134916583	373509	USP50	chr15	50789759	50848902	59143	ubiquitin specific peptidase 50
PA134888611	158880	USP51	chrX	55508049	55526301	18252	ubiquitin specific peptidase 51
PA134940368	54532	USP53	chr4	120123775	120219673	95898	ubiquitin specific peptidase 53
PA134959960	159195	USP54	chr10	75254296	75345433	91137	ubiquitin specific peptidase 54
PA37254	9098	USP6	chr17	5021687	5081327	59640	ubiquitin specific peptidase 6
PA134955568	9712	USP6NL	chr10	11499509	11663679	164170	USP6 N-terminal like
PA37255	7874	USP7	chr16	8982951	9067341	84390	ubiquitin specific peptidase 7 (herpes virus-associated)
PA37256	9101	USP8	chr15	50706579	50796280	89701	ubiquitin specific peptidase 8
PA37257	8239	USP9X	chrX	40934727	41098832	164105	ubiquitin specific peptidase 9, X-linked
PA37258	8287	USP9Y	chrY	14803160	14975768	172608	ubiquitin specific peptidase 9, Y-linked
PA134872379	10208	USPL1	chr13	31181830	31236687	54857	ubiquitin specific peptidase like 1
PA38213	10090	UST	chr6	149058063	149401126	343063	uronyl-2-sulfotransferase
PA37259	8433	UTF1	chr10	135033778	135048062	14284	undifferentiated embryonic cell transcription factor 1
PA142670630	51118	UTP11L	chr1	38468384	38493497	25113	UTP11-like, U3 small nucleolar ribonucleoprotein (yeast)
PA35595	10813	UTP14A	chrX	129030097	129066738	36641	UTP14, U3 small nucleolar ribonucleoprotein, homolog A (yeast)
PA134944828	9724	UTP14C	chr13	52588827	52610736	21909	UTP14, U3 small nucleolar ribonucleoprotein, homolog C (yeast)
PA142670631	84135	UTP15	chr5	72851568	72881984	30416	UTP15, U3 small nucleolar ribonucleoprotein, homolog (S. cerevisiae)
PA134984104	51096	UTP18	chr17	49327897	49378294	50397	UTP18 small subunit (SSU) processome component homolog (yeast)
PA143485666	27340	UTP20	chr12	101663905	101783397	119492	UTP20, small subunit (SSU) processome component, homolog (yeast)
PA162408778	84294	UTP23	chr8	117768742	117795449	26707	UTP23, small subunit (SSU) processome component, homolog (yeast)
PA162408779	57050	UTP3	chr4	71544196	71559268	15072	UTP3, small subunit (SSU) processome component, homolog (S. cerevisiae)
PA142672224	55813	UTP6	chr17	30187190	30238729	51539	UTP6, small subunit (SSU) processome component, homolog (yeast)
PA37260	7402	UTRN	chr6	144596434	145177170	580736	utrophin
PA37261	10911	UTS2	chr1	7904672	7923551	18879	urotensin 2
PA142670632	257313	UTS2B	chr3	190981944	191058325	76381	urotensin 2B
PA28857	2837	UTS2R	chr17	80320647	80336528	15881	urotensin 2 receptor
PA37263	7404	UTY	chrY	15357259	15602550	245291	ubiquitously transcribed tetratricopeptide repeat containing, Y-linked
PA37264	7405	UVRAG	chr11	75516212	75858282	342070	UV radiation resistance associated
PA162393105	57654	UVSSA	chr4	1331043	1384837	53794	UV-stimulated scaffold protein A
PA38465	80146	UXS1	chr2	106706759	106820795	114036	UDP-glucuronate decarboxylase 1
PA37265	8409	UXT	chrX	47508191	47528579	20388	ubiquitously-expressed, prefoldin-like chaperone
PA142670633	55697	VAC14	chr16	70718342	70845074	126732	Vac14 homolog (S. cerevisiae)
PA37266	6843	VAMP1	chr12	6568403	6589843	21440	vesicle-associated membrane protein 1 (synaptobrevin 1)
PA37267	6844	VAMP2	chr17	8059465	8076293	16828	vesicle-associated membrane protein 2 (synaptobrevin 2)
PA37268	9341	VAMP3	chr1	7821329	7844492	23163	vesicle-associated membrane protein 3
PA37269	8674	VAMP4	chr1	171666296	171721379	55083	vesicle-associated membrane protein 4
PA37270	10791	VAMP5	chr2	85801531	85823511	21980	vesicle-associated membrane protein 5
PA162408786	6845	VAMP7	chrY	59203949	59279439	75490	vesicle-associated membrane protein 7
PA37271	8673	VAMP8	chr2	85794614	85812156	17542	vesicle-associated membrane protein 8
PA37971	81839	VANGL1	chr1	116174574	116243845	69271	VANGL planar cell polarity protein 1
PA37970	57216	VANGL2	chr1	160360364	160401468	41104	VANGL planar cell polarity protein 2
PA37272	9218	VAPA	chr18	9903955	9963018	59063	VAMP (vesicle-associated membrane protein)-associated protein A, 33kDa
PA37273	9217	VAPB	chr20	56954175	57029157	74982	VAMP (vesicle-associated membrane protein)-associated protein B and C
PA37275	7407	VARS	chr6	31742295	31773712	31417	valyl-tRNA synthetase
PA164742816	57176	VARS2	chr6	30871982	30897236	25254	valyl-tRNA synthetase 2, mitochondrial
PA134941450	22846	VASH1	chr14	77218235	77252363	34128	vasohibin 1
PA145147736	79805	VASH2	chr1	213113887	213167986	54099	vasohibin 2
PA134974883	114990	VASN	chr16	4411849	4436529	24680	vasorin
PA37276	7408	VASP	chr19	46000688	46033247	32559	vasodilator-stimulated phosphoprotein
PA38422	10493	VAT1	chr17	41163622	41184459	20837	vesicle amine transport 1
PA164727497	57687	VAT1L	chr16	77812483	78017001	204518	vesicle amine transport 1-like
PA37280	7409	VAV1	chr19	6762679	6860377	97698	vav 1 guanine nucleotide exchange factor
PA37281	7410	VAV2	chr9	136624016	136867496	243480	vav 2 guanine nucleotide exchange factor
PA37282	10451	VAV3	chr1	108110782	108517545	406763	vav 3 guanine nucleotide exchange factor
PA37283	11023	VAX1	chr10	118885032	118907812	22780	ventral anterior homeobox 1
PA37284	25806	VAX2	chr2	71117720	71163576	45856	ventral anterior homeobox 2
PA37285	7411	VBP1	chrX	154415290	154471098	55808	von Hippel-Lindau binding protein 1
PA37286	7412	VCAM1	chr1	101175196	101207601	32405	vascular cell adhesion molecule 1
PA162408788	1462	VCAN	chr5	82757493	82881122	123629	versican
PA37288	7414	VCL	chr10	75747836	75882918	135082	vinculin
PA37289	7415	VCP	chr9	35053065	35082739	29674	valosin containing protein
PA142670629	80124	VCPIP1	chr8	67539488	67589452	49964	valosin containing protein (p97)/p47 complex interacting protein 1
PA134866014	79609	VCPKMT	chr14	50572350	50593297	20947	valosin containing protein lysine (K) methyltransferase
PA37290	26609	VCX	chrX	7800303	7815184	14881	variable charge, X-linked
PA134891971	51480	VCX2	chrX	8134985	8149308	14323	variable charge, X-linked 2
PA134936169	51481	VCX3A	chrX	6448659	6463159	14500	variable charge, X-linked 3A
PA134866686	425054	VCX3B	chrX	8422871	8437551	14680	variable charge, X-linked 3B
PA37291	9084	VCY	chrY	16094652	16108392	13740	variable charge, Y-linked
PA134979097	353513	VCY1B	chrY	16158102	16171838	13736	variable charge, Y-linked 1B
PA37292	7416	VDAC1	chr5	133304566	133351300	46734	voltage-dependent anion channel 1
PA37298	7418	VDAC1P4	chr1	180393931	180408937	15006	voltage-dependent anion channel 1 pseudogene 4
PA37295	7417	VDAC2	chr10	76959912	76994206	34294	voltage-dependent anion channel 2
PA37297	7419	VDAC3	chr8	42239279	42266455	27176	voltage-dependent anion channel 3
PA37301	7421	VDR	chr12	48232320	48308814	76494	vitamin D (1,25- dihydroxyvitamin D3) receptor
PA37302	7422	VEGFA	chr6	43727946	43757224	29278	vascular endothelial growth factor A
PA37303	7423	VEGFB	chr11	63992056	64009736	17680	vascular endothelial growth factor B
PA37304	7424	VEGFC	chr4	177601689	177723899	122210	vascular endothelial growth factor C
PA37803	27287	VENTX	chr10	135041408	135058433	17025	VENT homeobox
PA134952229	79674	VEPH1	chr3	156974531	157231415	256884	ventricular zone expressed PH domain-containing 1
PA162408823	7716	VEZF1	chr17	56045908	56075615	29707	vascular endothelial zinc finger 1
PA143485667	55591	VEZT	chr12	95601522	95699566	98044	vezatin, adherens junctions transmembrane protein
PA37305	7425	VGF	chr7	100802790	100820862	18072	VGF nerve growth factor inducible
PA134923162	51442	VGLL1	chrX	135604311	135641966	37655	vestigial-like family member 1
PA134881890	245806	VGLL2	chr6	117576721	117597728	21007	vestigial-like family member 2
PA142670628	389136	VGLL3	chr3	86984123	87050412	66289	vestigial-like family member 3
PA128394553	9686	VGLL4	chr3	11594543	11772220	177677	vestigial-like family member 4
PA37307	7428	VHL	chr3	10173319	10198354	25035	von Hippel-Lindau tumor suppressor, E3 ubiquitin protein ligase
PA37309	7429	VIL1	chr2	219273838	219317248	43410	villin 1
PA134911684	50853	VILL	chr3	38022217	38051676	29459	villin-like
PA37311	7431	VIM	chr10	17259934	17282592	22658	vimentin
PA37312	7432	VIP	chr6	153061932	153083900	21968	vasoactive intestinal peptide
PA165479332	63894	VIPAS39	chr14	77890018	77933983	43965	VPS33B interacting protein, apical-basolateral polarity regulator, spe-39 homolog
PA37313	7433	VIPR1	chr3	42520791	42582065	61274	vasoactive intestinal peptide receptor 1
PA37314	7434	VIPR2	chr7	158817866	158947649	129783	vasoactive intestinal peptide receptor 2
PA37316	5212	VIT	chr2	36913833	37044937	131104	vitrin
PA133787052	79001	VKORC1	chr16	31099175	31116699	17524	vitamin K epoxide reductase complex, subunit 1
PA134931578	154807	VKORC1L1	chr7	65328257	65427545	99288	vitamin K epoxide reductase complex, subunit 1-like 1
PA37317	7436	VLDLR	chr9	2611679	2657485	45806	very low density lipoprotein receptor
PA164727498	203547	VMA21	chrX	150555657	150580836	25179	VMA21 vacuolar H+-ATPase homolog (S. cerevisiae)
PA165394584	400673	VMAC	chr19	5894852	5913263	18411	vimentin-type intermediate filament associated coiled-coil protein
PA142670619	284013	VMO1	chr17	4685580	4699729	14149	vitelline membrane outer layer 1 homolog (chicken)
PA142670765	81671	VMP1	chr17	57774553	57922610	148057	vacuole membrane protein 1
PA134957891	57191	VN1R1	chr19	57963542	57978107	14565	vomeronasal 1 receptor 1
PA134969616	317701	VN1R2	chr19	53751545	53765855	14310	vomeronasal 1 receptor 2
PA134985458	317703	VN1R4	chr19	53767013	53780918	13905	vomeronasal 1 receptor 4
PA142672202	344760	VN2R1P	chr3	155741371	155758436	17065	vomeronasal 2 receptor 1 pseudogene
PA37321	8876	VNN1	chr6	132998997	133045194	46197	vanin 1
PA37322	8875	VNN2	chr6	133062009	133094598	32589	vanin 2
PA165618503	81552	VOPP1	chr7	55535303	55650200	114897	vesicular, overexpressed in cancer, prosurvival protein 1
PA142670621	9730	VPRBP	chr3	51430298	51544018	113720	Vpr (HIV-1) binding protein
PA37324	7441	VPREB1	chr22	22589200	22602926	13726	pre-B lymphocyte 1
PA37325	29802	VPREB3	chr22	24091930	24106630	14700	pre-B lymphocyte 3
PA37902	55823	VPS11	chr11	118928493	118955688	27195	vacuolar protein sorting 11 homolog (S. cerevisiae)
PA26444	23230	VPS13A	chr9	79782269	80035399	253130	vacuolar protein sorting 13 homolog A (S. cerevisiae)
PA26699	157680	VPS13B	chr8	100015299	100893447	878148	vacuolar protein sorting 13 homolog B (yeast)
PA134990089	54832	VPS13C	chr15	62141588	62362664	221076	vacuolar protein sorting 13 homolog C (S. cerevisiae)
PA134970144	55187	VPS13D	chr1	12280101	12575099	294998	vacuolar protein sorting 13 homolog D (S. cerevisiae)
PA37903	64601	VPS16	chr20	2811373	2850378	39005	vacuolar protein sorting 16 homolog (S. cerevisiae)
PA38069	57617	VPS18	chr15	41176628	41199173	22545	vacuolar protein sorting 18 homolog (S. cerevisiae)
PA142670614	84313	VPS25	chr17	40915454	40934618	19164	vacuolar protein sorting 25 homolog (S. cerevisiae)
PA37326	9559	VPS26A	chr10	70873908	70935617	61709	vacuolar protein sorting 26 homolog A (S. pombe)
PA128394747	112936	VPS26B	chr11	134084561	134120686	36125	vacuolar protein sorting 26 homolog B (S. pombe)
PA38512	51160	VPS28	chr8	145645984	145663946	17962	vacuolar protein sorting 28 homolog (S. cerevisiae)
PA37875	51699	VPS29	chr12	110926330	110949916	23586	vacuolar protein sorting 29 homolog (S. cerevisiae)
PA38306	65082	VPS33A	chr12	122711111	122761068	49957	vacuolar protein sorting 33 homolog A (S. cerevisiae)
PA37327	26276	VPS33B	chr15	91538774	91575833	37059	vacuolar protein sorting 33 homolog B (yeast)
PA37783	55737	VPS35	chr16	46690589	46733144	42555	vacuolar protein sorting 35 homolog (S. cerevisiae)
PA134990943	51028	VPS36	chr13	52983737	53034798	51061	vacuolar protein sorting 36 homolog (S. cerevisiae)
PA142670615	137492	VPS37A	chr8	17094401	17158533	64132	vacuolar protein sorting 37 homolog A (S. cerevisiae)
PA142670616	79720	VPS37B	chr12	123346875	123390712	43837	vacuolar protein sorting 37 homolog B (S. cerevisiae)
PA142670617	55048	VPS37C	chr11	60894728	60938916	44188	vacuolar protein sorting 37 homolog C (S. cerevisiae)
PA38308	155382	VPS37D	chr7	73072174	73089440	17266	vacuolar protein sorting 37 homolog D (S. cerevisiae)
PA134945163	23339	VPS39	chr15	42447899	42510524	62625	vacuolar protein sorting 39 homolog (S. cerevisiae)
PA37328	27072	VPS41	chr7	38760543	38958800	198257	vacuolar protein sorting 41 homolog (S. cerevisiae)
PA37901	11311	VPS45	chr1	150029350	150120505	91155	vacuolar protein sorting 45 homolog (S. cerevisiae)
PA38362	27183	VPS4A	chr16	69335242	69361951	26709	vacuolar protein sorting 4 homolog A (S. cerevisiae)
PA35795	9525	VPS4B	chr18	61053423	61099752	46329	vacuolar protein sorting 4 homolog B (S. cerevisiae)
PA25485	738	VPS51	chr11	64853587	64882332	28745	vacuolar protein sorting 51 homolog (S. cerevisiae)
PA34926	6293	VPS52	chr6	33215049	33249723	34674	vacuolar protein sorting 52 homolog (S. cerevisiae)
PA142670618	55275	VPS53	chr17	408908	628096	219188	vacuolar protein sorting 53 homolog (S. cerevisiae)
PA134920394	51542	VPS54	chr2	64116280	64256526	140246	vacuolar protein sorting 54 homolog (S. cerevisiae)
PA36396	6944	VPS72	chr1	151145776	151172689	26913	vacuolar protein sorting 72 homolog (S. cerevisiae)
PA142671617	23355	VPS8	chr3	184519925	184773402	253477	vacuolar protein sorting 8 homolog (S. cerevisiae)
PA25562	9605	VPS9D1	chr16	89770541	89797398	26857	VPS9 domain containing 1
PA37330	7443	VRK1	chr14	97253684	97350951	97267	vaccinia related kinase 1
PA37331	7444	VRK2	chr2	58263777	58390055	126278	vaccinia related kinase 2
PA134923990	51231	VRK3	chr19	50476724	50539274	62550	vaccinia related kinase 3
PA134899928	55237	VRTN	chr14	74805166	74829711	24545	vertebrae development associated
PA134944198	340547	VSIG1	chrX	107278160	107325414	47254	V-set and immunoglobulin domain containing 1
PA165513585	54621	VSIG10	chr12	118498398	118551810	53412	V-set and immunoglobulin domain containing 10
PA165394673	147645	VSIG10L	chr19	51831795	51855378	23583	V-set and immunoglobulin domain containing 10 like
PA134937463	23584	VSIG2	chr11	124614370	124632109	17739	V-set and immunoglobulin domain containing 2
PA134986421	11326	VSIG4	chrX	65238580	65269967	31387	V-set and immunoglobulin domain containing 4
PA142670610	391123	VSIG8	chr1	159821106	159842447	21341	V-set and immunoglobulin domain containing 8
PA37333	7447	VSNL1	chr2	17711807	17840706	128899	visinin-like 1
PA147357166	284415	VSTM1	chr19	54541079	54577207	36128	V-set and transmembrane domain containing 1
PA162408875	222008	VSTM2A	chr7	54600019	54639948	39929	V-set and transmembrane domain containing 2A
PA162408890	342865	VSTM2B	chr19	30007491	30058458	50967	V-set and transmembrane domain containing 2B
PA162408904	128434	VSTM2L	chr20	36521499	36576752	55253	V-set and transmembrane domain containing 2 like
PA134889917	196740	VSTM4	chr10	50219333	50333559	114226	V-set and transmembrane domain containing 4
PA164716741	387804	VSTM5	chr11	93550735	93593668	42933	V-set and transmembrane domain containing 5
PA37334	30813	VSX1	chr20	25048521	25073015	24494	visual system homeobox 1
PA26511	338917	VSX2	chr14	74696175	74732441	36266	visual system homeobox 2
PA162408932	51534	VTA1	chr6	142458372	142545085	86713	vesicle (multivesicular body) trafficking 1
PA142670611	79679	VTCN1	chr1	117683209	117763582	80373	V-set domain containing T cell activation inhibitor 1
PA134928049	143187	VTI1A	chr10	114196756	114581503	384747	vesicle transport through interaction with t-SNAREs 1A
PA134861090	10490	VTI1B	chr14	68110621	68151700	41079	vesicle transport through interaction with t-SNAREs 1B
PA37335	7448	VTN	chr17	26691298	26707373	16075	vitronectin
PA142670612	64856	VWA1	chr1	1360903	1381262	20359	von Willebrand factor A domain containing 1
PA142670613	340706	VWA2	chr10	115989013	116057259	68246	von Willebrand factor A domain containing 2
PA162408933	146177	VWA3A	chr16	22009462	22171287	161825	von Willebrand factor A domain containing 3A
PA162409004	200403	VWA3B	chr2	98693595	98932410	238815	von Willebrand factor A domain containing 3B
PA162409005	4013	VWA5A	chr11	123976111	124020619	44508	von Willebrand factor A domain containing 5A
PA162409030	127731	VWA5B1	chr1	20607412	20684662	77250	von Willebrand factor A domain containing 5B1
PA162409079	90113	VWA5B2	chr3	183938317	183963117	24800	von Willebrand factor A domain containing 5B2
PA25928	80737	VWA7	chr6	31730178	31755108	24930	von Willebrand factor A domain containing 7
PA162392941	23078	VWA8	chr13	42137961	42545221	407260	von Willebrand factor A domain containing 8
PA142672279	81556	VWA9	chr15	65868095	65913627	45532	von Willebrand factor A domain containing 9
PA147357154	375567	VWC2	chr7	49803257	49964546	161289	von Willebrand factor C domain containing 2
PA165697841	402117	VWC2L	chr2	215266292	215443774	177482	von Willebrand factor C domain containing protein 2-like
PA143485669	220001	VWCE	chr11	61022758	61072788	50030	von Willebrand factor C and EGF domains
PA164727503	221806	VWDE	chr7	12367509	12453852	86343	von Willebrand factor D and EGF domains
PA37337	7450	VWF	chr12	6055040	6243836	188796	von Willebrand factor
PA134978936	51322	WAC	chr10	28811355	28915041	103686	WW domain containing adaptor with coiled-coil
PA134872402	23063	WAPAL	chr10	88192013	88291541	99528	wings apart-like homolog (Drosophila)
PA37340	7453	WARS	chr14	100797125	100852680	55555	tryptophanyl-tRNA synthetase
PA37341	10352	WARS2	chr1	119570839	119693404	122565	tryptophanyl tRNA synthetase 2, mitochondrial
PA37342	7454	WAS	chrX	48532186	48552818	20632	Wiskott-Aldrich syndrome
PA37343	8936	WASF1	chr6	110418022	110511219	93197	WAS protein family, member 1
PA37344	10163	WASF2	chr1	27727734	27826678	98944	WAS protein family, member 2
PA37345	10810	WASF3	chr13	27121840	27266082	144242	WAS protein family, member 3
PA162409121	100287171	WASH1	chr9	11469	39739	28270	WAS protein family homolog 1
PA142671893	653440	WASH6P	chrX	155241323	155258337	17014	WAS protein family homolog 6 pseudogene
PA37346	8976	WASL	chr7	123318981	123399125	80144	Wiskott-Aldrich syndrome-like
PA37348	23559	WBP1	chr2	74674996	74691018	16022	WW domain binding protein 1
PA38144	51729	WBP11	chr12	14934513	14966420	31907	WW domain binding protein 11
PA128394674	54838	WBP1L	chr10	104493727	104579022	85295	WW domain binding protein 1-like
PA37349	23558	WBP2	chr17	73838780	73861501	22721	WW domain binding protein 2
PA145147710	164684	WBP2NL	chr22	42381607	42431935	50328	WBP2 N-terminal like
PA37350	11193	WBP4	chr13	41624973	41661142	36169	WW domain binding protein 4
PA134921975	51186	WBP5	chrX	102601380	102616397	15017	WW domain binding protein 5
PA37941	81554	WBSCR16	chr7	74438223	74499717	61494	Williams-Beuren syndrome chromosome region 16
PA38124	64409	WBSCR17	chr7	70587523	71181586	594063	Williams-Beuren syndrome chromosome region 17
PA38133	114049	WBSCR22	chr7	73087898	73115551	27653	Williams Beuren syndrome chromosome region 22
PA134905115	155368	WBSCR27	chr7	73245920	73266855	20935	Williams Beuren syndrome chromosome region 27
PA145147726	135886	WBSCR28	chr7	73265489	73283223	17734	Williams-Beuren syndrome chromosome region 28
PA134929936	57590	WDFY1	chr2	224737065	224820104	83039	WD repeat and FYVE domain containing 1
PA134870231	115825	WDFY2	chr13	52148484	52343935	195451	WD repeat and FYVE domain containing 2
PA134903706	23001	WDFY3	chr4	85587690	85897544	309854	WD repeat and FYVE domain containing 3
PA165664370	404201	WDFY3-AS2	chr4	85877895	85932896	55001	WDFY3 antisense RNA 2
PA134967634	57705	WDFY4	chr10	49882907	50194001	311094	WDFY family member 4
PA134988782	11169	WDHD1	chr14	55402656	55503819	101163	WD repeat and HMG-box DNA binding protein 1
PA164717186	51057	WDPCP	chr2	63345518	63825867	480349	WD repeat containing planar cell polarity effector
PA37358	9948	WDR1	chr4	10072963	10128612	55649	WD repeat domain 1
PA37818	55717	WDR11	chr10	122600687	122672038	71351	WD repeat domain 11
PA37841	55759	WDR12	chr2	203742323	203786949	44626	WD repeat domain 12
PA37876	64743	WDR13	chrX	48445880	48466582	20702	WD repeat domain 13
PA38181	116966	WDR17	chr4	176976985	177106979	129994	WD repeat domain 17
PA38269	57418	WDR18	chr19	974328	997569	23241	WD repeat domain 18
PA38317	57728	WDR19	chr4	39174024	39290430	116406	WD repeat domain 19
PA134936678	91833	WDR20	chr14	102596189	102693010	96821	WD repeat domain 20
PA134918496	84219	WDR24	chr16	731622	750608	18986	WD repeat domain 24
PA142670607	79446	WDR25	chr14	100832755	100999640	166885	WD repeat domain 25
PA134907873	80232	WDR26	chr1	224569845	224632001	62156	WD repeat domain 26
PA134875091	253769	WDR27	chr6	169854303	170112159	257856	WD repeat domain 27
PA37359	10885	WDR3	chr1	118462372	118506049	43677	WD repeat domain 3
PA134959062	114987	WDR31	chr9	116072502	116112620	40118	WD repeat domain 31
PA134943440	55339	WDR33	chr2	128458808	128578761	119953	WD repeat domain 33
PA134951680	89891	WDR34	chr9	131392940	131429129	36189	WD repeat domain 34
PA134928987	57539	WDR35	chr2	20107024	20199884	92860	WD repeat domain 35
PA134933637	134430	WDR36	chr5	110417870	110469200	51330	WD repeat domain 36
PA134922218	22884	WDR37	chr10	1085423	1181237	95814	WD repeat domain 37
PA162409138	401551	WDR38	chr9	127605627	127623170	17543	WD repeat domain 38
PA37360	10785	WDR4	chr21	44260190	44309699	49509	WD repeat domain 4
PA134906058	55255	WDR41	chr5	76724622	76798332	73710	WD repeat domain 41
PA134914163	23160	WDR43	chr2	29107533	29174080	66547	WD repeat domain 43
PA128394668	54521	WDR44	chrX	117470036	117586924	116888	WD repeat domain 44
PA134927673	11152	WDR45	chrX	48929092	48968059	38967	WD repeat domain 45
PA134894387	56270	WDR45B	chr17	80569438	80616411	46973	WD repeat domain 45B
PA25924	9277	WDR46	chr6	33243682	33267304	23622	WD repeat domain 46
PA134937302	22911	WDR47	chr1	109509835	109594860	85025	WD repeat domain 47
PA134956949	57599	WDR48	chr3	39083477	39141155	57678	WD repeat domain 48
PA134949512	151790	WDR49	chr3	167193289	167381747	188458	WD repeat domain 49
PA37361	11091	WDR5	chr9	136990801	137028094	37293	WD repeat domain 5
PA134948456	348793	WDR53	chr3	196278024	196305627	27603	WD repeat domain 53
PA142670589	84058	WDR54	chr2	74638863	74655882	17019	WD repeat domain 54
PA142670590	54853	WDR55	chr5	140034384	140054930	20546	WD repeat domain 55
PA142670593	79726	WDR59	chr16	74904468	75029026	124558	WD repeat domain 59
PA38248	54554	WDR5B	chr3	122127700	122144882	17182	WD repeat domain 5B
PA37362	11180	WDR6	chr3	49034637	49056386	21749	WD repeat domain 6
PA142670594	55112	WDR60	chr7	158639269	158741883	102614	WD repeat domain 60
PA142670595	80349	WDR61	chr15	78572575	78601977	29402	WD repeat domain 61
PA134963627	284403	WDR62	chr19	36535783	36599012	63229	WD repeat domain 62
PA142670596	126820	WDR63	chr1	85517993	85601821	83828	WD repeat domain 63
PA142670597	128025	WDR64	chr1	241805580	241968435	162855	WD repeat domain 64
PA142670599	144406	WDR66	chr12	122346463	122444839	98376	WD repeat domain 66
PA37784	23335	WDR7	chr18	54308590	54700036	391446	WD repeat domain 7
PA142670603	55100	WDR70	chr5	37369391	37755774	386383	WD repeat domain 70
PA142670587	256764	WDR72	chr15	53802938	54065075	262137	WD repeat domain 72
PA142670588	84942	WDR73	chr15	85182607	85207521	24914	WD repeat domain 73
PA142670578	54663	WDR74	chr11	62597380	62618044	20664	WD repeat domain 74
PA142670579	84128	WDR75	chr2	190296159	190343287	47128	WD repeat domain 75
PA142670580	79968	WDR76	chr15	44109112	44163617	54505	WD repeat domain 76
PA142670581	79084	WDR77	chr1	111979512	112001915	22403	WD repeat domain 77
PA142670582	79819	WDR78	chr1	67275568	67400907	125339	WD repeat domain 78
PA142670584	124997	WDR81	chr17	1609817	1644893	35076	WD repeat domain 81
PA142670585	80335	WDR82	chr3	52285438	52322659	37221	WD repeat domain 82
PA165394765	84292	WDR83	chr19	12767618	12789646	22028	WD repeat domain 83
PA162378666	51398	WDR83OS	chr19	12775881	12790465	14584	WD repeat domain 83 opposite strand
PA145147619	349136	WDR86	chr7	151074536	151117775	43239	WD repeat domain 86
PA145147633	83889	WDR87	chr19	38372213	38407317	35104	WD repeat domain 87
PA162409139	126248	WDR88	chr19	33612949	33670830	57881	WD repeat domain 88
PA134871067	112840	WDR89	chr14	64060757	64118641	57884	WD repeat domain 89
PA145147652	197335	WDR90	chr16	689363	720833	31470	WD repeat domain 90
PA162409166	29062	WDR91	chr7	134865590	134906316	40726	WD repeat domain 91
PA162409167	116143	WDR92	chr2	68354281	68394692	40411	WD repeat domain 92
PA162409188	56964	WDR93	chr15	90224028	90289869	65841	WD repeat domain 93
PA128394761	151525	WDSUB1	chr2	160089304	160153304	64000	WD repeat, sterile alpha motif and U-box domain containing 1
PA134981539	23038	WDTC1	chr1	27551007	27638124	87117	WD and tetratricopeptide repeats 1
PA164727566	55093	WDYHV1	chr8	124418965	124457261	38296	WDYHV motif containing 1
PA366	7465	WEE1	chr11	9585197	9618016	32819	WEE1 G2 checkpoint kinase
PA134909633	494551	WEE2	chr7	141398153	141434071	35918	WEE1 homolog 2 (S. pombe)
PA37963	58189	WFDC1	chr16	84318244	84366450	48206	WAP four-disulfide core domain 1
PA25688	140832	WFDC10A	chr20	44248385	44262831	14446	WAP four-disulfide core domain 10A
PA134935020	280664	WFDC10B	chr20	44310290	44343658	33368	WAP four-disulfide core domain 10B
PA134905167	259239	WFDC11	chr20	44274202	44308878	34676	WAP four-disulfide core domain 11
PA25663	128488	WFDC12	chr20	43749067	43763106	14039	WAP four-disulfide core domain 12
PA25680	164237	WFDC13	chr20	44320655	44340456	19801	WAP four-disulfide core domain 13
PA38059	10406	WFDC2	chr20	44088229	44113172	24943	WAP four-disulfide core domain 2
PA38067	140686	WFDC3	chr20	44399847	44430547	30700	WAP four-disulfide core domain 3
PA134885667	149708	WFDC5	chr20	43735093	43753813	18720	WAP four-disulfide core domain 5
PA25714	140870	WFDC6	chr20	44159836	44178134	18298	WAP four-disulfide core domain 6
PA25713	90199	WFDC8	chr20	44176791	44217989	41198	WAP four-disulfide core domain 8
PA134934414	259240	WFDC9	chr20	44233578	44269907	36329	WAP four-disulfide core domain 9
PA134897686	117166	WFIKKN1	chr16	671012	687116	16104	WAP, follistatin/kazal, immunoglobulin, kunitz and netrin domain containing 1
PA134864812	124857	WFIKKN2	chr17	48902011	48922709	20698	WAP, follistatin/kazal, immunoglobulin, kunitz and netrin domain containing 2
PA37365	7466	WFS1	chr4	6261577	6307992	46415	Wolfram syndrome 1 (wolframin)
PA164727567	123720	WHAMM	chr15	83466959	83506613	39654	WAS protein homolog associated with actin, golgi membranes and microtubules
PA37369	7468	WHSC1	chr4	1863123	1986934	123811	Wolf-Hirschhorn syndrome candidate 1
PA37370	54904	WHSC1L1	chr8	38124217	38249872	125655	Wolf-Hirschhorn syndrome candidate 1-like 1
PA142670574	84305	WIBG	chr12	56292197	56331697	39500	within bgcn homolog (Drosophila)
PA38291	11197	WIF1	chr12	65441404	65525346	83942	WNT inhibitory factor 1
PA162409189	7456	WIPF1	chr2	175421302	175557667	136365	WAS/WASL interacting protein family, member 1
PA162409210	147179	WIPF2	chr17	38365556	38441944	76388	WAS/WASL interacting protein family, member 2
PA162409231	644150	WIPF3	chr7	29836170	29959682	123512	WAS/WASL interacting protein family, member 3
PA142670575	55062	WIPI1	chr17	66414422	66463653	49231	WD repeat domain, phosphoinositide interacting 1
PA142670576	26100	WIPI2	chr7	5219835	5276486	56651	WD repeat domain, phosphoinositide interacting 2
PA37372	8840	WISP1	chr8	134193282	134246933	53651	WNT1 inducible signaling pathway protein 1
PA37373	8839	WISP2	chr20	43333493	43359453	25960	WNT1 inducible signaling pathway protein 2
PA37374	8838	WISP3	chr6	112365278	112393889	28611	WNT1 inducible signaling pathway protein 3
PA162409232	58525	WIZ	chr19	15529318	15570767	41449	widely interspaced zinc finger motifs
PA165752781	79971	WLS	chr1	68561142	68708284	147142	wntless Wnt ligand secretion mediator
PA33782	65125	WNK1	chr12	851759	1023618	171859	WNK lysine deficient protein kinase 1
PA33783	65268	WNK2	chr9	95936437	96085854	149417	WNK lysine deficient protein kinase 2
PA33784	65267	WNK3	chrX	54216256	54394438	178182	WNK lysine deficient protein kinase 3
PA134875400	65266	WNK4	chr17	40922632	40952084	29452	WNK lysine deficient protein kinase 4
PA37376	7471	WNT1	chr12	49362236	49379396	17160	wingless-type MMTV integration site family, member 1
PA37817	80326	WNT10A	chr2	219735255	219761651	26396	wingless-type MMTV integration site family, member 10A
PA37377	7480	WNT10B	chr12	49356123	49375641	19518	wingless-type MMTV integration site family, member 10B
PA37378	7481	WNT11	chr11	75894370	75931803	37433	wingless-type MMTV integration site family, member 11
PA38105	51384	WNT16	chr7	120955421	120984158	28737	wingless-type MMTV integration site family, member 16
PA37381	7472	WNT2	chr7	116913685	116973343	59658	wingless-type MMTV integration site family member 2
PA37382	7482	WNT2B	chr1	113000040	113066910	66870	wingless-type MMTV integration site family, member 2B
PA37383	7473	WNT3	chr17	44836872	44906126	69254	wingless-type MMTV integration site family, member 3
PA38074	89780	WNT3A	chr1	228184723	228251972	67249	wingless-type MMTV integration site family, member 3A
PA37384	54361	WNT4	chr1	22440798	22480474	39676	wingless-type MMTV integration site family, member 4
PA37385	7474	WNT5A	chr3	55496743	55531670	34927	wingless-type MMTV integration site family, member 5A
PA38104	81029	WNT5B	chr12	1673823	1759379	85556	wingless-type MMTV integration site family, member 5B
PA37386	7475	WNT6	chr2	219714546	219741954	27408	wingless-type MMTV integration site family, member 6
PA37387	7476	WNT7A	chr3	13857082	13931618	74536	wingless-type MMTV integration site family, member 7A
PA37388	7477	WNT7B	chr22	46313246	46383008	69762	wingless-type MMTV integration site family, member 7B
PA37389	7478	WNT8A	chr5	137409581	137431337	21756	wingless-type MMTV integration site family, member 8A
PA37390	7479	WNT8B	chr10	102212812	102246399	33587	wingless-type MMTV integration site family, member 8B
PA37379	7483	WNT9A	chr1	228106165	228145676	39511	wingless-type MMTV integration site family, member 9A
PA37380	7484	WNT9B	chr17	44918952	44967096	48144	wingless-type MMTV integration site family, member 9B
PA164727568	55135	WRAP53	chr17	7579389	7609820	30431	WD repeat containing, antisense to TP53
PA37363	49856	WRAP73	chr1	3544331	3576671	32340	WD repeat containing, antisense to TP73
PA37391	7485	WRB	chr21	40742213	40772815	30602	tryptophan rich basic protein
PA367	7486	WRN	chr8	30880778	31034277	153499	Werner syndrome, RecQ helicase-like
PA134982239	56897	WRNIP1	chr6	2755575	2788979	33404	Werner helicase interacting protein 1
PA134867554	26118	WSB1	chr17	25611106	25643659	32553	WD repeat and SOCS box containing 1
PA128395787	55884	WSB2	chr12	118467492	118509979	42487	WD repeat and SOCS box containing 2
PA162409253	23302	WSCD1	chr17	5962426	6030747	68321	WSC domain containing 1
PA162409276	9671	WSCD2	chr12	108513511	108647314	133803	WSC domain containing 2
PA37395	7490	WT1	chr11	32405789	32467104	61315	Wilms tumor 1
PA165543758	51352	WT1-AS	chr11	32447285	32464636	17351	WT1 antisense RNA
PA134864847	9589	WTAP	chr6	160137712	160180351	42639	Wilms tumor 1 associated protein
PA142670568	126374	WTIP	chr19	34962880	34995085	32205	Wilms tumor 1 interacting protein
PA143485670	23286	WWC1	chr5	167709065	167902308	193243	WW and C2 domain containing 1
PA143485671	80014	WWC2	chr4	184010463	184244930	234467	WW and C2 domain containing 2
PA143485672	55841	WWC3	chrX	9973795	10115518	141723	WWC family member 3
PA37398	51741	WWOX	chr16	78123310	79249567	1126257	WW domain containing oxidoreductase
PA134960138	11059	WWP1	chr8	87344965	87483181	138216	WW domain containing E3 ubiquitin protein ligase 1
PA134946925	11060	WWP2	chr16	69786187	69978644	192457	WW domain containing E3 ubiquitin protein ligase 2
PA134899667	25937	WWTR1	chr3	149232022	149431060	199038	WW domain containing transcription regulator 1
PA134905925	56949	XAB2	chr19	7681411	7704439	23028	XPA binding protein 2
PA162409299	54739	XAF1	chr17	6648716	6681966	33250	XIAP associated factor 1
PA162409316	653219	XAGE1A	chrX	52252219	52270363	18144	X antigen family, member 1A
PA145147615	653220	XAGE1B	chrX	52228810	52246954	18144	X antigen family, member 1B
PA145147616	653048	XAGE1C	chrX	52501761	52519905	18144	X antigen family, member 1C
PA28526	9503	XAGE1D	chrX	52525159	52543303	18144	X antigen family, member 1D
PA145147618	653067	XAGE1E	chrX	52538053	52556197	18144	X antigen family, member 1E
PA28527	9502	XAGE2	chrX	52101931	52121826	19895	X antigen family, member 2
PA164727593	728242	XAGE2B	chrX	52103158	52121734	18576	X antigen family, member 2B
PA33376	170626	XAGE3	chrX	52888557	52907119	18562	X antigen family, member 3
PA134961730	170627	XAGE5	chrX	52830366	52850325	19959	X antigen family, member 5
PA37400	7494	XBP1	chr22	29187548	29206560	19012	X-box binding protein 1
PA35575	6375	XCL1	chr1	168535711	168554315	18604	chemokine (C motif) ligand 1
PA35576	6846	XCL2	chr1	168507003	168523235	16232	chemokine (C motif) ligand 2
PA35037	2829	XCR1	chr3	46059291	46078979	19688	chemokine (C motif) receptor 1
PA37404	7498	XDH	chr2	31554188	31647611	93423	xanthine dehydrogenase
PA37405	7499	XG	chrX	2660069	2737541	77472	Xg blood group
PA25361	331	XIAP	chrX	122983662	123050829	67167	X-linked inhibitor of apoptosis, E3 ubiquitin protein ligase
PA162409336	165904	XIRP1	chr3	39221706	39244112	22406	xin actin-binding repeat containing 1
PA162409337	129446	XIRP2	chr2	167734997	168119263	384266	xin actin-binding repeat containing 2
PA37410	7504	XK	chrX	37535133	37594383	59250	X-linked Kx blood group
PA142670562	150165	XKR3	chr22	17261302	17312584	51282	XK, Kell blood group complex subunit-related family, member 3
PA142670563	114786	XKR4	chr8	56005017	56441714	436697	XK, Kell blood group complex subunit-related family, member 4
PA142670564	389610	XKR5	chr8	6663038	6703166	40128	XK, Kell blood group complex subunit-related family, member 5
PA134922549	286046	XKR6	chr8	10750654	11068875	318221	XK, Kell blood group complex subunit-related family, member 6
PA142670565	343702	XKR7	chr20	30545805	30589256	43451	XK, Kell blood group complex subunit-related family, member 7
PA142670566	55113	XKR8	chr1	28276504	28297604	21100	XK, Kell blood group complex subunit-related family, member 8
PA142670567	389668	XKR9	chr8	71571600	71651177	79577	XK, Kell blood group complex subunit-related family, member 9
PA134962569	402415	XKRX	chrX	100165431	100194422	28991	XK, Kell blood group complex subunit-related, X-linked
PA368	7507	XPA	chr9	100434191	100469691	35500	xeroderma pigmentosum, complementation group A
PA37413	7508	XPC	chr3	14183647	14230172	46525	xeroderma pigmentosum, complementation group C
PA37415	7511	XPNPEP1	chr10	111621524	111693311	71787	X-prolyl aminopeptidase (aminopeptidase P) 1, soluble
PA37416	7512	XPNPEP2	chrX	128862946	128906525	43579	X-prolyl aminopeptidase (aminopeptidase P) 2, membrane-bound
PA147357130	63929	XPNPEP3	chr22	41243085	41331823	88738	X-prolyl aminopeptidase (aminopeptidase P) 3, putative
PA37418	7514	XPO1	chr2	61702069	61775440	73371	exportin 1
PA134866468	64328	XPO4	chr13	21348468	21486913	138445	exportin 4
PA134979214	57510	XPO5	chr6	43487068	43553812	66744	exportin 5
PA134989996	23214	XPO6	chr16	28106297	28233281	126984	exportin 6
PA34207	23039	XPO7	chr8	21767180	21867096	99916	exportin 7
PA37419	11260	XPOT	chr12	64788153	64845464	57311	exportin, tRNA
PA37420	9213	XPR1	chr1	180591146	180862415	271269	xenotropic and polytropic retrovirus receptor 1
PA369	7515	XRCC1	chr19	44044464	44089730	45266	X-ray repair complementing defective repair in Chinese hamster cells 1
PA37421	7516	XRCC2	chr7	152340583	152383250	42667	X-ray repair complementing defective repair in Chinese hamster cells 2
PA37422	7517	XRCC3	chr14	104160945	104191823	30878	X-ray repair complementing defective repair in Chinese hamster cells 3
PA37423	7518	XRCC4	chr5	82363317	82652579	289262	X-ray repair complementing defective repair in Chinese hamster cells 4
PA37425	7520	XRCC5	chr2	216962381	217074016	111635	X-ray repair complementing defective repair in Chinese hamster cells 5 (double-strand-break rejoining)
PA28467	2547	XRCC6	chr22	42007250	42063052	55802	X-ray repair complementing defective repair in Chinese hamster cells 6
PA142670557	91419	XRCC6BP1	chr12	58325324	58354052	28728	XRCC6 binding protein 1
PA134878471	54464	XRN1	chr3	142022449	142176904	154455	5'-3' exoribonuclease 1
PA37427	22803	XRN2	chr20	21273942	21373463	99521	5'-3' exoribonuclease 2
PA134988069	143570	XRRA1	chr11	74547655	74670232	122577	X-ray radiation resistance associated 1
PA134925222	152002	XXYLT1	chr3	194786008	195001895	215887	xyloside xylosyltransferase 1
PA37430	9942	XYLB	chr3	38378251	38459467	81216	xylulokinase homolog (H. influenzae)
PA37973	64131	XYLT1	chr16	17193181	17574738	381557	xylosyltransferase I
PA37974	64132	XYLT2	chr17	48413393	48443512	30119	xylosyltransferase II
PA134961882	57002	YAE1D1	chr7	39595984	39654681	58697	Yae1 domain containing 1
PA38236	10138	YAF2	chr12	42547906	42642154	94248	YY1 associated factor 2
PA38103	10413	YAP1	chr11	101971151	102107154	136003	Yes-associated protein 1
PA37431	8565	YARS	chr1	33237840	33293633	55793	tyrosyl-tRNA synthetase
PA142670559	51067	YARS2	chr12	32875195	32918895	43700	tyrosyl-tRNA synthetase 2, mitochondrial
PA25852	54059	YBEY	chr21	47696250	47736020	39770	ybeY metallopeptidase (putative)
PA31791	4904	YBX1	chr1	43138060	43171024	32964	Y box binding protein 1
PA142670560	51087	YBX2	chr17	7188571	7207876	19305	Y box binding protein 2
PA26929	8531	YBX3	chr12	10848676	10886047	37371	Y box binding protein 3
PA162409362	150223	YDJC	chr22	21979378	22009017	29639	YdjC homolog (bacterial)
PA134922615	55689	YEATS2	chr3	183405587	183533413	127826	YEATS domain containing 2
PA134992686	8089	YEATS4	chr12	69743490	69787576	44086	YEATS domain containing 4
PA37432	7525	YES1	chr18	718592	822327	103735	YES proto-oncogene 1, Src family tyrosine kinase
PA134985105	10897	YIF1A	chr11	66049051	66066638	17587	Yip1 interacting factor homolog A (S. cerevisiae)
PA142670561	90522	YIF1B	chr19	38791200	38816615	25415	Yip1 interacting factor homolog B (S. cerevisiae)
PA142670555	54432	YIPF1	chr1	54314392	54365487	51095	Yip1 domain family, member 1
PA142670556	78992	YIPF2	chr19	11030444	11049357	18913	Yip1 domain family, member 2
PA134946615	25844	YIPF3	chr6	43476565	43494728	18163	Yip1 domain family, member 3
PA142670547	84272	YIPF4	chr2	32492958	32536074	43116	Yip1 domain family, member 4
PA142670548	81555	YIPF5	chr5	143534723	143560278	25555	Yip1 domain family, member 5
PA142670549	286451	YIPF6	chrX	67708624	67760127	51503	Yip1 domain family, member 6
PA142670550	285525	YIPF7	chr4	44621354	44663658	42304	Yip1 domain family, member 7
PA164727608	374887	YJEFN3	chr19	19629670	19651393	21723	YjeF N-terminal domain containing 3
PA145007308	10652	YKT6	chr7	44230577	44256893	26316	YKT6 v-SNARE homolog (S. cerevisiae)
PA134962086	56252	YLPM1	chr14	75220025	75307013	86988	YLP motif containing 1
PA37434	10730	YME1L1	chr10	27396040	27453349	57309	YME1-like 1 ATPase
PA142670552	55432	YOD1	chr1	207214194	207236325	22131	YOD1 deubiquitinase
PA37436	29799	YPEL1	chr22	22048825	22100071	51246	yippee-like 1 (Drosophila)
PA134978522	388403	YPEL2	chr17	57399053	57482095	83042	yippee-like 2 (Drosophila)
PA134985092	83719	YPEL3	chr16	30100635	30118248	17613	yippee-like 3 (Drosophila)
PA134991609	219539	YPEL4	chr11	57409560	57427417	17857	yippee-like 4 (Drosophila)
PA134863727	51646	YPEL5	chr2	30359750	30386399	26649	yippee-like 5 (Drosophila)
PA142670553	79693	YRDC	chr1	38265614	38283865	18251	yrdC N(6)-threonylcarbamoyltransferase domain containing
PA143485673	91746	YTHDC1	chr4	69173105	69225824	52719	YTH domain containing 1
PA134912676	64848	YTHDC2	chr5	112839391	112933984	94593	YTH domain containing 2
PA25737	54915	YTHDF1	chr20	61823781	61857538	33757	YTH N(6)-methyladenosine RNA binding protein 1
PA134964518	51441	YTHDF2	chr1	29053133	29099287	46154	YTH N(6)-methyladenosine RNA binding protein 2
PA134976395	253943	YTHDF3	chr8	64071112	64128346	57234	YTH N(6)-methyladenosine RNA binding protein 3
PA37438	7529	YWHAB	chr20	43504240	43540173	35933	tyrosine 3-monooxygenase/tryptophan 5-monooxygenase activation protein, beta
PA37440	7531	YWHAE	chr17	1244833	1313669	68836	tyrosine 3-monooxygenase/tryptophan 5-monooxygenase activation protein, epsilon
PA37441	7532	YWHAG	chr7	75953108	75998342	45234	tyrosine 3-monooxygenase/tryptophan 5-monooxygenase activation protein, gamma
PA37442	7533	YWHAH	chr22	32330479	32356590	26111	tyrosine 3-monooxygenase/tryptophan 5-monooxygenase activation protein, eta
PA37443	10971	YWHAQ	chr2	9721096	9781184	60088	tyrosine 3-monooxygenase/tryptophan 5-monooxygenase activation protein, theta
PA37444	7534	YWHAZ	chr8	101927804	101975717	47913	tyrosine 3-monooxygenase/tryptophan 5-monooxygenase activation protein, zeta
PA37445	7528	YY1	chr14	100695102	100748371	53269	YY1 transcription factor
PA142670546	55249	YY1AP1	chr1	155626233	155668823	42590	YY1 associated protein 1
PA134976542	404281	YY2	chrX	21864105	21879845	15740	YY2 transcription factor
PA162409377	353174	ZACN	chr17	74065263	74081885	16622	zinc activated ligand-gated ion channel
PA134951623	284273	ZADH2	chr18	72906278	72931281	25003	zinc binding alcohol dehydrogenase domain containing 2
PA37446	7455	ZAN	chr7	100321249	100398419	77170	zonadhesin (gene/pseudogene)
PA37447	7535	ZAP70	chr2	98320031	98359990	39959	zeta-chain (TCR) associated protein kinase 70kDa
PA134938240	326340	ZAR1	chr4	48482269	48499406	17137	zygote arrest 1
PA165505636	646799	ZAR1L	chr13	32874908	32896091	21183	zygote arrest 1-like
PA162409400	79740	ZBBX	chr3	166955075	167108193	153118	zinc finger, B-box domain containing
PA24753	9189	ZBED1	chrY	2351455	2379008	27553	zinc finger, BED-type containing 1
PA134879520	79413	ZBED2	chr3	111308747	111324182	15435	zinc finger, BED-type containing 2
PA134974972	84327	ZBED3	chr5	76369532	76393030	23498	zinc finger, BED-type containing 3
PA134948378	9889	ZBED4	chr22	50237497	50286726	49229	zinc finger, BED-type containing 4
PA147357120	58486	ZBED5	chr11	10871251	10889620	18369	zinc finger, BED-type containing 5
PA165752811	100381270	ZBED6	chr1	203756651	203772590	15939	zinc finger, BED-type containing 6
PA134942566	113763	ZBED6CL	chr7	150016938	150032810	15872	ZBED6 C-terminal like
PA164717348	63920	ZBED8	chr5	159817155	159837060	19905	zinc finger, BED-type containing 8
PA162402460	114821	ZBED9	chr6	28536407	28565112	28705	zinc finger, BED-type containing 9
PA38094	81030	ZBP1	chr20	56175902	56205632	29730	Z-DNA binding protein 1
PA128395769	22890	ZBTB1	chr14	64961292	65003408	42116	zinc finger and BTB domain containing 1
PA134883318	65986	ZBTB10	chr8	81387854	81441500	53646	zinc finger and BTB domain containing 10
PA134907354	27107	ZBTB11	chr3	101365283	101405988	40705	zinc finger and BTB domain containing 11
PA38784	221527	ZBTB12	chr6	31864394	31879769	15375	zinc finger and BTB domain containing 12
PA37449	7541	ZBTB14	chr18	5286018	5307052	21034	zinc finger and BTB domain containing 14
PA37517	7704	ZBTB16	chr11	113920289	114129702	209413	zinc finger and BTB domain containing 16
PA37522	7709	ZBTB17	chr1	16265364	16312627	47263	zinc finger and BTB domain containing 17
PA37608	10472	ZBTB18	chr1	244202241	244223778	21537	zinc finger and BTB domain containing 18
PA134949885	57621	ZBTB2	chr6	151682250	151722677	40427	zinc finger and BTB domain containing 2
PA37789	26137	ZBTB20	chr3	114030348	114876132	845784	zinc finger and BTB domain containing 20
PA37659	49854	ZBTB21	chr21	43403940	43440496	36556	zinc finger and BTB domain containing 21
PA37661	9278	ZBTB22	chr6	33279182	33295719	16537	zinc finger and BTB domain containing 22
PA134904966	9841	ZBTB24	chr6	109780719	109814440	33721	zinc finger and BTB domain containing 24
PA37687	7597	ZBTB25	chr14	64913285	64980656	67371	zinc finger and BTB domain containing 25
PA134914020	57684	ZBTB26	chr9	125674845	125703792	28947	zinc finger and BTB domain containing 26
PA134950004	79842	ZBTB3	chr11	62515435	62531656	16221	zinc finger and BTB domain containing 3
PA142670541	27033	ZBTB32	chr19	36185389	36210940	25551	zinc finger and BTB domain containing 32
PA134928604	10009	ZBTB33	chrX	119374607	119395251	20644	zinc finger and BTB domain containing 33
PA134869916	403341	ZBTB34	chr9	129612944	129651157	38213	zinc finger and BTB domain containing 34
PA134911383	84614	ZBTB37	chr1	173827220	173859596	32376	zinc finger and BTB domain containing 37
PA142670542	253461	ZBTB38	chr3	141033055	141171634	138579	zinc finger and BTB domain containing 38
PA142670543	9880	ZBTB39	chr12	57389617	57410297	20680	zinc finger and BTB domain containing 39
PA134959224	57659	ZBTB4	chr17	7359685	7397568	37883	zinc finger and BTB domain containing 4
PA142670544	9923	ZBTB40	chr1	22768344	22860650	92306	zinc finger and BTB domain containing 40
PA142670545	360023	ZBTB41	chr1	197119814	197179672	59858	zinc finger and BTB domain containing 41
PA144596242	100128927	ZBTB42	chr14	105256933	105274049	17116	zinc finger and BTB domain containing 42
PA38257	23099	ZBTB43	chr9	129557285	129603489	46204	zinc finger and BTB domain containing 43
PA162409447	29068	ZBTB44	chr11	130093572	130194663	101091	zinc finger and BTB domain containing 44
PA162409464	84878	ZBTB45	chr19	59021897	59041845	19948	zinc finger and BTB domain containing 45
PA25441	140685	ZBTB46	chr20	62372021	62473731	101710	zinc finger and BTB domain containing 46
PA162409466	92999	ZBTB47	chr3	42685176	42712072	26896	zinc finger and BTB domain containing 47
PA162409481	3104	ZBTB48	chr1	6630051	6652340	22289	zinc finger and BTB domain containing 48
PA165664822	166793	ZBTB49	chr4	4281924	4326513	44589	zinc finger and BTB domain containing 49
PA134969268	9925	ZBTB5	chr9	37435099	37475407	40308	zinc finger and BTB domain containing 5
PA134939601	10773	ZBTB6	chr9	125667335	125686365	19030	zinc finger and BTB domain containing 6
PA134885165	51341	ZBTB7A	chr19	4042216	4076816	34600	zinc finger and BTB domain containing 7A
PA38630	51043	ZBTB7B	chr1	154965106	154994001	28895	zinc finger and BTB domain containing 7B
PA134861865	201501	ZBTB7C	chr18	45550043	45945793	395750	zinc finger and BTB domain containing 7C
PA164727627	653121	ZBTB8A	chr1	32994772	33074542	79770	zinc finger and BTB domain containing 8A
PA164727642	728116	ZBTB8B	chr1	32920658	32956460	35802	zinc finger and BTB domain containing 8B
PA142670540	339487	ZBTB8OS	chr1	33083421	33126565	43144	zinc finger and BTB domain containing 8 opposite strand
PA134895172	221504	ZBTB9	chr6	33412356	33428321	15965	zinc finger and BTB domain containing 9
PA162386952	51101	ZC2HC1A	chr8	79568282	79635000	66718	zinc finger, C2HC-type containing 1A
PA165617689	153918	ZC2HC1B	chr6	144175573	144262483	86910	zinc finger, C2HC-type containing 1B
PA162386996	79696	ZC2HC1C	chr14	75525935	75547799	21864	zinc finger, C2HC-type containing 1C
PA142670534	84872	ZC3H10	chr12	56502030	56520143	18113	zinc finger CCCH-type containing 10
PA142670535	9877	ZC3H11A	chr1	203754665	203826256	71591	zinc finger CCCH-type containing 11A
PA142670537	80149	ZC3H12A	chr1	37930119	37952978	22859	zinc finger CCCH-type containing 12A
PA134942463	340554	ZC3H12B	chrX	64698058	64730767	32709	zinc finger CCCH-type containing 12B
PA128394739	85463	ZC3H12C	chr11	109953673	110045566	91893	zinc finger CCCH-type containing 12C
PA134867170	340152	ZC3H12D	chr6	149765766	149816148	50382	zinc finger CCCH-type containing 12D
PA134907656	23091	ZC3H13	chr13	46525600	46636896	111296	zinc finger CCCH-type containing 13
PA145007270	79882	ZC3H14	chr14	89019253	89082853	63600	zinc finger CCCH-type containing 14
PA162409508	55854	ZC3H15	chr2	187340885	187377088	36203	zinc finger CCCH-type containing 15
PA162409533	124245	ZC3H18	chr16	88626789	88701372	74583	zinc finger CCCH-type containing 18
PA134933089	23144	ZC3H3	chr8	144516825	144634449	117624	zinc finger CCCH-type containing 3
PA162409534	23211	ZC3H4	chr19	47564444	47627009	62565	zinc finger CCCH-type containing 4
PA134883473	376940	ZC3H6	chr2	113023178	113100640	77462	zinc finger CCCH-type containing 6
PA128394652	29066	ZC3H7A	chr16	11841442	11901114	59672	zinc finger CCCH-type containing 7A
PA142670533	23264	ZC3H7B	chr22	41687507	41759151	71644	zinc finger CCCH-type containing 7B
PA134956342	84524	ZC3H8	chr2	112970439	113022664	52225	zinc finger CCCH-type containing 8
PA134944289	56829	ZC3HAV1	chr7	138725266	138804466	79200	zinc finger CCCH-type, antiviral 1
PA145147600	92092	ZC3HAV1L	chr7	138707452	138730775	23323	zinc finger CCCH-type, antiviral 1-like
PA134931869	51530	ZC3HC1	chr7	129655126	129701233	46107	zinc finger, C3HC-type containing 1
PA164727643	55906	ZC4H2	chrX	64132682	64264624	131942	zinc finger, C4H2 domain containing
PA134876515	54819	ZCCHC10	chr5	132329677	132372275	42598	zinc finger, CCHC domain containing 10
PA134918178	23318	ZCCHC11	chr1	52885947	53028764	142817	zinc finger, CCHC domain containing 11
PA134885304	170261	ZCCHC12	chrX	117947787	117963931	16144	zinc finger, CCHC domain containing 12
PA134926925	389874	ZCCHC13	chrX	73514025	73527869	13844	zinc finger, CCHC domain containing 13
PA134895795	23174	ZCCHC14	chr16	87436852	87535870	99018	zinc finger, CCHC domain containing 14
PA142670538	340595	ZCCHC16	chrX	111316253	111703473	387220	zinc finger, CCHC domain containing 16
PA142670539	51538	ZCCHC17	chr1	31759832	31841569	81737	zinc finger, CCHC domain containing 17
PA134861180	54877	ZCCHC2	chr18	60180658	60257942	77284	zinc finger, CCHC domain containing 2
PA162409573	219654	ZCCHC24	chr10	81139081	81215383	76302	zinc finger, CCHC domain containing 24
PA25806	85364	ZCCHC3	chr20	268204	283965	15761	zinc finger, CCHC domain containing 3
PA134950003	29063	ZCCHC4	chr4	25304396	25377190	72794	zinc finger, CCHC domain containing 4
PA134958360	203430	ZCCHC5	chrX	77908566	77924825	16259	zinc finger, CCHC domain containing 5
PA134971144	79670	ZCCHC6	chr9	88899648	88979402	79754	zinc finger, CCHC domain containing 6
PA128394734	84186	ZCCHC7	chr9	37110161	37361146	250985	zinc finger, CCHC domain containing 7
PA134889410	55596	ZCCHC8	chr12	122953146	122995543	42397	zinc finger, CCHC domain containing 8
PA134931870	84240	ZCCHC9	chr5	80587402	80611966	24564	zinc finger, CCHC domain containing 9
PA143485674	85437	ZCRB1	chr12	42702888	42729932	27044	zinc finger CCHC-type and RNA binding motif 1
PA134913967	55063	ZCWPW1	chr7	99995449	100037037	41588	zinc finger, CW type with PWWP domain 1
PA134888742	152098	ZCWPW2	chr3	28380372	28569633	189261	zinc finger, CW type with PWWP domain 2
PA162409574	57683	ZDBF2	chr2	207129523	207182162	52639	zinc finger, DBF-type containing 2
PA38261	29800	ZDHHC1	chr16	67425322	67460339	35017	zinc finger, DHHC-type containing 1
PA38801	79844	ZDHHC11	chr5	792720	869088	76368	zinc finger, DHHC-type containing 11
PA38802	84885	ZDHHC12	chr9	131480148	131496451	16303	zinc finger, DHHC-type containing 12
PA134955878	54503	ZDHHC13	chr11	19128681	19200967	72286	zinc finger, DHHC-type containing 13
PA134935513	79683	ZDHHC14	chr6	157792557	158101293	308736	zinc finger, DHHC-type containing 14
PA134945089	158866	ZDHHC15	chrX	74585262	74753337	168075	zinc finger, DHHC-type containing 15
PA134985701	84287	ZDHHC16	chr10	99195900	99220127	24227	zinc finger, DHHC-type containing 16
PA134991292	23390	ZDHHC17	chr12	77147854	77250481	102627	zinc finger, DHHC-type containing 17
PA134968241	84243	ZDHHC18	chr1	27143201	27187092	43891	zinc finger, DHHC-type containing 18
PA134871748	131540	ZDHHC19	chr3	195921323	195948308	26985	zinc finger, DHHC-type containing 19
PA38336	51201	ZDHHC2	chr8	17003836	17083241	79405	zinc finger, DHHC-type containing 2
PA134880838	253832	ZDHHC20	chr13	21943710	22043508	99798	zinc finger, DHHC-type containing 20
PA134919189	340481	ZDHHC21	chr9	14608069	14703480	95411	zinc finger, DHHC-type containing 21
PA134952477	283576	ZDHHC22	chr14	77594613	77618134	23521	zinc finger, DHHC-type containing 22
PA134960347	254887	ZDHHC23	chr3	113656748	113708706	51958	zinc finger, DHHC-type containing 23
PA142670531	254359	ZDHHC24	chr11	66285854	66323709	37855	zinc finger, DHHC-type containing 24
PA38544	51304	ZDHHC3	chr3	44953753	45027674	73921	zinc finger, DHHC-type containing 3
PA38337	55146	ZDHHC4	chr7	6607065	6631610	24545	zinc finger, DHHC-type containing 4
PA38338	25921	ZDHHC5	chr11	57425223	57471659	46436	zinc finger, DHHC-type containing 5
PA38803	64429	ZDHHC6	chr10	114187058	114217301	30243	zinc finger, DHHC-type containing 6
PA38335	55625	ZDHHC7	chr16	85005066	85055141	50075	zinc finger, DHHC-type containing 7
PA38339	29801	ZDHHC8	chr22	20109364	20138530	29166	zinc finger, DHHC-type containing 8
PA38340	51114	ZDHHC9	chrX	128934264	128987910	53646	zinc finger, DHHC-type containing 9
PA162409589	6935	ZEB1	chr10	31597825	31821742	223917	zinc finger E-box binding homeobox 1
PA162409612	9839	ZEB2	chr2	145138942	145287958	149016	zinc finger E-box binding homeobox 2
PA162409637	10444	ZER1	chr9	131489065	131544220	55155	zyg-11 related, cell cycle regulator
PA142670532	79752	ZFAND1	chr8	82610566	82643539	32973	zinc finger, AN1-type domain 1
PA142670526	90637	ZFAND2A	chr7	1189543	1209855	20312	zinc finger, AN1-type domain 2A
PA142670527	130617	ZFAND2B	chr2	220061506	220077373	15867	zinc finger, AN1-type domain 2B
PA38277	60685	ZFAND3	chr6	37777272	38164637	387365	zinc finger, AN1-type domain 3
PA134976557	93550	ZFAND4	chr10	46108039	46178251	70212	zinc finger, AN1-type domain 4
PA37587	7763	ZFAND5	chr9	74963341	74990163	26822	zinc finger, AN1-type domain 5
PA134883256	54469	ZFAND6	chr15	80341910	80433735	91825	zinc finger, AN1-type domain 6
PA165392434	441951	ZFAS1	chr20	47884715	47908797	24082	ZNFX1 antisense RNA 1
PA162409638	57623	ZFAT	chr8	135487031	135735292	248261	zinc finger and AT hook domain containing
PA164727644	196441	ZFC3H1	chr12	72000379	72067749	67370	zinc finger, C3H1-type containing
PA134951324	85446	ZFHX2	chr14	23987064	24035199	48135	zinc finger homeobox 2
PA162409676	463	ZFHX3	chr16	72813784	73102534	288750	zinc finger homeobox 3
PA134986366	79776	ZFHX4	chr8	77583515	77782521	199006	zinc finger homeobox 4
PA134882678	162239	ZFP1	chr16	75172392	75209132	36740	ZFP1 zinc finger protein
PA134896979	64397	ZFP106	chr15	42702021	42759730	57709	zinc finger protein 106 homolog (mouse)
PA162409701	7771	ZFP112	chr19	44827706	44870856	43150	zinc finger protein 112 homolog (mouse)
PA145147576	57677	ZFP14	chr19	36822355	36880126	57771	ZFP14 zinc finger protein
PA142670528	80108	ZFP2	chr5	178312899	178363213	50314	ZFP2 zinc finger protein
PA38469	140612	ZFP28	chr19	57040317	57071170	30853	ZFP28 zinc finger protein
PA37450	124961	ZFP3	chr17	4971754	5002669	30915	ZFP3 zinc finger protein
PA143485675	22835	ZFP30	chr19	38120386	38158129	37743	ZFP30 zinc finger protein
PA37451	7538	ZFP36	chr19	39887487	39903052	15565	ZFP36 ring finger protein
PA35027	677	ZFP36L1	chr14	69251372	69273184	21812	ZFP36 ring finger protein-like 1
PA35028	678	ZFP36L2	chr2	43446541	43463745	17204	ZFP36 ring finger protein-like 2
PA37452	7539	ZFP37	chr9	115801144	115829043	27899	ZFP37 zinc finger protein
PA142670529	286128	ZFP41	chr8	144318991	144347875	28884	ZFP41 zinc finger protein
PA142670530	132625	ZFP42	chr4	188906925	188929199	22274	ZFP42 zinc finger protein
PA134937821	346171	ZFP57	chr6	29637169	29654931	17762	ZFP57 zinc finger protein
PA134969387	643836	ZFP62	chr5	180269435	180298334	28899	ZFP62 zinc finger protein
PA38060	55734	ZFP64	chr20	50697550	50818524	120974	ZFP64 zinc finger protein
PA134917508	339559	ZFP69	chr1	40933043	40965015	31972	ZFP69 zinc finger protein
PA134991949	65243	ZFP69B	chr1	40905774	40932390	26616	ZFP69 zinc finger protein B
PA162409714	284406	ZFP82	chr19	36879861	36919550	39689	ZFP82 zinc finger protein
PA134967487	146198	ZFP90	chr16	68563192	68612975	49783	ZFP90 zinc finger protein
PA37955	80829	ZFP91	chr11	58336587	58392023	55436	ZFP91 zinc finger protein
PA162409715	386607	ZFP91-CNTF	chr11	58336587	58396206	59619	ZFP91-CNTF readthrough (non-protein coding)
PA37457	7542	ZFPL1	chr11	64841694	64858874	17180	zinc finger protein-like 1
PA134920282	161882	ZFPM1	chr16	88510014	88604574	94560	zinc finger protein, FOG family member 1
PA134947303	23414	ZFPM2	chr8	106320917	106819767	498850	zinc finger protein, FOG family member 2
PA38219	51663	ZFR	chr5	32351456	32454844	103388	zinc finger RNA binding protein
PA162409746	23217	ZFR2	chr19	3801022	3879027	78005	zinc finger RNA binding protein 2
PA37458	7543	ZFX	chrX	24157047	24237372	80325	zinc finger protein, X-linked
PA37459	7544	ZFY	chrY	2793112	2853547	60435	zinc finger protein, Y-linked
PA37752	53349	ZFYVE1	chr14	73433152	73503920	70768	zinc finger, FYVE domain containing 1
PA134873366	9765	ZFYVE16	chr5	79693386	79778498	85112	zinc finger, FYVE domain containing 16
PA134906967	84936	ZFYVE19	chr15	41089274	41109767	20493	zinc finger, FYVE domain containing 19
PA134959491	64145	ZFYVE20	chr3	15108580	15150662	42082	zinc finger, FYVE domain containing 20
PA134879875	79038	ZFYVE21	chr14	104172081	104203005	30924	zinc finger, FYVE domain containing 21
PA134904455	23503	ZFYVE26	chr14	68210237	68293306	83069	zinc finger, FYVE domain containing 26
PA134863310	118813	ZFYVE27	chr10	99486878	99523664	36786	zinc finger, FYVE domain containing 27
PA134904138	57732	ZFYVE28	chr4	2268324	2430370	162046	zinc finger, FYVE domain containing 28
PA30532	9372	ZFYVE9	chr1	52597678	52815358	217680	zinc finger, FYVE domain containing 9
PA164727719	653808	ZG16	chr16	29779561	29795969	16408	zymogen granule protein 16
PA164727732	124220	ZG16B	chr16	2870173	2885285	15112	zymogen granule protein 16B
PA165394820	100125288	ZGLP1	chr19	10412479	10430233	17754	zinc finger, GATA-like protein 1
PA134881248	84619	ZGPAT	chr20	62328727	62370494	41767	zinc finger, CCCH-type with G patch domain
PA144596502	55345	ZGRF1	chr4	113457489	113568151	110662	zinc finger, GRF-type containing 1
PA37460	11244	ZHX1	chr8	124257690	124297781	40091	zinc fingers and homeoboxes 1
PA128394591	22882	ZHX2	chr8	123782510	123989755	207245	zinc fingers and homeoboxes 2
PA38056	23051	ZHX3	chr20	39804089	39938766	134677	zinc fingers and homeoboxes 3
PA37461	7545	ZIC1	chr3	147117181	147137506	20325	Zic family member 1
PA37462	7546	ZIC2	chr13	100624026	100642019	17993	Zic family member 2
PA37463	7547	ZIC3	chrX	136638346	136657259	18913	Zic family member 3
PA134937175	84107	ZIC4	chr3	147100835	147134596	33761	Zic family member 4
PA134941698	85416	ZIC5	chr13	100612275	100634178	21903	Zic family member 5
PA162409747	284307	ZIK1	chr19	58085508	58108256	22748	zinc finger protein interacting with K protein 1
PA37464	23619	ZIM2	chr19	57282915	57362097	79182	zinc finger, imprinted 2
PA38127	114026	ZIM3	chr19	57642464	57666570	24106	zinc finger, imprinted 3
PA37676	7586	ZKSCAN1	chr7	99603204	99645803	42599	zinc finger with KRAB and SCAN domains 1
PA162409748	342357	ZKSCAN2	chr16	25244322	25279210	34888	zinc finger with KRAB and SCAN domains 2
PA37821	80317	ZKSCAN3	chr6	28307691	28339954	32263	zinc finger with KRAB and SCAN domains 3
PA162409784	387032	ZKSCAN4	chr6	28209404	28237030	27626	zinc finger with KRAB and SCAN domains 4
PA162409785	23660	ZKSCAN5	chr7	99092273	99134445	42172	zinc finger with KRAB and SCAN domains 5
PA37537	55888	ZKSCAN7	chr3	44586667	44627975	41308	zinc finger with KRAB and SCAN domains 7
PA37563	7745	ZKSCAN8	chr6	28099688	28130250	30562	zinc finger with KRAB and SCAN domains 8
PA134880461	84460	ZMAT1	chrX	101134260	101197108	62848	zinc finger, matrin-type 1
PA134931664	153527	ZMAT2	chr5	140068265	140089248	20983	zinc finger, matrin-type 2
PA145147560	64393	ZMAT3	chr3	178732011	178800067	68056	zinc finger, matrin-type 3
PA142670525	79698	ZMAT4	chr8	40385109	40765345	380236	zinc finger, matrin-type 4
PA142670524	55954	ZMAT5	chr22	30123945	30173000	49055	zinc finger, matrin-type 5
PA162409804	57178	ZMIZ1	chr10	80818751	81079285	260534	zinc finger, MIZ-type containing 1
PA162409851	83637	ZMIZ2	chr7	44778168	44812480	34312	zinc finger, MIZ-type containing 2
PA37466	10269	ZMPSTE24	chr1	40713722	40762856	49134	zinc metallopeptidase STE24
PA134948969	79830	ZMYM1	chr1	35515387	35584460	69073	zinc finger, MYM-type 1
PA37569	7750	ZMYM2	chr13	20521708	20668968	147260	zinc finger, MYM-type 2
PA37632	9203	ZMYM3	chrX	70456474	70485047	28573	zinc finger, MYM-type 3
PA37633	9202	ZMYM4	chr1	35724444	35890545	166101	zinc finger, MYM-type 4
PA37607	9205	ZMYM5	chr13	20394621	20447776	53155	zinc finger, MYM-type 5
PA37628	9204	ZMYM6	chr1	35448766	35507569	58803	zinc finger, MYM-type 6
PA134981649	51364	ZMYND10	chr3	50375537	50393459	17922	zinc finger, MYND-type containing 10
PA128394578	10771	ZMYND11	chr10	170405	303577	133172	zinc finger, MYND-type containing 11
PA134993145	84217	ZMYND12	chr1	42893000	42931938	38938	zinc finger, MYND-type containing 12
PA134873463	84225	ZMYND15	chr17	4633059	4652414	19355	zinc finger, MYND-type containing 15
PA134878875	116225	ZMYND19	chr9	140473531	140494937	21406	zinc finger, MYND-type containing 19
PA162409890	23613	ZMYND8	chr20	45834994	45995485	160491	zinc finger, MYND-type containing 8
PA37468	7556	ZNF10	chr12	133697214	133739051	41837	zinc finger protein 10
PA37469	163227	ZNF100	chr19	21903417	21960430	57013	zinc finger protein 100
PA37470	94039	ZNF101	chr19	19768962	19794735	25773	zinc finger protein 101
PA37476	51427	ZNF107	chr7	64116461	64174960	58499	zinc finger protein 107
PA37483	163071	ZNF114	chr19	48764354	48793863	29509	zinc finger protein 114
PA37486	51351	ZNF117	chr7	64431830	64461414	29584	zinc finger protein 117
PA37491	7559	ZNF12	chr7	6725064	6756566	31502	zinc finger protein 12
PA37493	7675	ZNF121	chr19	9673292	9705209	31917	zinc finger protein 121
PA37496	7678	ZNF124	chr1	247282277	247345529	63252	zinc finger protein 124
PA37504	7690	ZNF131	chr5	43110985	43179351	68366	zinc finger protein 131
PA37505	7691	ZNF132	chr19	58941181	58961589	20408	zinc finger protein 132
PA134900961	7692	ZNF133	chr20	18258872	18300640	41768	zinc finger protein 133
PA37506	7693	ZNF134	chr19	58115830	58136636	20806	zinc finger protein 134
PA37507	7694	ZNF135	chr19	58560607	58584123	23516	zinc finger protein 135
PA37508	7695	ZNF136	chr19	12263872	12303064	39192	zinc finger protein 136
PA37509	7696	ZNF137P	chr19	53089937	53106405	16468	zinc finger protein 137, pseudogene
PA37510	7697	ZNF138	chr7	64244766	64317178	72412	zinc finger protein 138
PA37511	7561	ZNF14	chr19	19818281	19853921	35640	zinc finger protein 14
PA37512	7699	ZNF140	chr12	133647005	133688566	41561	zinc finger protein 140
PA37513	7700	ZNF141	chr4	321417	373076	51659	zinc finger protein 141
PA37514	7701	ZNF142	chr2	219499639	219534355	34716	zinc finger protein 142
PA37515	7702	ZNF143	chr11	9472512	9553071	80559	zinc finger protein 143
PA37518	7705	ZNF146	chr19	36695504	36732676	37172	zinc finger protein 146
PA37520	7707	ZNF148	chr3	124941513	125104198	162685	zinc finger protein 148
PA37523	7710	ZNF154	chr19	58205594	58230579	24985	zinc finger protein 154
PA37524	7711	ZNF155	chr19	44462014	44505477	43463	zinc finger protein 155
PA37525	7712	ZNF157	chrX	47219999	47276098	56099	zinc finger protein 157
PA37530	7564	ZNF16	chr8	146152744	146186274	33530	zinc finger protein 16
PA37531	90338	ZNF160	chr19	53566181	53616690	50509	zinc finger protein 160
PA37535	7718	ZNF165	chr6	28038482	28060341	21859	zinc finger protein 165
PA37539	169841	ZNF169	chr9	97011578	97068291	56713	zinc finger protein 169
PA37540	7565	ZNF17	chr19	57912529	57936307	23778	zinc finger protein 17
PA37545	7727	ZNF174	chr16	3441190	3462364	21174	zinc finger protein 174
PA37546	7728	ZNF175	chr19	52064531	52095991	31460	zinc finger protein 175
PA37548	7730	ZNF177	chr19	9463696	9496293	32597	zinc finger protein 177
PA37551	7566	ZNF18	chr17	11877756	11911736	33980	zinc finger protein 18
PA37552	7733	ZNF180	chr19	44975645	45014574	38929	zinc finger protein 180
PA37553	339318	ZNF181	chr19	35215103	35236774	21671	zinc finger protein 181
PA37581	7569	ZNF182	chrX	47831250	47873394	42144	zinc finger protein 182
PA37557	7738	ZNF184	chr6	27415521	27450897	35376	zinc finger protein 184
PA37558	7739	ZNF185	chrX	152056671	152145025	88354	zinc finger protein 185 (LIM domain)
PA37561	7743	ZNF189	chr9	104151136	104175942	24806	zinc finger protein 189
PA37562	7567	ZNF19	chr16	71504976	71608992	104016	zinc finger protein 19
PA37566	7748	ZNF195	chr11	3376157	3410452	34295	zinc finger protein 195
PA37568	10168	ZNF197	chr3	44656511	44692963	36452	zinc finger protein 197
PA37571	7549	ZNF2	chr2	95821165	95853065	31900	zinc finger protein 2
PA37572	7568	ZNF20	chr19	12239165	12261222	22057	zinc finger protein 20
PA37573	7752	ZNF200	chr16	3269325	3296221	26896	zinc finger protein 200
PA37574	7753	ZNF202	chr11	123591997	123622383	30386	zinc finger protein 202
PA37575	7754	ZNF204P	chr6	27322602	27353153	30551	zinc finger protein 204, pseudogene
PA37576	7755	ZNF205	chr16	3152563	3173528	20965	zinc finger protein 205
PA37578	7756	ZNF207	chr17	30667071	30700468	33397	zinc finger protein 207
PA37579	7757	ZNF208	chr19	22145897	22203745	57848	zinc finger protein 208
PA37582	10520	ZNF211	chr19	58134535	58158409	23874	zinc finger protein 211
PA37583	7988	ZNF212	chr7	148926741	148955700	28959	zinc finger protein 212
PA37584	7760	ZNF213	chr16	3175057	3195805	20748	zinc finger protein 213
PA37585	7761	ZNF214	chr11	7017549	7051586	34037	zinc finger protein 214
PA37586	7762	ZNF215	chr11	6937654	7012718	75064	zinc finger protein 215
PA37588	7764	ZNF217	chr20	52180610	52220801	40191	zinc finger protein 217
PA37590	51222	ZNF219	chr14	21555205	21582863	27658	zinc finger protein 219
PA37591	7570	ZNF22	chr10	45486273	45503777	17504	zinc finger protein 22
PA37593	7638	ZNF221	chr19	44445375	44474752	29377	zinc finger protein 221
PA37594	7673	ZNF222	chr19	44519494	44540263	20769	zinc finger protein 222
PA37595	7766	ZNF223	chr19	44546164	44575142	28978	zinc finger protein 223
PA37596	7767	ZNF224	chr19	44588482	44616997	28515	zinc finger protein 224
PA37597	7768	ZNF225	chr19	44607528	44640255	32727	zinc finger protein 225
PA37598	7769	ZNF226	chr19	44659215	44685534	26319	zinc finger protein 226
PA37599	7770	ZNF227	chr19	44706684	44744421	37737	zinc finger protein 227
PA37601	7772	ZNF229	chr19	44927423	44962766	35343	zinc finger protein 229
PA37602	7571	ZNF23	chr16	71478500	71506295	27795	zinc finger protein 23
PA37603	7773	ZNF230	chr19	44497077	44521072	23995	zinc finger protein 230
PA37604	7775	ZNF232	chr17	5006029	5036411	30382	zinc finger protein 232
PA134917179	353355	ZNF233	chr19	44754033	44782470	28437	zinc finger protein 233
PA37605	10780	ZNF234	chr19	44635710	44667462	31752	zinc finger protein 234
PA37455	9310	ZNF235	chr19	44787501	44819606	32105	zinc finger protein 235
PA37606	7776	ZNF236	chr18	74525149	74685688	160539	zinc finger protein 236
PA37609	8187	ZNF239	chr10	44048792	44080066	31274	zinc finger protein 239
PA37610	7572	ZNF24	chr18	32909178	32934428	25250	zinc finger protein 24
PA37619	57209	ZNF248	chr10	38062454	38157012	94558	zinc finger protein 248
PA37621	219749	ZNF25	chr10	38235500	38275584	40084	zinc finger protein 25
PA37622	58500	ZNF250	chr8	146099336	146137453	38117	zinc finger protein 250
PA37623	90987	ZNF251	chr8	145943294	145991285	47991	zinc finger protein 251
PA37785	56242	ZNF253	chr19	19966639	20008099	41460	zinc finger protein 253
PA37625	9534	ZNF254	chr19	24004991	24315770	310779	zinc finger protein 254
PA37627	10172	ZNF256	chr19	58449201	58469077	19876	zinc finger protein 256
PA37786	113835	ZNF257	chr19	22225126	22277276	52150	zinc finger protein 257
PA37631	7574	ZNF26	chr12	133552934	133592154	39220	zinc finger protein 26
PA145147548	339324	ZNF260	chr19	36998589	37029248	30659	zinc finger protein 260
PA37634	10127	ZNF263	chr16	3323380	3354401	31021	zinc finger protein 263
PA37635	9422	ZNF264	chr19	57692868	57737214	44346	zinc finger protein 264
PA37637	10781	ZNF266	chr19	9520102	9556254	36152	zinc finger protein 266
PA37638	10308	ZNF267	chr16	31875079	31931629	56550	zinc finger protein 267
PA37639	10795	ZNF268	chr12	133747995	133786698	38703	zinc finger protein 268
PA37643	10793	ZNF273	chr7	64353620	64394955	41335	zinc finger protein 273
PA37644	10782	ZNF274	chr19	58684356	58727928	43572	zinc finger protein 274
PA37645	10838	ZNF275	chrX	152589613	152621384	31771	zinc finger protein 275
PA134935042	92822	ZNF276	chr16	89776393	89810333	33940	zinc finger protein 276
PA37646	11179	ZNF277	chr7	111836643	111986989	150346	zinc finger protein 277
PA37649	7576	ZNF28	chr19	53297661	53334922	37261	zinc finger protein 28
PA38358	129025	ZNF280A	chr22	22865060	22884613	19553	zinc finger protein 280A
PA162409948	140883	ZNF280B	chr22	22835767	22873505	37738	zinc finger protein 280B
PA162409961	55609	ZNF280C	chrX	129333673	129412922	79249	zinc finger protein 280C
PA162410004	54816	ZNF280D	chr15	56919374	57036279	116905	zinc finger protein 280D
PA37651	23528	ZNF281	chr1	200371075	200389186	18111	zinc finger protein 281
PA37652	8427	ZNF282	chr7	148882560	148926339	43779	zinc finger protein 282
PA37653	284349	ZNF283	chr19	44321445	44356050	34605	zinc finger protein 283
PA37654	342909	ZNF284	chr19	44566297	44594623	28326	zinc finger protein 284
PA165394833	26974	ZNF285	chr19	44886808	44915777	28969	zinc finger protein 285
PA162410066	57335	ZNF286A	chr17	15592891	15627101	34210	zinc finger protein 286A
PA162410081	729288	ZNF286B	chr17	18558742	18595572	36830	zinc finger protein 286B
PA37788	57336	ZNF287	chr17	16450626	16482520	31894	zinc finger protein 287
PA134945416	23036	ZNF292	chr6	87855269	87976926	121657	zinc finger protein 292
PA37660	162979	ZNF296	chr19	45571758	45589688	17930	zinc finger protein 296
PA37664	7551	ZNF3	chr7	99658470	99690171	31701	zinc finger protein 3
PA37665	90075	ZNF30	chr19	35407807	35439076	31269	zinc finger protein 30
PA37666	91975	ZNF300	chr5	150270954	150294545	23591	zinc finger protein 300
PA37820	55900	ZNF302	chr19	35158553	35180302	21749	zinc finger protein 302
PA37791	57343	ZNF304	chr19	57852645	57874266	21621	zinc finger protein 304
PA134865305	282890	ZNF311	chr6	28959562	28983037	23475	zinc finger protein 311
PA37793	57693	ZNF317	chr19	9241056	9277091	36035	zinc finger protein 317
PA134923137	24149	ZNF318	chr6	43300808	43347181	46373	zinc finger protein 318
PA134937483	57567	ZNF319	chr16	58025572	58044551	18979	zinc finger protein 319
PA37670	7580	ZNF32	chr10	44136307	44154326	18019	zinc finger protein 32
PA37819	162967	ZNF320	chr19	53376425	53404599	28174	zinc finger protein 320
PA37816	399669	ZNF321P	chr19	53427388	53455847	28459	zinc finger protein 321, pseudogene
PA134861342	79692	ZNF322	chr6	26631611	26669980	38369	zinc finger protein 322
PA37831	387328	ZNF322P1	chr9	99957585	99971793	14208	zinc finger protein 322 pseudogene 1
PA37839	25799	ZNF324	chr19	58968412	58987945	19533	zinc finger protein 324
PA162410082	388569	ZNF324B	chr19	58952971	58972199	19228	zinc finger protein 324B
PA37842	284695	ZNF326	chr1	90450678	90497101	46423	zinc finger protein 326
PA37858	79673	ZNF329	chr19	58634695	58676477	41782	zinc finger protein 329
PA134925405	27309	ZNF330	chr4	142132049	142158851	26802	zinc finger protein 330
PA134866703	55422	ZNF331	chr19	54014177	54086523	72346	zinc finger protein 331
PA134929553	84449	ZNF333	chr19	14790711	14847558	56847	zinc finger protein 333
PA38040	55713	ZNF334	chr20	45125269	45152198	26929	zinc finger protein 334
PA38041	63925	ZNF335	chr20	44574292	44611560	37268	zinc finger protein 335
PA38043	26152	ZNF337	chr20	25651744	25687515	35771	zinc finger protein 337
PA37671	7581	ZNF33A	chr10	38289578	38356946	67368	zinc finger protein 33A
PA37672	7582	ZNF33B	chr10	43081532	43144016	62484	zinc finger protein 33B
PA37673	80778	ZNF34	chr8	145995499	146022725	27226	zinc finger protein 34
PA38076	84905	ZNF341	chr20	32309566	32383075	73509	zinc finger protein 341
PA38081	79175	ZNF343	chr20	2459463	2499778	40315	zinc finger protein 343
PA38128	25850	ZNF345	chr19	37331260	37387120	55860	zinc finger protein 345
PA134898181	23567	ZNF346	chr5	176439681	176511189	71508	zinc finger protein 346
PA38143	84671	ZNF347	chr19	53638553	53672322	33769	zinc finger protein 347
PA37674	7584	ZNF35	chr3	44680108	44705283	25175	zinc finger protein 35
PA134972827	59348	ZNF350	chr19	52464593	52500079	35486	zinc finger protein 350
PA36383	6940	ZNF354A	chr5	178135522	178167703	32181	zinc finger protein 354A
PA38210	117608	ZNF354B	chr5	178276954	178314424	37470	zinc finger protein 354B
PA38184	30832	ZNF354C	chr5	178477607	178513022	35415	zinc finger protein 354C
PA38189	140467	ZNF358	chr19	7570169	7588911	18742	zinc finger protein 358
PA38290	149076	ZNF362	chr1	33711908	33769321	57413	zinc finger protein 362
PA134873576	22891	ZNF365	chr10	64123916	64434771	310855	zinc finger protein 365
PA38314	167465	ZNF366	chr5	71735238	71813249	78011	zinc finger protein 366
PA38316	195828	ZNF367	chr9	99145223	99190669	45446	zinc finger protein 367
PA37677	7587	ZNF37A	chr10	38373264	38415280	42016	zinc finger protein 37A
PA134869965	84911	ZNF382	chr19	37086207	37122499	36292	zinc finger protein 382
PA134903145	163087	ZNF383	chr19	37698828	37737828	39000	zinc finger protein 383
PA36644	171017	ZNF384	chr12	6772643	6808738	36095	zinc finger protein 384
PA162410095	25946	ZNF385A	chr12	54759913	54795083	35170	zinc finger protein 385A
PA162410114	151126	ZNF385B	chr2	180303709	180736232	432523	zinc finger protein 385B
PA162410139	201181	ZNF385C	chr17	40174594	40215881	41287	zinc finger protein 385C
PA162410152	79750	ZNF385D	chr3	21456911	22424132	967221	zinc finger protein 385D
PA134868215	346157	ZNF391	chr6	27346524	27374683	28159	zinc finger protein 391
PA38702	84124	ZNF394	chr7	99081142	99107925	26783	zinc finger protein 394
PA134978145	55893	ZNF395	chr8	28200102	28253983	53881	zinc finger protein 395
PA38697	252884	ZNF396	chr18	32943661	32967301	23640	zinc finger protein 396
PA38694	84307	ZNF397	chr18	32810994	32841397	30403	zinc finger protein 397
PA38532	57541	ZNF398	chr7	148813508	148883134	69626	zinc finger protein 398
PA134880927	342908	ZNF404	chr19	44373515	44398116	24601	zinc finger protein 404
PA134942906	55628	ZNF407	chr18	72255106	72780628	525522	zinc finger protein 407
PA134936136	79797	ZNF408	chr11	46712317	46730466	18149	zinc finger protein 408
PA37682	7592	ZNF41	chrX	47302281	47353070	50789	zinc finger protein 41
PA134958929	57862	ZNF410	chr14	74343318	74401991	58673	zinc finger protein 410
PA142670521	84330	ZNF414	chr19	8572462	8589048	16586	zinc finger protein 414
PA134984602	55786	ZNF415	chr19	53608132	53646173	38041	zinc finger protein 415
PA134905500	55659	ZNF416	chr19	58079387	58100266	20879	zinc finger protein 416
PA134863699	147687	ZNF417	chr19	58414142	58437978	23836	zinc finger protein 417
PA134912102	147686	ZNF418	chr19	58430252	58456795	26543	zinc finger protein 418
PA134871733	79744	ZNF419	chr19	57989079	58009048	19969	zinc finger protein 419
PA134958420	147923	ZNF420	chr19	37559319	37624221	64902	zinc finger protein 420
PA134903681	23090	ZNF423	chr16	49521515	49901830	380315	zinc finger protein 423
PA134984453	155054	ZNF425	chr7	148796853	148833438	36585	zinc finger protein 425
PA134991761	79088	ZNF426	chr19	9635667	9659638	23971	zinc finger protein 426
PA142672216	126299	ZNF428	chr19	44108376	44134298	25922	zinc finger protein 428
PA134910790	353088	ZNF429	chr19	21678437	21724079	45642	zinc finger protein 429
PA37684	7594	ZNF43	chr19	21984751	22044870	60119	zinc finger protein 43
PA134987901	80264	ZNF430	chr19	21193426	21245852	52426	zinc finger protein 430
PA134932493	170959	ZNF431	chr19	21314813	21374070	59257	zinc finger protein 431
PA134935907	9668	ZNF432	chr19	52533677	52562073	28396	zinc finger protein 432
PA134943717	163059	ZNF433	chr19	12122532	12156525	33993	zinc finger protein 433
PA134911283	80818	ZNF436	chr1	23682941	23706357	23416	zinc finger protein 436
PA143485677	220929	ZNF438	chr10	31130563	31330866	200303	zinc finger protein 438
PA134886330	90594	ZNF439	chr19	11949541	11983306	33765	zinc finger protein 439
PA37685	51710	ZNF44	chr19	12355059	12415714	60655	zinc finger protein 44
PA134917447	126070	ZNF440	chr19	11915099	11949016	33917	zinc finger protein 440
PA134991367	126068	ZNF441	chr19	11867815	11897893	30078	zinc finger protein 441
PA134983440	79973	ZNF442	chr19	12457185	12486475	29290	zinc finger protein 442
PA134968382	10224	ZNF443	chr19	12534710	12561926	27216	zinc finger protein 443
PA134984823	55311	ZNF444	chr19	56642320	56675262	32942	zinc finger protein 444
PA134904986	353274	ZNF445	chr3	44478262	44529162	50900	zinc finger protein 445
PA134863395	55663	ZNF446	chr19	58975910	58995601	19691	zinc finger protein 446
PA134920699	203523	ZNF449	chrX	134468696	134500338	31642	zinc finger protein 449
PA37686	7596	ZNF45	chr19	44413776	44449411	35635	zinc finger protein 45
PA134967635	26036	ZNF451	chr6	56944808	57038103	93295	zinc finger protein 451
PA134974337	285676	ZNF454	chr5	178358194	178396218	38024	zinc finger protein 454
PA37642	10794	ZNF460	chr19	57780776	57808436	27660	zinc finger protein 460
PA145149895	92283	ZNF461	chr19	37125283	37167740	42457	zinc finger protein 461
PA134949139	58499	ZNF462	chr9	109612469	109778525	166056	zinc finger protein 462
PA134886769	168544	ZNF467	chr7	149458452	149480295	21843	zinc finger protein 467
PA162410166	90333	ZNF468	chr19	53338785	53370902	32117	zinc finger protein 468
PA134861470	84627	ZNF469	chr16	88483879	88510165	26286	zinc finger protein 469
PA145007252	388566	ZNF470	chr19	57068401	57102965	34564	zinc finger protein 470
PA134940750	57573	ZNF471	chr19	57009212	57044581	35369	zinc finger protein 471
PA134987987	25888	ZNF473	chr19	50518786	50555033	36247	zinc finger protein 473
PA144596519	133923	ZNF474	chr5	121455215	121492266	37051	zinc finger protein 474
PA134903704	90827	ZNF479	chr7	57184321	57217571	33250	zinc finger protein 479
PA37689	197407	ZNF48	chr16	30379633	30414429	34796	zinc finger protein 48
PA134876563	147657	ZNF480	chr19	52790426	52832180	41754	zinc finger protein 480
PA134897404	158399	ZNF483	chr9	114277439	114343124	65685	zinc finger protein 483
PA134992184	83744	ZNF484	chr9	95604313	95650320	46007	zinc finger protein 484
PA134887005	220992	ZNF485	chr10	44091855	44116352	24497	zinc finger protein 485
PA134919932	90649	ZNF486	chr19	20268020	20314299	46279	zinc finger protein 486
PA143485525	642819	ZNF487	chr10	43922574	43981007	58433	zinc finger protein 487
PA134917840	118738	ZNF488	chr10	48345029	48376866	31837	zinc finger protein 488
PA134990049	57474	ZNF490	chr19	12683920	12731623	47703	zinc finger protein 490
PA134982286	126069	ZNF491	chr19	11899391	11922470	23079	zinc finger protein 491
PA134940205	57615	ZNF492	chr19	22807126	22853472	46346	zinc finger protein 492
PA134932599	284443	ZNF493	chr19	21569921	21613297	43376	zinc finger protein 493
PA134888470	84838	ZNF496	chr1	247457717	247505294	47577	zinc finger protein 496
PA134994387	162968	ZNF497	chr19	58862723	58884214	21491	zinc finger protein 497
PA134969305	26048	ZNF500	chr16	4797815	4827219	29404	zinc finger protein 500
PA134959192	115560	ZNF501	chr3	44761098	44781575	20477	zinc finger protein 501
PA134866656	91392	ZNF502	chr3	44744135	44768323	24188	zinc finger protein 502
PA134904334	84858	ZNF503	chr10	77154602	77171513	16911	zinc finger protein 503
PA134884301	440515	ZNF506	chr19	19893648	19942560	48912	zinc finger protein 506
PA134917055	22847	ZNF507	chr19	32826514	32881573	55059	zinc finger protein 507
PA134944603	22869	ZNF510	chr9	99515147	99550401	35254	zinc finger protein 510
PA134940031	118472	ZNF511	chr10	135112421	135129666	17245	zinc finger protein 511
PA134896861	84450	ZNF512	chr2	27795836	27849082	53246	zinc finger protein 512
PA162410181	57473	ZNF512B	chr20	62585057	62611223	26166	zinc finger protein 512B
PA134872812	130557	ZNF513	chr2	27597098	27613733	16635	zinc finger protein 513
PA134978837	84874	ZNF514	chr2	95810400	95835322	24922	zinc finger protein 514
PA134992707	9658	ZNF516	chr18	74066637	74217146	150509	zinc finger protein 516
PA134889443	340385	ZNF517	chr8	146014261	146038461	24200	zinc finger protein 517
PA162410182	9849	ZNF518A	chr10	97879472	97926517	47045	zinc finger protein 518A
PA162410199	85460	ZNF518B	chr4	10438497	10469032	30535	zinc finger protein 518B
PA134863605	162655	ZNF519	chr18	14072989	14142489	69500	zinc finger protein 519
PA134956321	25925	ZNF521	chr18	22638888	22942214	303326	zinc finger protein 521
PA134981576	147807	ZNF524	chr19	56101730	56117504	15774	zinc finger protein 524
PA134967668	116115	ZNF526	chr19	42714492	42735353	20861	zinc finger protein 526
PA134973274	84503	ZNF527	chr19	37852007	37886967	34960	zinc finger protein 527
PA134869369	84436	ZNF528	chr19	52890771	52924661	33890	zinc finger protein 528
PA134910867	57711	ZNF529	chr19	37031517	37106178	74661	zinc finger protein 529
PA134892909	348327	ZNF530	chr19	58101253	58127090	25837	zinc finger protein 530
PA134901858	55205	ZNF532	chr18	56519832	56656709	136877	zinc finger protein 532
PA134911920	147658	ZNF534	chr19	52922394	52945720	23326	zinc finger protein 534
PA134920047	9745	ZNF536	chr19	30853328	31051966	198638	zinc finger protein 536
PA134980975	163255	ZNF540	chr19	38032273	38108080	75807	zinc finger protein 540
PA134941115	84215	ZNF541	chr19	48020942	48085994	65052	zinc finger protein 541
PA134914064	125919	ZNF543	chr19	57821865	57845144	23279	zinc finger protein 543
PA134871299	27300	ZNF544	chr19	58729960	58791923	61963	zinc finger protein 544
PA134881362	339327	ZNF546	chr19	40492943	40526514	33571	zinc finger protein 546
PA134931565	284306	ZNF547	chr19	57864891	57893927	29036	zinc finger protein 547
PA134889718	147694	ZNF548	chr19	57891218	57916919	25701	zinc finger protein 548
PA134905435	256051	ZNF549	chr19	58028693	58055244	26551	zinc finger protein 549
PA134937679	162972	ZNF550	chr19	58050204	58081231	31027	zinc finger protein 550
PA134993781	90233	ZNF551	chr19	58183337	58204179	20842	zinc finger protein 551
PA134986961	79818	ZNF552	chr19	58315450	58336529	21079	zinc finger protein 552
PA134915990	115196	ZNF554	chr19	2809872	2839733	29861	zinc finger protein 554
PA134956715	148254	ZNF555	chr19	2831433	2863472	32039	zinc finger protein 555
PA134949188	80032	ZNF556	chr19	2857333	2881515	24182	zinc finger protein 556
PA134866521	79230	ZNF557	chr19	7059471	7090979	31508	zinc finger protein 557
PA134899314	148156	ZNF558	chr19	8917250	8952972	35722	zinc finger protein 558
PA134891126	84527	ZNF559	chr19	9424448	9464838	40390	zinc finger protein 559
PA134992071	147741	ZNF560	chr19	9574031	9619279	45248	zinc finger protein 560
PA134935834	93134	ZNF561	chr19	9715002	9741916	26914	zinc finger protein 561
PA134941707	54811	ZNF562	chr19	9756330	9795776	39446	zinc finger protein 562
PA134949077	147837	ZNF563	chr19	12425291	12454534	29243	zinc finger protein 563
PA134876070	163050	ZNF564	chr19	12633184	12701789	68605	zinc finger protein 564
PA134970652	147929	ZNF565	chr19	36670187	36715986	45799	zinc finger protein 565
PA134977695	84924	ZNF566	chr19	36933021	36990804	57783	zinc finger protein 566
PA134986394	163081	ZNF567	chr19	37168466	37215428	46962	zinc finger protein 567
PA134893477	374900	ZNF568	chr19	37397231	37491834	94603	zinc finger protein 568
PA134899564	148266	ZNF569	chr19	37898778	37970167	71389	zinc finger protein 569
PA37699	126295	ZNF57	chr19	2890896	2921641	30745	zinc finger protein 57
PA134943423	148268	ZNF570	chr19	37948463	37979242	30779	zinc finger protein 570
PA134892585	51276	ZNF571	chr19	38052155	38095673	43518	zinc finger protein 571
PA134924678	137209	ZNF572	chr8	125975539	125994631	19092	zinc finger protein 572
PA134883623	126231	ZNF573	chr19	38226203	38280230	54027	zinc finger protein 573
PA134916492	64763	ZNF574	chr19	42569057	42588719	19662	zinc finger protein 574
PA134958979	284346	ZNF575	chr19	44027244	44043290	16046	zinc finger protein 575
PA134950110	79177	ZNF576	chr19	44090544	44107587	17043	zinc finger protein 576
PA134942499	84765	ZNF577	chr19	52356056	52401229	45173	zinc finger protein 577
PA134936072	147660	ZNF578	chr19	52946829	53023131	76302	zinc finger protein 578
PA134930711	163033	ZNF579	chr19	56085891	56102211	16320	zinc finger protein 579
PA134867016	51157	ZNF580	chr19	56136361	56157836	21475	zinc finger protein 580
PA134899657	51545	ZNF581	chr19	56144986	56159989	15003	zinc finger protein 581
PA134989661	147948	ZNF582	chr19	56883595	56914970	31375	zinc finger protein 582
PA134982111	147949	ZNF583	chr19	56905383	56939400	34017	zinc finger protein 583
PA134968861	201514	ZNF584	chr19	58909245	58932694	23449	zinc finger protein 584
PA134905518	199704	ZNF585A	chr19	37635340	37673643	38303	zinc finger protein 585A
PA134925877	92285	ZNF585B	chr19	37669481	37711632	42151	zinc finger protein 585B
PA134946358	54807	ZNF586	chr19	58271020	58294984	23964	zinc finger protein 586
PA134940421	84914	ZNF587	chr19	58321011	58382953	61942	zinc finger protein 587
PA134988473	51385	ZNF589	chr3	48272596	48315480	42884	zinc finger protein 589
PA134918837	9640	ZNF592	chr15	85281818	85352663	70845	zinc finger protein 592
PA134962156	51042	ZNF593	chr1	26486388	26500364	13976	zinc finger protein 593
PA134985995	84622	ZNF594	chr17	5079830	5105178	25348	zinc finger protein 594
PA134868351	152687	ZNF595	chr4	43227	91099	47872	zinc finger protein 595
PA134901402	169270	ZNF596	chr8	172200	200339	28139	zinc finger protein 596
PA134935893	146434	ZNF597	chr16	3483110	3503490	20380	zinc finger protein 597
PA134944505	90850	ZNF598	chr16	2044653	2069822	25169	zinc finger protein 598
PA134983786	148103	ZNF599	chr19	35245979	35274134	28155	zinc finger protein 599
PA134977938	162966	ZNF600	chr19	53265747	53300034	34287	zinc finger protein 600
PA134901606	100289635	ZNF605	chr12	133495019	133542908	47889	zinc finger protein 605
PA134931984	80095	ZNF606	chr19	58485440	58524714	39274	zinc finger protein 606
PA134938252	84775	ZNF607	chr19	38184264	38220691	36427	zinc finger protein 607
PA134945727	57507	ZNF608	chr5	123969606	124094517	124911	zinc finger protein 608
PA134952302	23060	ZNF609	chr15	64781619	64981267	199648	zinc finger protein 609
PA134963099	162963	ZNF610	chr19	52829498	52873376	43878	zinc finger protein 610
PA134988282	81856	ZNF611	chr19	53203066	53248307	45241	zinc finger protein 611
PA134937067	79898	ZNF613	chr19	52420688	52452011	31323	zinc finger protein 613
PA134914044	80110	ZNF614	chr19	52513577	52541680	28103	zinc finger protein 614
PA134872929	284370	ZNF615	chr19	52491587	52521494	29907	zinc finger protein 615
PA134978923	90317	ZNF616	chr19	52613344	52653191	39847	zinc finger protein 616
PA31532	114991	ZNF618	chr9	116628562	116821875	193313	zinc finger protein 618
PA134889198	285267	ZNF619	chr3	40508604	40534728	26124	zinc finger protein 619
PA134942360	253639	ZNF620	chr3	40537450	40562712	25262	zinc finger protein 620
PA134982950	285268	ZNF621	chr3	40556376	40584043	27667	zinc finger protein 621
PA134992557	90441	ZNF622	chr5	16448628	16475894	27266	zinc finger protein 622
PA134969295	9831	ZNF623	chr8	144708183	144738900	30717	zinc finger protein 623
PA134977006	57547	ZNF624	chr17	16521048	16567167	46119	zinc finger protein 624
PA134911932	90589	ZNF625	chr19	12252705	12277546	24841	zinc finger protein 625
PA134875370	199777	ZNF626	chr19	20799745	20854402	54657	zinc finger protein 626
PA134903355	199692	ZNF627	chr19	11698235	11732974	34739	zinc finger protein 627
PA142670507	89887	ZNF628	chr19	55977699	55998854	21155	zinc finger protein 628
PA134930939	23361	ZNF629	chr16	30786770	30808564	21794	zinc finger protein 629
PA134889031	57232	ZNF630	chrX	47914567	47941025	26458	zinc finger protein 630
PA134983478	27332	ZNF638	chr2	71493729	71665191	171462	zinc finger protein 638
PA134990796	51193	ZNF639	chr3	179031551	179056325	24774	zinc finger protein 639
PA142670508	121274	ZNF641	chr12	48726065	48755029	28964	zinc finger protein 641
PA134984168	84146	ZNF644	chr1	91377855	91497812	119957	zinc finger protein 644
PA134934025	158506	ZNF645	chrX	22281030	22295578	14548	zinc finger protein 645
PA134955953	9726	ZNF646	chr16	31075581	31097833	22252	zinc finger protein 646
PA134974398	127665	ZNF648	chr1	182020705	182040847	20142	zinc finger protein 648
PA143485678	65251	ZNF649	chr19	52389488	52418305	28817	zinc finger protein 649
PA134896615	22834	ZNF652	chr17	47363568	47449835	86267	zinc finger protein 652
PA134989597	115950	ZNF653	chr19	11591242	11626738	35496	zinc finger protein 653
PA134923001	55279	ZNF654	chr3	88098394	88196814	98420	zinc finger protein 654
PA134883537	79027	ZNF655	chr7	99146034	99177076	31042	zinc finger protein 655
PA134907871	26149	ZNF658	chr9	40768188	40802112	33924	zinc finger protein 658
PA134920595	285349	ZNF660	chr3	44616456	44644186	27730	zinc finger protein 660
PA142670510	389114	ZNF662	chr3	42937402	42963825	26423	zinc finger protein 662
PA37547	144348	ZNF664	chr12	124447699	124502986	55287	zinc finger protein 664
PA142670513	79788	ZNF665	chr19	53663552	53706619	43067	zinc finger protein 665
PA142670514	63934	ZNF667	chr19	56947693	56998770	51077	zinc finger protein 667
PA142670515	79759	ZNF668	chr16	31069164	31095641	26477	zinc finger protein 668
PA142670516	79862	ZNF669	chr1	247260264	247277685	17421	zinc finger protein 669
PA142670517	93474	ZNF670	chr1	247194940	247252115	57175	zinc finger protein 670
PA142670518	79891	ZNF671	chr19	58228115	58248995	20880	zinc finger protein 671
PA142670473	79894	ZNF672	chr1	249122409	249146716	24307	zinc finger protein 672
PA142670475	641339	ZNF674	chrX	46354160	46414892	60732	zinc finger protein 674
PA142670476	171392	ZNF675	chr19	23832583	23880036	47453	zinc finger protein 675
PA142670477	163223	ZNF676	chr19	22358903	22389753	30850	zinc finger protein 676
PA142670478	342926	ZNF677	chr19	53735638	53768219	32581	zinc finger protein 677
PA142670479	339500	ZNF678	chr1	227741220	227868144	126924	zinc finger protein 678
PA142670480	168417	ZNF679	chr7	63678852	63730309	51457	zinc finger protein 679
PA142670481	340252	ZNF680	chr7	63977255	64033505	56250	zinc finger protein 680
PA142670482	148213	ZNF681	chr19	23918997	23951693	32696	zinc finger protein 681
PA142670483	91120	ZNF682	chr19	20112227	20160277	48050	zinc finger protein 682
PA142670484	257101	ZNF683	chr1	26685125	26711023	25898	zinc finger protein 683
PA142670485	127396	ZNF684	chr1	40987233	41016841	29608	zinc finger protein 684
PA142670486	57592	ZNF687	chr1	151244094	151267381	23287	zinc finger protein 687
PA142670487	146542	ZNF688	chr16	30577998	30595243	17245	zinc finger protein 688
PA142670488	115509	ZNF689	chr16	30610879	30632096	21217	zinc finger protein 689
PA37712	7620	ZNF69	chr19	11988633	12028366	39733	zinc finger protein 69
PA142670490	51058	ZNF691	chr1	43302244	43321148	18904	zinc finger protein 691
PA142670491	55657	ZNF692	chr1	249141203	249163315	22112	zinc finger protein 692
PA142670493	57116	ZNF695	chr1	247105849	247181395	75546	zinc finger protein 695
PA142670494	79943	ZNF696	chr8	144361651	144385122	23471	zinc finger protein 696
PA142670495	90874	ZNF697	chr1	120159000	120200813	41813	zinc finger protein 697
PA142670496	374879	ZNF699	chr19	9401246	9430390	29144	zinc finger protein 699
PA37713	7553	ZNF7	chr8	146042855	146075893	33038	zinc finger protein 7
PA37714	7621	ZNF70	chr22	24080772	24103279	22507	zinc finger protein 70
PA142670497	90592	ZNF700	chr19	12025883	12064588	38705	zinc finger protein 700
PA142670498	55762	ZNF701	chr19	53063526	53093427	29901	zinc finger protein 701
PA142670499	79986	ZNF702P	chr19	53468504	53506784	38280	zinc finger protein 702, pseudogene
PA142670500	80139	ZNF703	chr8	37543301	37559396	16095	zinc finger protein 703
PA142670501	619279	ZNF704	chr8	81537686	81797016	259330	zinc finger protein 704
PA142670502	440077	ZNF705A	chr12	8280807	8335642	54835	zinc finger protein 705A
PA162410210	728957	ZNF705D	chr8	11936847	11976025	39178	zinc finger protein 705D
PA165586029	100131980	ZNF705G	chr8	7212498	7230490	17992	zinc finger protein 705G
PA142670505	51123	ZNF706	chr8	102206266	102228292	22026	zinc finger protein 706
PA142670506	286075	ZNF707	chr8	144756622	144780672	24050	zinc finger protein 707
PA37528	7562	ZNF708	chr19	21470963	21522219	51256	zinc finger protein 708
PA142670469	163051	ZNF709	chr19	12568998	12605632	36634	zinc finger protein 709
PA37715	58491	ZNF71	chr19	57096664	57138550	41886	zinc finger protein 71
PA142670470	374655	ZNF710	chr15	90534197	90628432	94235	zinc finger protein 710
PA37702	7552	ZNF711	chrX	84488826	84531368	42542	zinc finger protein 711
PA143485679	349075	ZNF713	chr7	55945148	56011519	66371	zinc finger protein 713
PA143485680	148206	ZNF714	chr19	21254953	21310897	55944	zinc finger protein 714
PA143485681	441234	ZNF716	chr7	57499883	57536265	36382	zinc finger protein 716
PA142670471	100131827	ZNF717	chr3	75782868	75844709	61841	zinc finger protein 717
PA143485683	124411	ZNF720	chr16	31708741	31775886	67145	zinc finger protein 720
PA143485684	170960	ZNF721	chr4	430773	502960	72187	zinc finger protein 721
PA145149936	730087	ZNF726	chr19	24087684	24119769	32085	zinc finger protein 726
PA37710	7618	ZNF726P1	chr19	24005084	24018272	13188	zinc finger protein 726 pseudogene 1
PA162410231	442319	ZNF727	chr7	63495765	63547444	51679	zinc finger protein 727
PA145149938	100287226	ZNF729	chr19	22459252	22502978	43726	zinc finger protein 729
PA162410249	100129543	ZNF730	chr19	23289777	23333014	43237	zinc finger protein 730
PA162410265	654254	ZNF732	chr4	261464	309110	47646	zinc finger protein 732
PA164727747	728927	ZNF736	chr7	63757815	63813017	55202	zinc finger protein 736
PA162410269	100129842	ZNF737	chr19	20711067	20758626	47559	zinc finger protein 737
PA37718	7625	ZNF74	chr22	20738405	20765753	27348	zinc finger protein 74
PA143485686	283337	ZNF740	chr12	53564535	53587654	23119	zinc finger protein 740
PA144596520	155061	ZNF746	chr7	149166884	149204928	38044	zinc finger protein 746
PA144596521	65988	ZNF747	chr16	30538688	30556345	17657	zinc finger protein 747
PA145007248	388567	ZNF749	chr19	57936693	57960291	23598	zinc finger protein 749
PA145149939	79755	ZNF750	chr17	80784310	80807931	23621	zinc finger protein 750
PA37720	7627	ZNF75A	chr16	3345406	3375935	30529	zinc finger protein 75a
PA37719	7626	ZNF75D	chrX	134416719	134488034	71315	zinc finger protein 75D
PA37723	7629	ZNF76	chr6	35216691	35266762	50071	zinc finger protein 76
PA162410298	284390	ZNF763	chr19	12065796	12094214	28418	zinc finger protein 763
PA162410311	92595	ZNF764	chr16	30562085	30579642	17557	zinc finger protein 764
PA162410312	91661	ZNF765	chr19	53888397	53918262	29865	zinc finger protein 765
PA162410313	90321	ZNF766	chr19	52762824	52798979	36155	zinc finger protein 766
PA162410327	79724	ZNF768	chr16	30532322	30548821	16499	zinc finger protein 768
PA37724	58492	ZNF77	chr19	2930216	2954969	24753	zinc finger protein 77
PA162410336	54989	ZNF770	chr15	35267542	35290497	22955	zinc finger protein 770
PA162410347	51333	ZNF771	chr16	30408735	30432916	24181	zinc finger protein 771
PA162410356	400720	ZNF772	chr19	57977954	57998945	20991	zinc finger protein 772
PA162410357	374928	ZNF773	chr19	58001222	58032772	31550	zinc finger protein 773
PA162410358	342132	ZNF774	chr15	90885477	90908884	23407	zinc finger protein 774
PA162410371	285971	ZNF775	chr7	150066406	150098719	32313	zinc finger protein 775
PA162410382	284309	ZNF776	chr19	58248164	58272527	24363	zinc finger protein 776
PA162410383	27153	ZNF777	chr7	149125454	149168053	42599	zinc finger protein 777
PA162410400	197320	ZNF778	chr16	89274111	89305402	31291	zinc finger protein 778
PA162410417	284323	ZNF780A	chr19	40572059	40606845	34786	zinc finger protein 780A
PA162410426	163131	ZNF780B	chr19	40531167	40572125	40958	zinc finger protein 780B
PA162410427	163115	ZNF781	chr19	38155650	38193216	37566	zinc finger protein 781
PA162410440	158431	ZNF782	chr9	99575754	99706169	130415	zinc finger protein 782
PA162410458	147808	ZNF784	chr19	56129107	56145941	16834	zinc finger protein 784
PA162410467	146540	ZNF785	chr16	30588994	30607092	18098	zinc finger protein 785
PA162410468	136051	ZNF786	chr7	148763733	148797869	34136	zinc finger protein 786
PA162410481	126208	ZNF787	chr19	56595732	56642649	46917	zinc finger protein 787
PA162410492	285989	ZNF789	chr7	99060476	99088408	27932	zinc finger protein 789
PA37727	7633	ZNF79	chr9	130176653	130212525	35872	zinc finger protein 79
PA162410507	388536	ZNF790	chr19	37306224	37351689	45465	zinc finger protein 790
PA162410522	163049	ZNF791	chr19	12711732	12743676	31944	zinc finger protein 791
PA162410535	126375	ZNF792	chr19	35444078	35465139	21061	zinc finger protein 792
PA162410548	390927	ZNF793	chr19	37987323	38037239	49916	zinc finger protein 793
PA162410569	90576	ZNF799	chr19	12497828	12522088	24260	zinc finger protein 799
PA37728	7554	ZNF8	chr19	58780314	58830023	49709	zinc finger protein 8
PA37729	7634	ZNF80	chr3	113950370	113966425	16055	zinc finger protein 80
PA162410582	168850	ZNF800	chr7	127007097	127042778	35681	zinc finger protein 800
PA162410599	91752	ZNF804A	chr2	185453093	185807214	354121	zinc finger protein 804A
PA162410600	219578	ZNF804B	chr7	88378753	88969346	590593	zinc finger protein 804B
PA162410601	390980	ZNF805	chr19	57742053	57777106	35053	zinc finger protein 805
PA162410633	388558	ZNF808	chr19	53020905	53062502	41597	zinc finger protein 808
PA37730	347344	ZNF81	chrX	47686270	47784655	98385	zinc finger protein 81
PA162410648	729648	ZNF812	chr19	9797189	9821493	24304	zinc finger protein 812
PA162410661	126017	ZNF813	chr19	53960989	54000546	39557	zinc finger protein 813
PA164727759	730051	ZNF814	chr19	58377747	58410442	32695	zinc finger protein 814
PA165394953	125893	ZNF816	chr19	53449632	53476164	26532	zinc finger protein 816
PA162410689	55565	ZNF821	chr16	71890583	71928093	37510	zinc finger protein 821
PA162410690	55552	ZNF823	chr19	11829080	11859824	30744	zinc finger protein 823
PA162410703	664701	ZNF826P	chr19	20575626	20617771	42145	zinc finger protein 826, pseudogene
PA162410714	152485	ZNF827	chr4	146678874	146869607	190733	zinc finger protein 827
PA162410750	374899	ZNF829	chr19	37376026	37417193	41167	zinc finger protein 829
PA37731	55769	ZNF83	chr19	53112617	53203834	91217	zinc finger protein 83
PA162410767	91603	ZNF830	chr17	33278549	33293205	14656	zinc finger protein 830
PA162410774	128611	ZNF831	chr20	57725895	57837168	111273	zinc finger protein 831
PA162410775	401898	ZNF833P	chr19	11774813	11800384	25571	zinc finger protein 833, pseudogene
PA162410787	90485	ZNF835	chr19	57170729	57193151	22422	zinc finger protein 835
PA162410788	162962	ZNF836	chr19	52655039	52684896	29857	zinc finger protein 836
PA162410789	116412	ZNF837	chr19	58875990	58902389	26399	zinc finger protein 837
PA162410800	55778	ZNF839	chr14	102773714	102812511	38797	zinc finger protein 839
PA37732	7637	ZNF84	chr12	133603878	133642885	39007	zinc finger protein 84
PA162410839	284371	ZNF841	chr19	52564719	52609021	44302	zinc finger protein 841
PA162410853	283933	ZNF843	chr16	31443885	31464348	20463	zinc finger protein 843
PA162410862	284391	ZNF844	chr19	12165546	12191626	26080	zinc finger protein 844
PA162410863	91664	ZNF845	chr19	53827002	53861122	34120	zinc finger protein 845
PA162410876	162993	ZNF846	chr19	9864845	9906834	41989	zinc finger protein 846
PA37733	7639	ZNF85	chr19	21096059	21136503	40444	zinc finger protein 85
PA162410901	285346	ZNF852	chr3	44537462	44562132	24670	zinc finger protein 852
PA162410913	54753	ZNF853	chr7	6645398	6666921	21523	zinc finger protein 853
PA164727772	100507490	ZNF859P	chr1	-1	-1	0	zinc finger protein 859, pseudogene
PA164727773	344787	ZNF860	chr3	32013266	32036228	22962	zinc finger protein 860
PA164727780	100302737	ZNF861P	chr19	-1	-1	0	zinc finger protein 861, pseudogene
PA164727781	643641	ZNF862	chr7	149525464	149567568	42104	zinc finger protein 862
PA165395041	100507290	ZNF865	chr19	56104880	56132911	28031	zinc finger protein 865
PA165395055	729747	ZNF878	chr19	12151620	12173782	22162	zinc finger protein 878
PA165660603	345462	ZNF879	chr5	178440776	178464388	23612	zinc finger protein 879
PA165395098	400713	ZNF880	chr19	52863170	52892048	28878	zinc finger protein 880
PA37738	7643	ZNF90	chr19	20178803	20234977	56174	zinc finger protein 90
PA37739	7644	ZNF91	chr19	23537498	23588269	50771	zinc finger protein 91
PA37740	168374	ZNF92	chr7	64828752	64869049	40297	zinc finger protein 92
PA37741	81931	ZNF93	chr19	20001722	20049382	47660	zinc finger protein 93
PA37746	148198	ZNF98	chr19	22570899	22615148	44249	zinc finger protein 98
PA37747	7652	ZNF99	chr19	22931985	22976973	44988	zinc finger protein 99
PA143485687	57169	ZNFX1	chr20	47859437	47904756	45319	zinc finger, NFX1-type containing 1
PA134947251	10467	ZNHIT1	chr7	100850985	100870471	19486	zinc finger, HIT-type containing 1
PA25496	741	ZNHIT2	chr11	64880875	64895170	14295	zinc finger, HIT-type containing 2
PA36987	9326	ZNHIT3	chr17	34832471	34858154	25683	zinc finger, HIT-type containing 3
PA162410929	54680	ZNHIT6	chr1	86112106	86184116	72010	zinc finger, HIT-type containing 6
PA37754	30834	ZNRD1	chr6	30019017	30035686	16669	zinc ribbon domain containing 1
PA134938288	84937	ZNRF1	chr16	75022915	75147892	124977	zinc and ring finger 1, E3 ubiquitin protein ligase
PA134961488	223082	ZNRF2	chr7	30313923	30410308	96385	zinc and ring finger 2, E3 ubiquitin protein ligase
PA134983897	84133	ZNRF3	chr22	29269755	29456476	186721	zinc and ring finger 3
PA134943871	148066	ZNRF4	chr19	5445426	5459867	14441	zinc and ring finger 4
PA37755	22917	ZP1	chr11	60625015	60646164	21149	zona pellucida glycoprotein 1 (sperm receptor)
PA37756	7783	ZP2	chr16	21205773	21235831	30058	zona pellucida glycoprotein 2 (sperm receptor)
PA37757	7784	ZP3	chr7	76016841	76074388	57547	zona pellucida glycoprotein 3 (sperm receptor)
PA38036	57829	ZP4	chr1	238038164	238064222	26058	zona pellucida glycoprotein 4
PA38013	11055	ZPBP	chr7	49974023	50142860	168837	zona pellucida binding protein
PA134894503	124626	ZPBP2	chr17	38014417	38037149	22732	zona pellucida binding protein 2
PA142670472	131368	ZPLD1	chr3	101918816	102201685	282869	zona pellucida-like domain containing 1
PA37629	8882	ZPR1	chr11	116646276	116668739	22463	ZPR1 zinc finger
PA134933584	54764	ZRANB1	chr10	126595704	126679005	83301	zinc finger, RAN-binding domain containing 1
PA37636	9406	ZRANB2	chr1	71525974	71556972	30998	zinc finger, RAN-binding domain containing 2
PA134871612	84083	ZRANB3	chr2	135951539	136298806	347267	zinc finger, RAN-binding domain containing 3
PA162410930	8233	ZRSR2	chrX	15798574	15844383	45809	zinc finger (CCCH type), RNA-binding motif and serine/arginine rich 2
PA134933489	284312	ZSCAN1	chr19	58535434	58568999	33565	zinc finger and SCAN domain containing 1
PA162410957	84891	ZSCAN10	chr16	3135895	3159293	23398	zinc finger and SCAN domain containing 10
PA37744	9753	ZSCAN12	chr6	28343598	28377544	33946	zinc finger and SCAN domain containing 12
PA162410958	80345	ZSCAN16	chr6	28082334	28100864	18530	zinc finger and SCAN domain containing 16
PA162410959	65982	ZSCAN18	chr19	58592204	58639793	47589	zinc finger and SCAN domain containing 18
PA134941325	54993	ZSCAN2	chr15	85134249	85169947	35698	zinc finger and SCAN domain containing 2
PA37668	7579	ZSCAN20	chr1	33928232	33965105	36873	zinc finger and SCAN domain containing 20
PA162410981	7589	ZSCAN21	chr7	99637390	99665663	28273	zinc finger and SCAN domain containing 21
PA29307	342945	ZSCAN22	chr19	58828385	58856712	28327	zinc finger and SCAN domain containing 22
PA162410995	222696	ZSCAN23	chr6	28396373	28421279	24906	zinc finger and SCAN domain containing 23
PA134962723	221785	ZSCAN25	chr7	99204571	99278204	73633	zinc finger and SCAN domain containing 25
PA162411015	146050	ZSCAN29	chr15	43647370	43673226	25856	zinc finger and SCAN domain containing 29
PA165429212	100101467	ZSCAN30	chr18	32828023	32880196	52173	zinc finger and SCAN domain containing 30
PA37840	64288	ZSCAN31	chr6	28289514	28331972	42458	zinc finger and SCAN domain containing 31
PA134902932	54925	ZSCAN32	chr16	3428661	3461065	32404	zinc finger and SCAN domain containing 32
PA134878313	201516	ZSCAN4	chr19	58170303	58193520	23217	zinc finger and SCAN domain containing 4
PA162411030	79149	ZSCAN5A	chr19	56729672	56836208	106536	zinc finger and SCAN domain containing 5A
PA162411031	342933	ZSCAN5B	chr19	56698058	56719207	21149	zinc finger and SCAN domain containing 5B
PA162411044	649137	ZSCAN5C	chr19	56707154	56723823	16669	zinc finger and SCAN domain containing 5C
PA37564	7746	ZSCAN9	chr6	28183029	28204265	21236	zinc finger and SCAN domain containing 9
PA25704	90204	ZSWIM1	chr20	44499581	44516905	17324	zinc finger, SWIM-type containing 1
PA134900131	151112	ZSWIM2	chr2	187689207	187723897	34690	zinc finger, SWIM-type containing 2
PA25706	140831	ZSWIM3	chr20	44476220	44510770	34550	zinc finger, SWIM-type containing 3
PA134975055	65249	ZSWIM4	chr19	13896258	13946068	49810	zinc finger, SWIM-type containing 4
PA134981647	57643	ZSWIM5	chr1	45479071	45682250	203179	zinc finger, SWIM-type containing 5
PA134910181	57688	ZSWIM6	chr5	60618100	60844999	226899	zinc finger, SWIM-type containing 6
PA162411055	125150	ZSWIM7	chr17	15876874	15913006	36132	zinc finger, SWIM-type containing 7
PA134885317	23053	ZSWIM8	chr10	75535334	75564556	29222	zinc finger, SWIM-type containing 8
PA162411072	221302	ZUFSP	chr6	116953781	116999973	46192	zinc finger with UFM1-specific peptidase domain
PA37759	9183	ZW10	chr11	113600905	113654485	53580	zw10 kinetochore protein
PA142670465	55055	ZWILCH	chr15	66787431	66844823	57392	zwilch kinetochore protein
PA37761	11130	ZWINT	chr10	58114016	58131063	17047	ZW10 interacting kinetochore protein
PA37763	7789	ZXDA	chrX	57928864	57947067	18203	zinc finger, X-linked, duplicated A
PA37764	158586	ZXDB	chrX	57608269	57626910	18641	zinc finger, X-linked, duplicated B
PA142670466	79364	ZXDC	chr3	126153444	126204773	51329	ZXD family zinc finger C
PA142670467	440590	ZYG11A	chr1	53298183	53363247	65064	zyg-11 family member A, cell cycle regulator
PA142670468	79699	ZYG11B	chr1	53182126	53296014	113888	zyg-11 family member B, cell cycle regulator
PA37765	7791	ZYX	chr7	143068338	143091204	22866	zyxin
PA134938508	23140	ZZEF1	chr17	3904739	4056314	151575	zinc finger, ZZ-type with EF-hand domain 1
PA134873184	26009	ZZZ3	chr1	78025160	78159119	133959	zinc finger, ZZ-type containing 3
